Index Nabijacky;Index Udalosti;Cas Zaciatku;Cas Konca;CasTrvania;Miesto;Rychlost nabijania
0;0;249;328;79;112;2.0
0;1;328;341;13;112;2.0
0;2;341;343;2;112;2.0
0;3;343;358;15;112;2.0
0;4;358;361;3;112;2.0
0;5;361;376;15;112;2.0
0;6;376;378;2;112;2.0
0;7;378;393;15;112;2.0
0;8;393;396;3;112;2.0
0;9;396;411;15;112;2.0
0;10;411;413;2;112;2.0
0;11;413;420;7;112;2.0
0;12;420;431;11;112;2.0
0;13;431;446;15;112;2.0
0;14;446;448;2;112;2.0
0;15;448;455;7;112;2.0
0;16;455;456;1;112;2.0
0;17;456;465;9;112;2.0
0;18;465;466;1;112;2.0
0;19;466;475;9;112;2.0
0;20;475;501;26;112;2.0
0;21;501;506;5;112;2.0
0;22;506;515;9;112;2.0
0;23;515;528;13;112;2.0
0;24;528;531;3;112;2.0
0;25;531;545;14;112;2.0
0;26;545;551;6;112;2.0
0;27;551;586;35;112;2.0
0;28;586;595;9;112;2.0
0;29;595;636;41;112;2.0
0;30;636;653;17;112;2.0
0;31;653;706;53;112;2.0
0;32;706;720;14;112;2.0
0;33;720;743;23;112;2.0
0;34;743;766;23;112;2.0
0;35;766;780;14;112;2.0
0;36;780;801;21;112;2.0
0;37;801;818;17;112;2.0
0;38;818;826;8;112;2.0
0;39;826;835;9;112;2.0
0;40;835;851;16;112;2.0
0;41;851;868;17;112;2.0
0;42;868;871;3;112;2.0
0;43;871;886;15;112;2.0
0;44;886;890;4;112;2.0
0;45;890;905;15;112;2.0
0;46;905;906;1;112;2.0
0;47;906;921;15;112;2.0
0;48;921;928;7;112;2.0
0;49;928;940;12;112;2.0
0;50;940;946;6;112;2.0
0;51;946;960;14;112;2.0
0;52;960;961;1;112;2.0
0;53;961;980;19;112;2.0
0;54;980;981;1;112;2.0
0;55;981;995;14;112;2.0
0;56;995;1001;6;112;2.0
0;57;1001;1018;17;112;2.0
0;58;1018;1031;13;112;2.0
0;59;1031;1045;14;112;2.0
0;60;1045;1051;6;112;2.0
0;61;1051;1071;20;112;2.0
0;62;1071;1073;2;112;2.0
0;63;1073;1085;12;112;2.0
0;64;1085;1091;6;112;2.0
0;65;1091;1100;9;112;2.0
0;66;1100;1103;3;112;2.0
0;67;1103;1150;47;112;2.0
0;68;1150;1173;23;112;2.0
0;69;1173;1210;37;112;2.0
0;70;1210;1223;13;112;2.0
0;71;1223;1270;47;112;2.0
0;72;1270;1283;13;112;2.0
0;73;1283;1320;37;112;2.0
0;74;1320;1334;14;112;2.0
0;75;1334;1384;50;112;2.0
0;76;1384;1388;4;112;2.0
0;77;1388;1403;15;112;2.0
0;78;1403;1418;15;112;2.0
0;79;1418;1433;15;112;2.0
0;80;1433;1448;15;112;2.0
0;81;1448;1463;15;112;2.0
0;82;1463;1478;15;112;2.0
0;83;1478;1493;15;112;2.0
0;84;1493;1508;15;112;2.0
0;85;1508;1523;15;112;2.0
0;86;1523;1538;15;112;2.0
0;87;1538;1553;15;112;2.0
0;88;1553;1568;15;112;2.0
0;89;1568;1583;15;112;2.0
0;90;1583;1598;15;112;2.0
0;91;1598;1613;15;112;2.0
0;92;1613;1628;15;112;2.0
0;93;1628;1643;15;112;2.0
0;94;1643;1658;15;112;2.0
0;95;1658;1680;22;112;2.0
1;0;245;335;90;93;2.0
1;1;335;340;5;93;2.0
1;2;340;350;10;93;2.0
1;3;350;360;10;93;2.0
1;4;360;365;5;93;2.0
1;5;365;375;10;93;2.0
1;6;375;385;10;93;2.0
1;7;385;395;10;93;2.0
1;8;395;400;5;93;2.0
1;9;400;410;10;93;2.0
1;10;410;420;10;93;2.0
1;11;420;422;2;93;2.0
1;12;422;430;8;93;2.0
1;13;430;445;15;93;2.0
1;14;445;455;10;93;2.0
1;15;455;457;2;93;2.0
1;16;457;465;8;93;2.0
1;17;465;467;2;93;2.0
1;18;467;477;10;93;2.0
1;19;477;500;23;93;2.0
1;20;500;508;8;93;2.0
1;21;508;517;9;93;2.0
1;22;517;530;13;93;2.0
1;23;530;535;5;93;2.0
1;24;535;547;12;93;2.0
1;25;547;553;6;93;2.0
1;26;553;585;32;93;2.0
1;27;585;597;12;93;2.0
1;28;597;635;38;93;2.0
1;29;635;660;25;93;2.0
1;30;660;705;45;93;2.0
1;31;705;722;17;93;2.0
1;32;722;750;28;93;2.0
1;33;750;765;15;93;2.0
1;34;765;782;17;93;2.0
1;35;782;800;18;93;2.0
1;36;800;825;25;93;2.0
1;37;825;837;12;93;2.0
1;38;837;850;13;93;2.0
1;39;850;870;20;93;2.0
1;40;870;875;5;93;2.0
1;41;875;885;10;93;2.0
1;42;885;892;7;93;2.0
1;43;892;905;13;93;2.0
1;44;905;907;2;93;2.0
1;45;907;920;13;93;2.0
1;46;920;935;15;93;2.0
1;47;935;942;7;93;2.0
1;48;942;945;3;93;2.0
1;49;945;960;15;93;2.0
1;50;960;962;2;93;2.0
1;51;962;980;18;93;2.0
1;52;980;982;2;93;2.0
1;53;982;997;15;93;2.0
1;54;997;1000;3;93;2.0
1;55;1000;1025;25;93;2.0
1;56;1025;1030;5;93;2.0
1;57;1030;1047;17;93;2.0
1;58;1047;1050;3;93;2.0
1;59;1050;1070;20;93;2.0
1;60;1070;1080;10;93;2.0
1;61;1080;1087;7;93;2.0
1;62;1087;1090;3;93;2.0
1;63;1090;1102;12;93;2.0
1;64;1102;1105;3;93;2.0
1;65;1105;1149;44;93;2.0
1;66;1149;1175;26;93;2.0
1;67;1175;1209;34;93;2.0
1;68;1209;1225;16;93;2.0
1;69;1225;1269;44;93;2.0
1;70;1269;1285;16;93;2.0
1;71;1285;1319;34;93;2.0
1;72;1319;1341;22;93;2.0
1;73;1341;1383;42;93;2.0
1;74;1383;1390;7;93;2.0
1;75;1390;1405;15;93;2.0
1;76;1405;1420;15;93;2.0
1;77;1420;1435;15;93;2.0
1;78;1435;1450;15;93;2.0
1;79;1450;1465;15;93;2.0
1;80;1465;1480;15;93;2.0
1;81;1480;1495;15;93;2.0
1;82;1495;1510;15;93;2.0
1;83;1510;1525;15;93;2.0
1;84;1525;1540;15;93;2.0
1;85;1540;1555;15;93;2.0
1;86;1555;1570;15;93;2.0
1;87;1570;1585;15;93;2.0
1;88;1585;1600;15;93;2.0
1;89;1600;1615;15;93;2.0
1;90;1615;1630;15;93;2.0
1;91;1630;1645;15;93;2.0
1;92;1645;1660;15;93;2.0
1;93;1660;1680;20;93;2.0
2;0;246;335;89;92;2.0
2;1;335;340;5;92;2.0
2;2;340;350;10;92;2.0
2;3;350;360;10;92;2.0
2;4;360;365;5;92;2.0
2;5;365;375;10;92;2.0
2;6;375;385;10;92;2.0
2;7;385;395;10;92;2.0
2;8;395;400;5;92;2.0
2;9;400;410;10;92;2.0
2;10;410;420;10;92;2.0
2;11;420;421;1;92;2.0
2;12;421;430;9;92;2.0
2;13;430;445;15;92;2.0
2;14;445;455;10;92;2.0
2;15;455;456;1;92;2.0
2;16;456;465;9;92;2.0
2;17;465;466;1;92;2.0
2;18;466;476;10;92;2.0
2;19;476;500;24;92;2.0
2;20;500;507;7;92;2.0
2;21;507;516;9;92;2.0
2;22;516;530;14;92;2.0
2;23;530;535;5;92;2.0
2;24;535;546;11;92;2.0
2;25;546;552;6;92;2.0
2;26;552;585;33;92;2.0
2;27;585;596;11;92;2.0
2;28;596;635;39;92;2.0
2;29;635;660;25;92;2.0
2;30;660;705;45;92;2.0
2;31;705;721;16;92;2.0
2;32;721;750;29;92;2.0
2;33;750;765;15;92;2.0
2;34;765;781;16;92;2.0
2;35;781;800;19;92;2.0
2;36;800;825;25;92;2.0
2;37;825;836;11;92;2.0
2;38;836;850;14;92;2.0
2;39;850;870;20;92;2.0
2;40;870;875;5;92;2.0
2;41;875;885;10;92;2.0
2;42;885;891;6;92;2.0
2;43;891;905;14;92;2.0
2;44;905;906;1;92;2.0
2;45;906;920;14;92;2.0
2;46;920;935;15;92;2.0
2;47;935;941;6;92;2.0
2;48;941;945;4;92;2.0
2;49;945;960;15;92;2.0
2;50;960;961;1;92;2.0
2;51;961;980;19;92;2.0
2;52;980;981;1;92;2.0
2;53;981;996;15;92;2.0
2;54;996;1000;4;92;2.0
2;55;1000;1025;25;92;2.0
2;56;1025;1030;5;92;2.0
2;57;1030;1046;16;92;2.0
2;58;1046;1050;4;92;2.0
2;59;1050;1070;20;92;2.0
2;60;1070;1080;10;92;2.0
2;61;1080;1086;6;92;2.0
2;62;1086;1090;4;92;2.0
2;63;1090;1101;11;92;2.0
2;64;1101;1104;3;92;2.0
2;65;1104;1149;45;92;2.0
2;66;1149;1174;25;92;2.0
2;67;1174;1209;35;92;2.0
2;68;1209;1224;15;92;2.0
2;69;1224;1269;45;92;2.0
2;70;1269;1284;15;92;2.0
2;71;1284;1319;35;92;2.0
2;72;1319;1341;22;92;2.0
2;73;1341;1383;42;92;2.0
2;74;1383;1389;6;92;2.0
2;75;1389;1404;15;92;2.0
2;76;1404;1419;15;92;2.0
2;77;1419;1434;15;92;2.0
2;78;1434;1449;15;92;2.0
2;79;1449;1464;15;92;2.0
2;80;1464;1479;15;92;2.0
2;81;1479;1494;15;92;2.0
2;82;1494;1509;15;92;2.0
2;83;1509;1524;15;92;2.0
2;84;1524;1539;15;92;2.0
2;85;1539;1554;15;92;2.0
2;86;1554;1569;15;92;2.0
2;87;1569;1584;15;92;2.0
2;88;1584;1599;15;92;2.0
2;89;1599;1614;15;92;2.0
2;90;1614;1629;15;92;2.0
2;91;1629;1644;15;92;2.0
2;92;1644;1659;15;92;2.0
2;93;1659;1674;15;92;2.0
2;94;1674;1680;6;92;2.0
3;0;248;335;87;77;2.0
3;1;335;343;8;77;2.0
3;2;343;350;7;77;2.0
3;3;350;363;13;77;2.0
3;4;363;365;2;77;2.0
3;5;365;378;13;77;2.0
3;6;378;385;7;77;2.0
3;7;385;398;13;77;2.0
3;8;398;400;2;77;2.0
3;9;400;413;13;77;2.0
3;10;413;420;7;77;2.0
3;11;420;421;1;77;2.0
3;12;421;433;12;77;2.0
3;13;433;448;15;77;2.0
3;14;448;455;7;77;2.0
3;15;455;456;1;77;2.0
3;16;456;458;2;77;2.0
3;17;458;466;8;77;2.0
3;18;466;468;2;77;2.0
3;19;468;476;8;77;2.0
3;20;476;503;27;77;2.0
3;21;503;507;4;77;2.0
3;22;507;516;9;77;2.0
3;23;516;533;17;77;2.0
3;24;533;535;2;77;2.0
3;25;535;546;11;77;2.0
3;26;546;552;6;77;2.0
3;27;552;588;36;77;2.0
3;28;588;596;8;77;2.0
3;29;596;638;42;77;2.0
3;30;638;660;22;77;2.0
3;31;660;708;48;77;2.0
3;32;708;721;13;77;2.0
3;33;721;750;29;77;2.0
3;34;750;768;18;77;2.0
3;35;768;781;13;77;2.0
3;36;781;803;22;77;2.0
3;37;803;825;22;77;2.0
3;38;825;828;3;77;2.0
3;39;828;836;8;77;2.0
3;40;836;853;17;77;2.0
3;41;853;873;20;77;2.0
3;42;873;875;2;77;2.0
3;43;875;888;13;77;2.0
3;44;888;891;3;77;2.0
3;45;891;906;15;77;2.0
3;46;906;908;2;77;2.0
3;47;908;923;15;77;2.0
3;48;923;935;12;77;2.0
3;49;935;941;6;77;2.0
3;50;941;948;7;77;2.0
3;51;948;961;13;77;2.0
3;52;961;963;2;77;2.0
3;53;963;981;18;77;2.0
3;54;981;983;2;77;2.0
3;55;983;996;13;77;2.0
3;56;996;1003;7;77;2.0
3;57;1003;1025;22;77;2.0
3;58;1025;1033;8;77;2.0
3;59;1033;1046;13;77;2.0
3;60;1046;1053;7;77;2.0
3;61;1053;1073;20;77;2.0
3;62;1073;1080;7;77;2.0
3;63;1080;1086;6;77;2.0
3;64;1086;1093;7;77;2.0
3;65;1093;1101;8;77;2.0
3;66;1101;1104;3;77;2.0
3;67;1104;1152;48;77;2.0
3;68;1152;1174;22;77;2.0
3;69;1174;1212;38;77;2.0
3;70;1212;1224;12;77;2.0
3;71;1224;1272;48;77;2.0
3;72;1272;1284;12;77;2.0
3;73;1284;1322;38;77;2.0
3;74;1322;1341;19;77;2.0
3;75;1341;1386;45;77;2.0
3;76;1386;1389;3;77;2.0
3;77;1389;1404;15;77;2.0
3;78;1404;1419;15;77;2.0
3;79;1419;1434;15;77;2.0
3;80;1434;1449;15;77;2.0
3;81;1449;1464;15;77;2.0
3;82;1464;1479;15;77;2.0
3;83;1479;1494;15;77;2.0
3;84;1494;1509;15;77;2.0
3;85;1509;1524;15;77;2.0
3;86;1524;1539;15;77;2.0
3;87;1539;1554;15;77;2.0
3;88;1554;1569;15;77;2.0
3;89;1569;1584;15;77;2.0
3;90;1584;1599;15;77;2.0
3;91;1599;1614;15;77;2.0
3;92;1614;1629;15;77;2.0
3;93;1629;1644;15;77;2.0
3;94;1644;1659;15;77;2.0
3;95;1659;1680;21;77;2.0
4;0;245;333;88;119;2.0
4;1;333;340;7;119;2.0
4;2;340;348;8;119;2.0
4;3;348;360;12;119;2.0
4;4;360;363;3;119;2.0
4;5;363;375;12;119;2.0
4;6;375;383;8;119;2.0
4;7;383;395;12;119;2.0
4;8;395;398;3;119;2.0
4;9;398;410;12;119;2.0
4;10;410;418;8;119;2.0
4;11;418;419;1;119;2.0
4;12;419;430;11;119;2.0
4;13;430;445;15;119;2.0
4;14;445;453;8;119;2.0
4;15;453;454;1;119;2.0
4;16;454;455;1;119;2.0
4;17;455;464;9;119;2.0
4;18;464;465;1;119;2.0
4;19;465;474;9;119;2.0
4;20;474;500;26;119;2.0
4;21;500;505;5;119;2.0
4;22;505;514;9;119;2.0
4;23;514;530;16;119;2.0
4;24;530;533;3;119;2.0
4;25;533;544;11;119;2.0
4;26;544;550;6;119;2.0
4;27;550;585;35;119;2.0
4;28;585;594;9;119;2.0
4;29;594;635;41;119;2.0
4;30;635;658;23;119;2.0
4;31;658;705;47;119;2.0
4;32;705;719;14;119;2.0
4;33;719;748;29;119;2.0
4;34;748;765;17;119;2.0
4;35;765;779;14;119;2.0
4;36;779;800;21;119;2.0
4;37;800;823;23;119;2.0
4;38;823;825;2;119;2.0
4;39;825;834;9;119;2.0
4;40;834;850;16;119;2.0
4;41;850;870;20;119;2.0
4;42;870;873;3;119;2.0
4;43;873;885;12;119;2.0
4;44;885;889;4;119;2.0
4;45;889;904;15;119;2.0
4;46;904;905;1;119;2.0
4;47;905;920;15;119;2.0
4;48;920;933;13;119;2.0
4;49;933;939;6;119;2.0
4;50;939;945;6;119;2.0
4;51;945;959;14;119;2.0
4;52;959;960;1;119;2.0
4;53;960;979;19;119;2.0
4;54;979;980;1;119;2.0
4;55;980;994;14;119;2.0
4;56;994;1000;6;119;2.0
4;57;1000;1023;23;119;2.0
4;58;1023;1030;7;119;2.0
4;59;1030;1044;14;119;2.0
4;60;1044;1050;6;119;2.0
4;61;1050;1070;20;119;2.0
4;62;1070;1078;8;119;2.0
4;63;1078;1084;6;119;2.0
4;64;1084;1090;6;119;2.0
4;65;1090;1099;9;119;2.0
4;66;1099;1102;3;119;2.0
4;67;1102;1149;47;119;2.0
4;68;1149;1172;23;119;2.0
4;69;1172;1209;37;119;2.0
4;70;1209;1222;13;119;2.0
4;71;1222;1269;47;119;2.0
4;72;1269;1282;13;119;2.0
4;73;1282;1319;37;119;2.0
4;74;1319;1339;20;119;2.0
4;75;1339;1383;44;119;2.0
4;76;1383;1387;4;119;2.0
4;77;1387;1402;15;119;2.0
4;78;1402;1417;15;119;2.0
4;79;1417;1432;15;119;2.0
4;80;1432;1447;15;119;2.0
4;81;1447;1462;15;119;2.0
4;82;1462;1477;15;119;2.0
4;83;1477;1492;15;119;2.0
4;84;1492;1507;15;119;2.0
4;85;1507;1522;15;119;2.0
4;86;1522;1537;15;119;2.0
4;87;1537;1552;15;119;2.0
4;88;1552;1567;15;119;2.0
4;89;1567;1582;15;119;2.0
4;90;1582;1597;15;119;2.0
4;91;1597;1612;15;119;2.0
4;92;1612;1627;15;119;2.0
4;93;1627;1642;15;119;2.0
4;94;1642;1657;15;119;2.0
4;95;1657;1672;15;119;2.0
4;96;1672;1680;8;119;2.0
5;0;243;335;92;96;2.0
5;1;335;338;3;96;2.0
5;2;338;350;12;96;2.0
5;3;350;358;8;96;2.0
5;4;358;365;7;96;2.0
5;5;365;373;8;96;2.0
5;6;373;385;12;96;2.0
5;7;385;393;8;96;2.0
5;8;393;400;7;96;2.0
5;9;400;408;8;96;2.0
5;10;408;420;12;96;2.0
5;11;420;421;1;96;2.0
5;12;421;428;7;96;2.0
5;13;428;443;15;96;2.0
5;14;443;453;10;96;2.0
5;15;453;455;2;96;2.0
5;16;455;456;1;96;2.0
5;17;456;463;7;96;2.0
5;18;463;466;3;96;2.0
5;19;466;476;10;96;2.0
5;20;476;498;22;96;2.0
5;21;498;507;9;96;2.0
5;22;507;516;9;96;2.0
5;23;516;528;12;96;2.0
5;24;528;535;7;96;2.0
5;25;535;546;11;96;2.0
5;26;546;552;6;96;2.0
5;27;552;583;31;96;2.0
5;28;583;596;13;96;2.0
5;29;596;633;37;96;2.0
5;30;633;660;27;96;2.0
5;31;660;703;43;96;2.0
5;32;703;721;18;96;2.0
5;33;721;750;29;96;2.0
5;34;750;763;13;96;2.0
5;35;763;781;18;96;2.0
5;36;781;798;17;96;2.0
5;37;798;823;25;96;2.0
5;38;823;825;2;96;2.0
5;39;825;836;11;96;2.0
5;40;836;848;12;96;2.0
5;41;848;868;20;96;2.0
5;42;868;875;7;96;2.0
5;43;875;883;8;96;2.0
5;44;883;891;8;96;2.0
5;45;891;903;12;96;2.0
5;46;903;906;3;96;2.0
5;47;906;918;12;96;2.0
5;48;918;935;17;96;2.0
5;49;935;941;6;96;2.0
5;50;941;943;2;96;2.0
5;51;943;958;15;96;2.0
5;52;958;961;3;96;2.0
5;53;961;978;17;96;2.0
5;54;978;981;3;96;2.0
5;55;981;996;15;96;2.0
5;56;996;998;2;96;2.0
5;57;998;1025;27;96;2.0
5;58;1025;1028;3;96;2.0
5;59;1028;1046;18;96;2.0
5;60;1046;1048;2;96;2.0
5;61;1048;1068;20;96;2.0
5;62;1068;1080;12;96;2.0
5;63;1080;1086;6;96;2.0
5;64;1086;1088;2;96;2.0
5;65;1088;1101;13;96;2.0
5;66;1101;1104;3;96;2.0
5;67;1104;1147;43;96;2.0
5;68;1147;1174;27;96;2.0
5;69;1174;1207;33;96;2.0
5;70;1207;1224;17;96;2.0
5;71;1224;1267;43;96;2.0
5;72;1267;1284;17;96;2.0
5;73;1284;1317;33;96;2.0
5;74;1317;1341;24;96;2.0
5;75;1341;1381;40;96;2.0
5;76;1381;1389;8;96;2.0
5;77;1389;1404;15;96;2.0
5;78;1404;1419;15;96;2.0
5;79;1419;1434;15;96;2.0
5;80;1434;1449;15;96;2.0
5;81;1449;1464;15;96;2.0
5;82;1464;1479;15;96;2.0
5;83;1479;1494;15;96;2.0
5;84;1494;1509;15;96;2.0
5;85;1509;1524;15;96;2.0
5;86;1524;1539;15;96;2.0
5;87;1539;1554;15;96;2.0
5;88;1554;1569;15;96;2.0
5;89;1569;1584;15;96;2.0
5;90;1584;1599;15;96;2.0
5;91;1599;1614;15;96;2.0
5;92;1614;1629;15;96;2.0
5;93;1629;1644;15;96;2.0
5;94;1644;1659;15;96;2.0
5;95;1659;1674;15;96;2.0
5;96;1674;1680;6;96;2.0
6;0;252;337;85;160;2.0
6;1;337;348;11;160;2.0
6;2;348;352;4;160;2.0
6;3;352;367;15;160;2.0
6;4;367;368;1;160;2.0
6;5;368;383;15;160;2.0
6;6;383;387;4;160;2.0
6;7;387;402;15;160;2.0
6;8;402;403;1;160;2.0
6;9;403;418;15;160;2.0
6;10;418;422;4;160;2.0
6;11;422;425;3;160;2.0
6;12;425;438;13;160;2.0
6;13;438;453;15;160;2.0
6;14;453;457;4;160;2.0
6;15;457;460;3;160;2.0
6;16;460;463;3;160;2.0
6;17;463;470;7;160;2.0
6;18;470;473;3;160;2.0
6;19;473;480;7;160;2.0
6;20;480;508;28;160;2.0
6;21;508;511;3;160;2.0
6;22;511;520;9;160;2.0
6;23;520;537;17;160;2.0
6;24;537;538;1;160;2.0
6;25;538;550;12;160;2.0
6;26;550;556;6;160;2.0
6;27;556;593;37;160;2.0
6;28;593;600;7;160;2.0
6;29;600;643;43;160;2.0
6;30;643;662;19;160;2.0
6;31;662;713;51;160;2.0
6;32;713;725;12;160;2.0
6;33;725;752;27;160;2.0
6;34;752;773;21;160;2.0
6;35;773;785;12;160;2.0
6;36;785;808;23;160;2.0
6;37;808;827;19;160;2.0
6;38;827;833;6;160;2.0
6;39;833;840;7;160;2.0
6;40;840;858;18;160;2.0
6;41;858;877;19;160;2.0
6;42;877;878;1;160;2.0
6;43;878;893;15;160;2.0
6;44;893;895;2;160;2.0
6;45;895;910;15;160;2.0
6;46;910;913;3;160;2.0
6;47;913;928;15;160;2.0
6;48;928;937;9;160;2.0
6;49;937;945;8;160;2.0
6;50;945;953;8;160;2.0
6;51;953;965;12;160;2.0
6;52;965;968;3;160;2.0
6;53;968;985;17;160;2.0
6;54;985;988;3;160;2.0
6;55;988;1000;12;160;2.0
6;56;1000;1008;8;160;2.0
6;57;1008;1027;19;160;2.0
6;58;1027;1038;11;160;2.0
6;59;1038;1050;12;160;2.0
6;60;1050;1058;8;160;2.0
6;61;1058;1078;20;160;2.0
6;62;1078;1082;4;160;2.0
6;63;1082;1090;8;160;2.0
6;64;1090;1098;8;160;2.0
6;65;1098;1105;7;160;2.0
6;66;1105;1108;3;160;2.0
6;67;1108;1157;49;160;2.0
6;68;1157;1178;21;160;2.0
6;69;1178;1217;39;160;2.0
6;70;1217;1228;11;160;2.0
6;71;1228;1277;49;160;2.0
6;72;1277;1288;11;160;2.0
6;73;1288;1327;39;160;2.0
6;74;1327;1343;16;160;2.0
6;75;1343;1391;48;160;2.0
6;76;1391;1393;2;160;2.0
6;77;1393;1408;15;160;2.0
6;78;1408;1423;15;160;2.0
6;79;1423;1438;15;160;2.0
6;80;1438;1453;15;160;2.0
6;81;1453;1468;15;160;2.0
6;82;1468;1483;15;160;2.0
6;83;1483;1498;15;160;2.0
6;84;1498;1513;15;160;2.0
6;85;1513;1528;15;160;2.0
6;86;1528;1543;15;160;2.0
6;87;1543;1558;15;160;2.0
6;88;1558;1573;15;160;2.0
6;89;1573;1588;15;160;2.0
6;90;1588;1603;15;160;2.0
6;91;1603;1618;15;160;2.0
6;92;1618;1633;15;160;2.0
6;93;1633;1648;15;160;2.0
6;94;1648;1663;15;160;2.0
6;95;1663;1680;17;160;2.0
7;0;250;333;83;1;2.0
7;1;333;346;13;1;2.0
7;2;346;348;2;1;2.0
7;3;348;363;15;1;2.0
7;4;363;366;3;1;2.0
7;5;366;381;15;1;2.0
7;6;381;383;2;1;2.0
7;7;383;398;15;1;2.0
7;8;398;401;3;1;2.0
7;9;401;416;15;1;2.0
7;10;416;418;2;1;2.0
7;11;418;423;5;1;2.0
7;12;423;436;13;1;2.0
7;13;436;451;15;1;2.0
7;14;451;453;2;1;2.0
7;15;453;458;5;1;2.0
7;16;458;461;3;1;2.0
7;17;461;468;7;1;2.0
7;18;468;471;3;1;2.0
7;19;471;478;7;1;2.0
7;20;478;506;28;1;2.0
7;21;506;509;3;1;2.0
7;22;509;518;9;1;2.0
7;23;518;533;15;1;2.0
7;24;533;536;3;1;2.0
7;25;536;548;12;1;2.0
7;26;548;554;6;1;2.0
7;27;554;591;37;1;2.0
7;28;591;598;7;1;2.0
7;29;598;641;43;1;2.0
7;30;641;658;17;1;2.0
7;31;658;711;53;1;2.0
7;32;711;723;12;1;2.0
7;33;723;748;25;1;2.0
7;34;748;771;23;1;2.0
7;35;771;783;12;1;2.0
7;36;783;806;23;1;2.0
7;37;806;823;17;1;2.0
7;38;823;831;8;1;2.0
7;39;831;838;7;1;2.0
7;40;838;856;18;1;2.0
7;41;856;873;17;1;2.0
7;42;873;876;3;1;2.0
7;43;876;891;15;1;2.0
7;44;891;893;2;1;2.0
7;45;893;908;15;1;2.0
7;46;908;911;3;1;2.0
7;47;911;926;15;1;2.0
7;48;926;933;7;1;2.0
7;49;933;943;10;1;2.0
7;50;943;951;8;1;2.0
7;51;951;963;12;1;2.0
7;52;963;966;3;1;2.0
7;53;966;983;17;1;2.0
7;54;983;986;3;1;2.0
7;55;986;998;12;1;2.0
7;56;998;1006;8;1;2.0
7;57;1006;1023;17;1;2.0
7;58;1023;1036;13;1;2.0
7;59;1036;1048;12;1;2.0
7;60;1048;1056;8;1;2.0
7;61;1056;1076;20;1;2.0
7;62;1076;1078;2;1;2.0
7;63;1078;1088;10;1;2.0
7;64;1088;1096;8;1;2.0
7;65;1096;1103;7;1;2.0
7;66;1103;1106;3;1;2.0
7;67;1106;1155;49;1;2.0
7;68;1155;1176;21;1;2.0
7;69;1176;1215;39;1;2.0
7;70;1215;1226;11;1;2.0
7;71;1226;1275;49;1;2.0
7;72;1275;1286;11;1;2.0
7;73;1286;1325;39;1;2.0
7;74;1325;1339;14;1;2.0
7;75;1339;1389;50;1;2.0
7;76;1389;1391;2;1;2.0
7;77;1391;1406;15;1;2.0
7;78;1406;1421;15;1;2.0
7;79;1421;1436;15;1;2.0
7;80;1436;1451;15;1;2.0
7;81;1451;1466;15;1;2.0
7;82;1466;1481;15;1;2.0
7;83;1481;1496;15;1;2.0
7;84;1496;1511;15;1;2.0
7;85;1511;1526;15;1;2.0
7;86;1526;1541;15;1;2.0
7;87;1541;1556;15;1;2.0
7;88;1556;1571;15;1;2.0
7;89;1571;1586;15;1;2.0
7;90;1586;1601;15;1;2.0
7;91;1601;1616;15;1;2.0
7;92;1616;1631;15;1;2.0
7;93;1631;1646;15;1;2.0
7;94;1646;1661;15;1;2.0
7;95;1661;1680;19;1;2.0
8;0;250;337;87;43;2.0
8;1;337;339;2;43;2.0
8;2;339;352;13;43;2.0
8;3;352;359;7;43;2.0
8;4;359;367;8;43;2.0
8;5;367;374;7;43;2.0
8;6;374;387;13;43;2.0
8;7;387;394;7;43;2.0
8;8;394;402;8;43;2.0
8;9;402;409;7;43;2.0
8;10;409;422;13;43;2.0
8;11;422;429;7;43;2.0
8;12;429;444;15;43;2.0
8;13;444;454;10;43;2.0
8;14;454;457;3;43;2.0
8;15;457;464;7;43;2.0
8;16;464;467;3;43;2.0
8;17;467;477;10;43;2.0
8;18;477;499;22;43;2.0
8;19;499;508;9;43;2.0
8;20;508;517;9;43;2.0
8;21;517;529;12;43;2.0
8;22;529;537;8;43;2.0
8;23;537;547;10;43;2.0
8;24;547;553;6;43;2.0
8;25;553;584;31;43;2.0
8;26;584;597;13;43;2.0
8;27;597;634;37;43;2.0
8;28;634;662;28;43;2.0
8;29;662;704;42;43;2.0
8;30;704;722;18;43;2.0
8;31;722;752;30;43;2.0
8;32;752;764;12;43;2.0
8;33;764;782;18;43;2.0
8;34;782;799;17;43;2.0
8;35;799;824;25;43;2.0
8;36;824;827;3;43;2.0
8;37;827;837;10;43;2.0
8;38;837;849;12;43;2.0
8;39;849;869;20;43;2.0
8;40;869;877;8;43;2.0
8;41;877;884;7;43;2.0
8;42;884;892;8;43;2.0
8;43;892;904;12;43;2.0
8;44;904;907;3;43;2.0
8;45;907;919;12;43;2.0
8;46;919;937;18;43;2.0
8;47;937;942;5;43;2.0
8;48;942;944;2;43;2.0
8;49;944;959;15;43;2.0
8;50;959;962;3;43;2.0
8;51;962;979;17;43;2.0
8;52;979;982;3;43;2.0
8;53;982;997;15;43;2.0
8;54;997;999;2;43;2.0
8;55;999;1027;28;43;2.0
8;56;1027;1029;2;43;2.0
8;57;1029;1047;18;43;2.0
8;58;1047;1049;2;43;2.0
8;59;1049;1069;20;43;2.0
8;60;1069;1082;13;43;2.0
8;61;1082;1087;5;43;2.0
8;62;1087;1089;2;43;2.0
8;63;1089;1102;13;43;2.0
8;64;1102;1105;3;43;2.0
8;65;1105;1148;43;43;2.0
8;66;1148;1175;27;43;2.0
8;67;1175;1208;33;43;2.0
8;68;1208;1225;17;43;2.0
8;69;1225;1268;43;43;2.0
8;70;1268;1285;17;43;2.0
8;71;1285;1318;33;43;2.0
8;72;1318;1343;25;43;2.0
8;73;1343;1382;39;43;2.0
8;74;1382;1390;8;43;2.0
8;75;1390;1405;15;43;2.0
8;76;1405;1420;15;43;2.0
8;77;1420;1435;15;43;2.0
8;78;1435;1450;15;43;2.0
8;79;1450;1465;15;43;2.0
8;80;1465;1480;15;43;2.0
8;81;1480;1495;15;43;2.0
8;82;1495;1510;15;43;2.0
8;83;1510;1525;15;43;2.0
8;84;1525;1540;15;43;2.0
8;85;1540;1555;15;43;2.0
8;86;1555;1570;15;43;2.0
8;87;1570;1585;15;43;2.0
8;88;1585;1600;15;43;2.0
8;89;1600;1615;15;43;2.0
8;90;1615;1630;15;43;2.0
8;91;1630;1645;15;43;2.0
8;92;1645;1660;15;43;2.0
8;93;1660;1680;20;43;2.0
9;0;250;331;81;4;2.0
9;1;331;344;13;4;2.0
9;2;344;346;2;4;2.0
9;3;346;361;15;4;2.0
9;4;361;364;3;4;2.0
9;5;364;379;15;4;2.0
9;6;379;381;2;4;2.0
9;7;381;396;15;4;2.0
9;8;396;399;3;4;2.0
9;9;399;414;15;4;2.0
9;10;414;416;2;4;2.0
9;11;416;422;6;4;2.0
9;12;422;434;12;4;2.0
9;13;434;449;15;4;2.0
9;14;449;451;2;4;2.0
9;15;451;457;6;4;2.0
9;16;457;459;2;4;2.0
9;17;459;467;8;4;2.0
9;18;467;469;2;4;2.0
9;19;469;477;8;4;2.0
9;20;477;504;27;4;2.0
9;21;504;508;4;4;2.0
9;22;508;517;9;4;2.0
9;23;517;531;14;4;2.0
9;24;531;534;3;4;2.0
9;25;534;547;13;4;2.0
9;26;547;553;6;4;2.0
9;27;553;589;36;4;2.0
9;28;589;597;8;4;2.0
9;29;597;639;42;4;2.0
9;30;639;656;17;4;2.0
9;31;656;709;53;4;2.0
9;32;709;722;13;4;2.0
9;33;722;746;24;4;2.0
9;34;746;769;23;4;2.0
9;35;769;782;13;4;2.0
9;36;782;804;22;4;2.0
9;37;804;821;17;4;2.0
9;38;821;829;8;4;2.0
9;39;829;837;8;4;2.0
9;40;837;854;17;4;2.0
9;41;854;871;17;4;2.0
9;42;871;874;3;4;2.0
9;43;874;889;15;4;2.0
9;44;889;892;3;4;2.0
9;45;892;907;15;4;2.0
9;46;907;909;2;4;2.0
9;47;909;924;15;4;2.0
9;48;924;931;7;4;2.0
9;49;931;942;11;4;2.0
9;50;942;949;7;4;2.0
9;51;949;962;13;4;2.0
9;52;962;964;2;4;2.0
9;53;964;982;18;4;2.0
9;54;982;984;2;4;2.0
9;55;984;997;13;4;2.0
9;56;997;1004;7;4;2.0
9;57;1004;1021;17;4;2.0
9;58;1021;1034;13;4;2.0
9;59;1034;1047;13;4;2.0
9;60;1047;1054;7;4;2.0
9;61;1054;1074;20;4;2.0
9;62;1074;1076;2;4;2.0
9;63;1076;1087;11;4;2.0
9;64;1087;1094;7;4;2.0
9;65;1094;1102;8;4;2.0
9;66;1102;1105;3;4;2.0
9;67;1105;1153;48;4;2.0
9;68;1153;1175;22;4;2.0
9;69;1175;1213;38;4;2.0
9;70;1213;1225;12;4;2.0
9;71;1225;1273;48;4;2.0
9;72;1273;1285;12;4;2.0
9;73;1285;1323;38;4;2.0
9;74;1323;1337;14;4;2.0
9;75;1337;1387;50;4;2.0
9;76;1387;1390;3;4;2.0
9;77;1390;1405;15;4;2.0
9;78;1405;1420;15;4;2.0
9;79;1420;1435;15;4;2.0
9;80;1435;1450;15;4;2.0
9;81;1450;1465;15;4;2.0
9;82;1465;1480;15;4;2.0
9;83;1480;1495;15;4;2.0
9;84;1495;1510;15;4;2.0
9;85;1510;1525;15;4;2.0
9;86;1525;1540;15;4;2.0
9;87;1540;1555;15;4;2.0
9;88;1555;1570;15;4;2.0
9;89;1570;1585;15;4;2.0
9;90;1585;1600;15;4;2.0
9;91;1600;1615;15;4;2.0
9;92;1615;1630;15;4;2.0
9;93;1630;1645;15;4;2.0
9;94;1645;1660;15;4;2.0
9;95;1660;1680;20;4;2.0
10;0;252;337;85;11;2.0
10;1;337;338;1;11;2.0
10;2;338;352;14;11;2.0
10;3;352;358;6;11;2.0
10;4;358;367;9;11;2.0
10;5;367;373;6;11;2.0
10;6;373;387;14;11;2.0
10;7;387;393;6;11;2.0
10;8;393;402;9;11;2.0
10;9;402;408;6;11;2.0
10;10;408;422;14;11;2.0
10;11;422;423;1;11;2.0
10;12;423;428;5;11;2.0
10;13;428;443;15;11;2.0
10;14;443;453;10;11;2.0
10;15;453;457;4;11;2.0
10;16;457;458;1;11;2.0
10;17;458;463;5;11;2.0
10;18;463;468;5;11;2.0
10;19;468;478;10;11;2.0
10;20;478;498;20;11;2.0
10;21;498;509;11;11;2.0
10;22;509;518;9;11;2.0
10;23;518;528;10;11;2.0
10;24;528;537;9;11;2.0
10;25;537;548;11;11;2.0
10;26;548;554;6;11;2.0
10;27;554;583;29;11;2.0
10;28;583;598;15;11;2.0
10;29;598;633;35;11;2.0
10;30;633;662;29;11;2.0
10;31;662;703;41;11;2.0
10;32;703;723;20;11;2.0
10;33;723;752;29;11;2.0
10;34;752;763;11;11;2.0
10;35;763;783;20;11;2.0
10;36;783;798;15;11;2.0
10;37;798;823;25;11;2.0
10;38;823;827;4;11;2.0
10;39;827;838;11;11;2.0
10;40;838;848;10;11;2.0
10;41;848;868;20;11;2.0
10;42;868;877;9;11;2.0
10;43;877;883;6;11;2.0
10;44;883;893;10;11;2.0
10;45;893;903;10;11;2.0
10;46;903;908;5;11;2.0
10;47;908;918;10;11;2.0
10;48;918;937;19;11;2.0
10;49;937;943;6;11;2.0
10;50;943;958;15;11;2.0
10;51;958;963;5;11;2.0
10;52;963;978;15;11;2.0
10;53;978;983;5;11;2.0
10;54;983;998;15;11;2.0
10;55;998;1027;29;11;2.0
10;56;1027;1028;1;11;2.0
10;57;1028;1048;20;11;2.0
10;58;1048;1068;20;11;2.0
10;59;1068;1082;14;11;2.0
10;60;1082;1088;6;11;2.0
10;61;1088;1103;15;11;2.0
10;62;1103;1106;3;11;2.0
10;63;1106;1147;41;11;2.0
10;64;1147;1176;29;11;2.0
10;65;1176;1207;31;11;2.0
10;66;1207;1226;19;11;2.0
10;67;1226;1267;41;11;2.0
10;68;1267;1286;19;11;2.0
10;69;1286;1317;31;11;2.0
10;70;1317;1343;26;11;2.0
10;71;1343;1381;38;11;2.0
10;72;1381;1391;10;11;2.0
10;73;1391;1406;15;11;2.0
10;74;1406;1421;15;11;2.0
10;75;1421;1436;15;11;2.0
10;76;1436;1451;15;11;2.0
10;77;1451;1466;15;11;2.0
10;78;1466;1481;15;11;2.0
10;79;1481;1496;15;11;2.0
10;80;1496;1511;15;11;2.0
10;81;1511;1526;15;11;2.0
10;82;1526;1541;15;11;2.0
10;83;1541;1556;15;11;2.0
10;84;1556;1571;15;11;2.0
10;85;1571;1586;15;11;2.0
10;86;1586;1601;15;11;2.0
10;87;1601;1616;15;11;2.0
10;88;1616;1631;15;11;2.0
10;89;1631;1646;15;11;2.0
10;90;1646;1661;15;11;2.0
10;91;1661;1680;19;11;2.0
11;0;250;343;93;87;2.0
11;1;343;346;3;87;2.0
11;2;346;358;12;87;2.0
11;3;358;366;8;87;2.0
11;4;366;373;7;87;2.0
11;5;373;381;8;87;2.0
11;6;381;393;12;87;2.0
11;7;393;401;8;87;2.0
11;8;401;408;7;87;2.0
11;9;408;416;8;87;2.0
11;10;416;428;12;87;2.0
11;11;428;429;1;87;2.0
11;12;429;436;7;87;2.0
11;13;436;451;15;87;2.0
11;14;451;461;10;87;2.0
11;15;461;463;2;87;2.0
11;16;463;464;1;87;2.0
11;17;464;471;7;87;2.0
11;18;471;474;3;87;2.0
11;19;474;484;10;87;2.0
11;20;484;506;22;87;2.0
11;21;506;515;9;87;2.0
11;22;515;524;9;87;2.0
11;23;524;536;12;87;2.0
11;24;536;543;7;87;2.0
11;25;543;554;11;87;2.0
11;26;554;560;6;87;2.0
11;27;560;591;31;87;2.0
11;28;591;604;13;87;2.0
11;29;604;641;37;87;2.0
11;30;641;668;27;87;2.0
11;31;668;711;43;87;2.0
11;32;711;729;18;87;2.0
11;33;729;758;29;87;2.0
11;34;758;771;13;87;2.0
11;35;771;789;18;87;2.0
11;36;789;806;17;87;2.0
11;37;806;831;25;87;2.0
11;38;831;833;2;87;2.0
11;39;833;844;11;87;2.0
11;40;844;856;12;87;2.0
11;41;856;876;20;87;2.0
11;42;876;883;7;87;2.0
11;43;883;891;8;87;2.0
11;44;891;899;8;87;2.0
11;45;899;911;12;87;2.0
11;46;911;914;3;87;2.0
11;47;914;926;12;87;2.0
11;48;926;943;17;87;2.0
11;49;943;949;6;87;2.0
11;50;949;951;2;87;2.0
11;51;951;966;15;87;2.0
11;52;966;969;3;87;2.0
11;53;969;986;17;87;2.0
11;54;986;989;3;87;2.0
11;55;989;1004;15;87;2.0
11;56;1004;1006;2;87;2.0
11;57;1006;1033;27;87;2.0
11;58;1033;1036;3;87;2.0
11;59;1036;1054;18;87;2.0
11;60;1054;1056;2;87;2.0
11;61;1056;1076;20;87;2.0
11;62;1076;1088;12;87;2.0
11;63;1088;1094;6;87;2.0
11;64;1094;1096;2;87;2.0
11;65;1096;1109;13;87;2.0
11;66;1109;1112;3;87;2.0
11;67;1112;1155;43;87;2.0
11;68;1155;1182;27;87;2.0
11;69;1182;1215;33;87;2.0
11;70;1215;1232;17;87;2.0
11;71;1232;1275;43;87;2.0
11;72;1275;1292;17;87;2.0
11;73;1292;1325;33;87;2.0
11;74;1325;1349;24;87;2.0
11;75;1349;1389;40;87;2.0
11;76;1389;1397;8;87;2.0
11;77;1397;1412;15;87;2.0
11;78;1412;1427;15;87;2.0
11;79;1427;1442;15;87;2.0
11;80;1442;1457;15;87;2.0
11;81;1457;1472;15;87;2.0
11;82;1472;1487;15;87;2.0
11;83;1487;1502;15;87;2.0
11;84;1502;1517;15;87;2.0
11;85;1517;1532;15;87;2.0
11;86;1532;1547;15;87;2.0
11;87;1547;1562;15;87;2.0
11;88;1562;1577;15;87;2.0
11;89;1577;1592;15;87;2.0
11;90;1592;1607;15;87;2.0
11;91;1607;1622;15;87;2.0
11;92;1622;1637;15;87;2.0
11;93;1637;1652;15;87;2.0
11;94;1652;1667;15;87;2.0
11;95;1667;1680;13;87;2.0
12;0;246;336;90;72;2.0
12;1;336;342;6;72;2.0
12;2;342;351;9;72;2.0
12;3;351;362;11;72;2.0
12;4;362;366;4;72;2.0
12;5;366;377;11;72;2.0
12;6;377;386;9;72;2.0
12;7;386;397;11;72;2.0
12;8;397;401;4;72;2.0
12;9;401;412;11;72;2.0
12;10;412;421;9;72;2.0
12;11;421;423;2;72;2.0
12;12;423;432;9;72;2.0
12;13;432;447;15;72;2.0
12;14;447;456;9;72;2.0
12;15;456;457;1;72;2.0
12;16;457;458;1;72;2.0
12;17;458;467;9;72;2.0
12;18;467;468;1;72;2.0
12;19;468;478;10;72;2.0
12;20;478;502;24;72;2.0
12;21;502;509;7;72;2.0
12;22;509;518;9;72;2.0
12;23;518;532;14;72;2.0
12;24;532;536;4;72;2.0
12;25;536;548;12;72;2.0
12;26;548;554;6;72;2.0
12;27;554;587;33;72;2.0
12;28;587;598;11;72;2.0
12;29;598;637;39;72;2.0
12;30;637;661;24;72;2.0
12;31;661;707;46;72;2.0
12;32;707;723;16;72;2.0
12;33;723;751;28;72;2.0
12;34;751;767;16;72;2.0
12;35;767;783;16;72;2.0
12;36;783;802;19;72;2.0
12;37;802;826;24;72;2.0
12;38;826;827;1;72;2.0
12;39;827;838;11;72;2.0
12;40;838;852;14;72;2.0
12;41;852;872;20;72;2.0
12;42;872;876;4;72;2.0
12;43;876;887;11;72;2.0
12;44;887;893;6;72;2.0
12;45;893;907;14;72;2.0
12;46;907;908;1;72;2.0
12;47;908;922;14;72;2.0
12;48;922;936;14;72;2.0
12;49;936;943;7;72;2.0
12;50;943;947;4;72;2.0
12;51;947;962;15;72;2.0
12;52;962;963;1;72;2.0
12;53;963;982;19;72;2.0
12;54;982;983;1;72;2.0
12;55;983;998;15;72;2.0
12;56;998;1002;4;72;2.0
12;57;1002;1026;24;72;2.0
12;58;1026;1032;6;72;2.0
12;59;1032;1048;16;72;2.0
12;60;1048;1052;4;72;2.0
12;61;1052;1072;20;72;2.0
12;62;1072;1081;9;72;2.0
12;63;1081;1088;7;72;2.0
12;64;1088;1092;4;72;2.0
12;65;1092;1103;11;72;2.0
12;66;1103;1106;3;72;2.0
12;67;1106;1151;45;72;2.0
12;68;1151;1176;25;72;2.0
12;69;1176;1211;35;72;2.0
12;70;1211;1226;15;72;2.0
12;71;1226;1271;45;72;2.0
12;72;1271;1286;15;72;2.0
12;73;1286;1321;35;72;2.0
12;74;1321;1342;21;72;2.0
12;75;1342;1385;43;72;2.0
12;76;1385;1391;6;72;2.0
12;77;1391;1406;15;72;2.0
12;78;1406;1421;15;72;2.0
12;79;1421;1436;15;72;2.0
12;80;1436;1451;15;72;2.0
12;81;1451;1466;15;72;2.0
12;82;1466;1481;15;72;2.0
12;83;1481;1496;15;72;2.0
12;84;1496;1511;15;72;2.0
12;85;1511;1526;15;72;2.0
12;86;1526;1541;15;72;2.0
12;87;1541;1556;15;72;2.0
12;88;1556;1571;15;72;2.0
12;89;1571;1586;15;72;2.0
12;90;1586;1601;15;72;2.0
12;91;1601;1616;15;72;2.0
12;92;1616;1631;15;72;2.0
12;93;1631;1646;15;72;2.0
12;94;1646;1661;15;72;2.0
12;95;1661;1680;19;72;2.0
13;0;249;333;84;58;2.0
13;1;333;345;12;58;2.0
13;2;345;348;3;58;2.0
13;3;348;363;15;58;2.0
13;4;363;365;2;58;2.0
13;5;365;380;15;58;2.0
13;6;380;383;3;58;2.0
13;7;383;398;15;58;2.0
13;8;398;400;2;58;2.0
13;9;400;415;15;58;2.0
13;10;415;418;3;58;2.0
13;11;418;423;5;58;2.0
13;12;423;435;12;58;2.0
13;13;435;450;15;58;2.0
13;14;450;453;3;58;2.0
13;15;453;458;5;58;2.0
13;16;458;460;2;58;2.0
13;17;460;468;8;58;2.0
13;18;468;470;2;58;2.0
13;19;470;478;8;58;2.0
13;20;478;505;27;58;2.0
13;21;505;509;4;58;2.0
13;22;509;518;9;58;2.0
13;23;518;533;15;58;2.0
13;24;533;535;2;58;2.0
13;25;535;548;13;58;2.0
13;26;548;554;6;58;2.0
13;27;554;590;36;58;2.0
13;28;590;598;8;58;2.0
13;29;598;640;42;58;2.0
13;30;640;658;18;58;2.0
13;31;658;710;52;58;2.0
13;32;710;723;13;58;2.0
13;33;723;748;25;58;2.0
13;34;748;770;22;58;2.0
13;35;770;783;13;58;2.0
13;36;783;805;22;58;2.0
13;37;805;823;18;58;2.0
13;38;823;830;7;58;2.0
13;39;830;838;8;58;2.0
13;40;838;855;17;58;2.0
13;41;855;873;18;58;2.0
13;42;873;875;2;58;2.0
13;43;875;890;15;58;2.0
13;44;890;893;3;58;2.0
13;45;893;908;15;58;2.0
13;46;908;910;2;58;2.0
13;47;910;925;15;58;2.0
13;48;925;933;8;58;2.0
13;49;933;943;10;58;2.0
13;50;943;950;7;58;2.0
13;51;950;963;13;58;2.0
13;52;963;965;2;58;2.0
13;53;965;983;18;58;2.0
13;54;983;985;2;58;2.0
13;55;985;998;13;58;2.0
13;56;998;1005;7;58;2.0
13;57;1005;1023;18;58;2.0
13;58;1023;1035;12;58;2.0
13;59;1035;1048;13;58;2.0
13;60;1048;1055;7;58;2.0
13;61;1055;1075;20;58;2.0
13;62;1075;1078;3;58;2.0
13;63;1078;1088;10;58;2.0
13;64;1088;1095;7;58;2.0
13;65;1095;1103;8;58;2.0
13;66;1103;1106;3;58;2.0
13;67;1106;1154;48;58;2.0
13;68;1154;1176;22;58;2.0
13;69;1176;1214;38;58;2.0
13;70;1214;1226;12;58;2.0
13;71;1226;1274;48;58;2.0
13;72;1274;1286;12;58;2.0
13;73;1286;1324;38;58;2.0
13;74;1324;1339;15;58;2.0
13;75;1339;1388;49;58;2.0
13;76;1388;1391;3;58;2.0
13;77;1391;1406;15;58;2.0
13;78;1406;1421;15;58;2.0
13;79;1421;1436;15;58;2.0
13;80;1436;1451;15;58;2.0
13;81;1451;1466;15;58;2.0
13;82;1466;1481;15;58;2.0
13;83;1481;1496;15;58;2.0
13;84;1496;1511;15;58;2.0
13;85;1511;1526;15;58;2.0
13;86;1526;1541;15;58;2.0
13;87;1541;1556;15;58;2.0
13;88;1556;1571;15;58;2.0
13;89;1571;1586;15;58;2.0
13;90;1586;1601;15;58;2.0
13;91;1601;1616;15;58;2.0
13;92;1616;1631;15;58;2.0
13;93;1631;1646;15;58;2.0
13;94;1646;1661;15;58;2.0
13;95;1661;1680;19;58;2.0
14;0;257;324;67;115;2.0
14;1;324;344;20;115;2.0
14;2;344;359;15;115;2.0
14;3;359;374;15;115;2.0
14;4;374;379;5;115;2.0
14;5;379;394;15;115;2.0
14;6;394;409;15;115;2.0
14;7;409;414;5;115;2.0
14;8;414;429;15;115;2.0
14;9;429;439;10;115;2.0
14;10;439;449;10;115;2.0
14;11;449;464;15;115;2.0
14;12;464;474;10;115;2.0
14;13;474;484;10;115;2.0
14;14;484;514;30;115;2.0
14;15;514;515;1;115;2.0
14;16;515;524;9;115;2.0
14;17;524;544;20;115;2.0
14;18;544;554;10;115;2.0
14;19;554;560;6;115;2.0
14;20;560;569;9;115;2.0
14;21;569;604;35;115;2.0
14;22;604;619;15;115;2.0
14;23;619;669;50;115;2.0
14;24;669;689;20;115;2.0
14;25;689;729;40;115;2.0
14;26;729;749;20;115;2.0
14;27;749;759;10;115;2.0
14;28;759;784;25;115;2.0
14;29;784;789;5;115;2.0
14;30;789;809;20;115;2.0
14;31;809;834;25;115;2.0
14;32;834;844;10;115;2.0
14;33;844;854;10;115;2.0
14;34;854;869;15;115;2.0
14;35;869;884;15;115;2.0
14;36;884;889;5;115;2.0
14;37;889;899;10;115;2.0
14;38;899;904;5;115;2.0
14;39;904;914;10;115;2.0
14;40;914;929;15;115;2.0
14;41;929;944;15;115;2.0
14;42;944;949;5;115;2.0
14;43;949;964;15;115;2.0
14;44;964;969;5;115;2.0
14;45;969;984;15;115;2.0
14;46;984;989;5;115;2.0
14;47;989;1004;15;115;2.0
14;48;1004;1014;10;115;2.0
14;49;1014;1034;20;115;2.0
14;50;1034;1054;20;115;2.0
14;51;1054;1074;20;115;2.0
14;52;1074;1089;15;115;2.0
14;53;1089;1094;5;115;2.0
14;54;1094;1109;15;115;2.0
14;55;1109;1112;3;115;2.0
14;56;1112;1133;21;115;2.0
14;57;1133;1182;49;115;2.0
14;58;1182;1193;11;115;2.0
14;59;1193;1232;39;115;2.0
14;60;1232;1253;21;115;2.0
14;61;1253;1292;39;115;2.0
14;62;1292;1303;11;115;2.0
14;63;1303;1350;47;115;2.0
14;64;1350;1367;17;115;2.0
14;65;1367;1397;30;115;2.0
14;66;1397;1412;15;115;2.0
14;67;1412;1427;15;115;2.0
14;68;1427;1442;15;115;2.0
14;69;1442;1457;15;115;2.0
14;70;1457;1472;15;115;2.0
14;71;1472;1487;15;115;2.0
14;72;1487;1502;15;115;2.0
14;73;1502;1517;15;115;2.0
14;74;1517;1532;15;115;2.0
14;75;1532;1547;15;115;2.0
14;76;1547;1562;15;115;2.0
14;77;1562;1577;15;115;2.0
14;78;1577;1592;15;115;2.0
14;79;1592;1607;15;115;2.0
14;80;1607;1622;15;115;2.0
14;81;1622;1637;15;115;2.0
14;82;1637;1652;15;115;2.0
14;83;1652;1680;28;115;2.0
15;0;260;341;81;159;2.0
15;1;341;351;10;159;2.0
15;2;351;356;5;159;2.0
15;3;356;371;15;159;2.0
15;4;371;386;15;159;2.0
15;5;386;391;5;159;2.0
15;6;391;406;15;159;2.0
15;7;406;421;15;159;2.0
15;8;421;426;5;159;2.0
15;9;426;430;4;159;2.0
15;10;430;441;11;159;2.0
15;11;441;456;15;159;2.0
15;12;456;461;5;159;2.0
15;13;461;465;4;159;2.0
15;14;465;466;1;159;2.0
15;15;466;475;9;159;2.0
15;16;475;476;1;159;2.0
15;17;476;485;9;159;2.0
15;18;485;511;26;159;2.0
15;19;511;516;5;159;2.0
15;20;516;525;9;159;2.0
15;21;525;541;16;159;2.0
15;22;541;555;14;159;2.0
15;23;555;561;6;159;2.0
15;24;561;596;35;159;2.0
15;25;596;605;9;159;2.0
15;26;605;646;41;159;2.0
15;27;646;666;20;159;2.0
15;28;666;716;50;159;2.0
15;29;716;730;14;159;2.0
15;30;730;756;26;159;2.0
15;31;756;776;20;159;2.0
15;32;776;790;14;159;2.0
15;33;790;811;21;159;2.0
15;34;811;831;20;159;2.0
15;35;831;836;5;159;2.0
15;36;836;845;9;159;2.0
15;37;845;861;16;159;2.0
15;38;861;881;20;159;2.0
15;39;881;896;15;159;2.0
15;40;896;900;4;159;2.0
15;41;900;915;15;159;2.0
15;42;915;916;1;159;2.0
15;43;916;931;15;159;2.0
15;44;931;941;10;159;2.0
15;45;941;950;9;159;2.0
15;46;950;956;6;159;2.0
15;47;956;970;14;159;2.0
15;48;970;971;1;159;2.0
15;49;971;990;19;159;2.0
15;50;990;991;1;159;2.0
15;51;991;1005;14;159;2.0
15;52;1005;1011;6;159;2.0
15;53;1011;1031;20;159;2.0
15;54;1031;1041;10;159;2.0
15;55;1041;1055;14;159;2.0
15;56;1055;1061;6;159;2.0
15;57;1061;1081;20;159;2.0
15;58;1081;1086;5;159;2.0
15;59;1086;1095;9;159;2.0
15;60;1095;1101;6;159;2.0
15;61;1101;1110;9;159;2.0
15;62;1110;1113;3;159;2.0
15;63;1113;1160;47;159;2.0
15;64;1160;1183;23;159;2.0
15;65;1183;1220;37;159;2.0
15;66;1220;1233;13;159;2.0
15;67;1233;1280;47;159;2.0
15;68;1280;1293;13;159;2.0
15;69;1293;1330;37;159;2.0
15;70;1330;1347;17;159;2.0
15;71;1347;1394;47;159;2.0
15;72;1394;1398;4;159;2.0
15;73;1398;1413;15;159;2.0
15;74;1413;1428;15;159;2.0
15;75;1428;1443;15;159;2.0
15;76;1443;1458;15;159;2.0
15;77;1458;1473;15;159;2.0
15;78;1473;1488;15;159;2.0
15;79;1488;1503;15;159;2.0
15;80;1503;1518;15;159;2.0
15;81;1518;1533;15;159;2.0
15;82;1533;1548;15;159;2.0
15;83;1548;1563;15;159;2.0
15;84;1563;1578;15;159;2.0
15;85;1578;1593;15;159;2.0
15;86;1593;1608;15;159;2.0
15;87;1608;1623;15;159;2.0
15;88;1623;1638;15;159;2.0
15;89;1638;1653;15;159;2.0
15;90;1653;1680;27;159;2.0
16;0;247;335;88;14;2.0
16;1;335;350;15;14;2.0
16;2;350;355;5;14;2.0
16;3;355;365;10;14;2.0
16;4;365;370;5;14;2.0
16;5;370;385;15;14;2.0
16;6;385;390;5;14;2.0
16;7;390;400;10;14;2.0
16;8;400;405;5;14;2.0
16;9;405;420;15;14;2.0
16;10;420;421;1;14;2.0
16;11;421;425;4;14;2.0
16;12;425;440;15;14;2.0
16;13;440;450;10;14;2.0
16;14;450;455;5;14;2.0
16;15;455;456;1;14;2.0
16;16;456;460;4;14;2.0
16;17;460;466;6;14;2.0
16;18;466;476;10;14;2.0
16;19;476;495;19;14;2.0
16;20;495;507;12;14;2.0
16;21;507;516;9;14;2.0
16;22;516;525;9;14;2.0
16;23;525;535;10;14;2.0
16;24;535;546;11;14;2.0
16;25;546;552;6;14;2.0
16;26;552;580;28;14;2.0
16;27;580;596;16;14;2.0
16;28;596;630;34;14;2.0
16;29;630;660;30;14;2.0
16;30;660;700;40;14;2.0
16;31;700;721;21;14;2.0
16;32;721;750;29;14;2.0
16;33;750;760;10;14;2.0
16;34;760;781;21;14;2.0
16;35;781;795;14;14;2.0
16;36;795;820;25;14;2.0
16;37;820;825;5;14;2.0
16;38;825;836;11;14;2.0
16;39;836;845;9;14;2.0
16;40;845;865;20;14;2.0
16;41;865;875;10;14;2.0
16;42;875;880;5;14;2.0
16;43;880;891;11;14;2.0
16;44;891;900;9;14;2.0
16;45;900;906;6;14;2.0
16;46;906;915;9;14;2.0
16;47;915;935;20;14;2.0
16;48;935;940;5;14;2.0
16;49;940;941;1;14;2.0
16;50;941;955;14;14;2.0
16;51;955;961;6;14;2.0
16;52;961;975;14;14;2.0
16;53;975;981;6;14;2.0
16;54;981;995;14;14;2.0
16;55;995;996;1;14;2.0
16;56;996;1025;29;14;2.0
16;57;1025;1045;20;14;2.0
16;58;1045;1046;1;14;2.0
16;59;1046;1065;19;14;2.0
16;60;1065;1080;15;14;2.0
16;61;1080;1085;5;14;2.0
16;62;1085;1086;1;14;2.0
16;63;1086;1101;15;14;2.0
16;64;1101;1104;3;14;2.0
16;65;1104;1144;40;14;2.0
16;66;1144;1174;30;14;2.0
16;67;1174;1204;30;14;2.0
16;68;1204;1224;20;14;2.0
16;69;1224;1264;40;14;2.0
16;70;1264;1284;20;14;2.0
16;71;1284;1314;30;14;2.0
16;72;1314;1341;27;14;2.0
16;73;1341;1378;37;14;2.0
16;74;1378;1389;11;14;2.0
16;75;1389;1404;15;14;2.0
16;76;1404;1419;15;14;2.0
16;77;1419;1434;15;14;2.0
16;78;1434;1449;15;14;2.0
16;79;1449;1464;15;14;2.0
16;80;1464;1479;15;14;2.0
16;81;1479;1494;15;14;2.0
16;82;1494;1509;15;14;2.0
16;83;1509;1524;15;14;2.0
16;84;1524;1539;15;14;2.0
16;85;1539;1554;15;14;2.0
16;86;1554;1569;15;14;2.0
16;87;1569;1584;15;14;2.0
16;88;1584;1599;15;14;2.0
16;89;1599;1614;15;14;2.0
16;90;1614;1629;15;14;2.0
16;91;1629;1644;15;14;2.0
16;92;1644;1659;15;14;2.0
16;93;1659;1680;21;14;2.0
17;0;252;338;86;99;2.0
17;1;338;341;3;99;2.0
17;2;341;353;12;99;2.0
17;3;353;361;8;99;2.0
17;4;361;368;7;99;2.0
17;5;368;376;8;99;2.0
17;6;376;388;12;99;2.0
17;7;388;396;8;99;2.0
17;8;396;403;7;99;2.0
17;9;403;411;8;99;2.0
17;10;411;423;12;99;2.0
17;11;423;424;1;99;2.0
17;12;424;431;7;99;2.0
17;13;431;446;15;99;2.0
17;14;446;456;10;99;2.0
17;15;456;458;2;99;2.0
17;16;458;459;1;99;2.0
17;17;459;466;7;99;2.0
17;18;466;469;3;99;2.0
17;19;469;479;10;99;2.0
17;20;479;501;22;99;2.0
17;21;501;510;9;99;2.0
17;22;510;519;9;99;2.0
17;23;519;531;12;99;2.0
17;24;531;538;7;99;2.0
17;25;538;549;11;99;2.0
17;26;549;555;6;99;2.0
17;27;555;586;31;99;2.0
17;28;586;599;13;99;2.0
17;29;599;636;37;99;2.0
17;30;636;663;27;99;2.0
17;31;663;706;43;99;2.0
17;32;706;724;18;99;2.0
17;33;724;753;29;99;2.0
17;34;753;766;13;99;2.0
17;35;766;784;18;99;2.0
17;36;784;801;17;99;2.0
17;37;801;826;25;99;2.0
17;38;826;828;2;99;2.0
17;39;828;839;11;99;2.0
17;40;839;851;12;99;2.0
17;41;851;871;20;99;2.0
17;42;871;878;7;99;2.0
17;43;878;886;8;99;2.0
17;44;886;894;8;99;2.0
17;45;894;906;12;99;2.0
17;46;906;909;3;99;2.0
17;47;909;921;12;99;2.0
17;48;921;938;17;99;2.0
17;49;938;944;6;99;2.0
17;50;944;946;2;99;2.0
17;51;946;961;15;99;2.0
17;52;961;964;3;99;2.0
17;53;964;981;17;99;2.0
17;54;981;984;3;99;2.0
17;55;984;999;15;99;2.0
17;56;999;1001;2;99;2.0
17;57;1001;1028;27;99;2.0
17;58;1028;1031;3;99;2.0
17;59;1031;1049;18;99;2.0
17;60;1049;1051;2;99;2.0
17;61;1051;1071;20;99;2.0
17;62;1071;1083;12;99;2.0
17;63;1083;1089;6;99;2.0
17;64;1089;1091;2;99;2.0
17;65;1091;1104;13;99;2.0
17;66;1104;1107;3;99;2.0
17;67;1107;1150;43;99;2.0
17;68;1150;1177;27;99;2.0
17;69;1177;1210;33;99;2.0
17;70;1210;1227;17;99;2.0
17;71;1227;1270;43;99;2.0
17;72;1270;1287;17;99;2.0
17;73;1287;1320;33;99;2.0
17;74;1320;1344;24;99;2.0
17;75;1344;1384;40;99;2.0
17;76;1384;1392;8;99;2.0
17;77;1392;1407;15;99;2.0
17;78;1407;1422;15;99;2.0
17;79;1422;1437;15;99;2.0
17;80;1437;1452;15;99;2.0
17;81;1452;1467;15;99;2.0
17;82;1467;1482;15;99;2.0
17;83;1482;1497;15;99;2.0
17;84;1497;1512;15;99;2.0
17;85;1512;1527;15;99;2.0
17;86;1527;1542;15;99;2.0
17;87;1542;1557;15;99;2.0
17;88;1557;1572;15;99;2.0
17;89;1572;1587;15;99;2.0
17;90;1587;1602;15;99;2.0
17;91;1602;1617;15;99;2.0
17;92;1617;1632;15;99;2.0
17;93;1632;1647;15;99;2.0
17;94;1647;1662;15;99;2.0
17;95;1662;1680;18;99;2.0
18;0;246;335;89;501;2.0
18;1;335;342;7;501;2.0
18;2;342;350;8;501;2.0
18;3;350;362;12;501;2.0
18;4;362;365;3;501;2.0
18;5;365;377;12;501;2.0
18;6;377;385;8;501;2.0
18;7;385;397;12;501;2.0
18;8;397;400;3;501;2.0
18;9;400;412;12;501;2.0
18;10;412;420;8;501;2.0
18;11;420;421;1;501;2.0
18;12;421;432;11;501;2.0
18;13;432;447;15;501;2.0
18;14;447;455;8;501;2.0
18;15;455;456;1;501;2.0
18;16;456;457;1;501;2.0
18;17;457;466;9;501;2.0
18;18;466;467;1;501;2.0
18;19;467;476;9;501;2.0
18;20;476;502;26;501;2.0
18;21;502;507;5;501;2.0
18;22;507;516;9;501;2.0
18;23;516;532;16;501;2.0
18;24;532;535;3;501;2.0
18;25;535;546;11;501;2.0
18;26;546;552;6;501;2.0
18;27;552;587;35;501;2.0
18;28;587;596;9;501;2.0
18;29;596;637;41;501;2.0
18;30;637;660;23;501;2.0
18;31;660;707;47;501;2.0
18;32;707;721;14;501;2.0
18;33;721;750;29;501;2.0
18;34;750;767;17;501;2.0
18;35;767;781;14;501;2.0
18;36;781;802;21;501;2.0
18;37;802;825;23;501;2.0
18;38;825;827;2;501;2.0
18;39;827;836;9;501;2.0
18;40;836;852;16;501;2.0
18;41;852;872;20;501;2.0
18;42;872;875;3;501;2.0
18;43;875;887;12;501;2.0
18;44;887;891;4;501;2.0
18;45;891;906;15;501;2.0
18;46;906;907;1;501;2.0
18;47;907;922;15;501;2.0
18;48;922;935;13;501;2.0
18;49;935;941;6;501;2.0
18;50;941;947;6;501;2.0
18;51;947;961;14;501;2.0
18;52;961;962;1;501;2.0
18;53;962;981;19;501;2.0
18;54;981;982;1;501;2.0
18;55;982;996;14;501;2.0
18;56;996;1002;6;501;2.0
18;57;1002;1025;23;501;2.0
18;58;1025;1032;7;501;2.0
18;59;1032;1046;14;501;2.0
18;60;1046;1052;6;501;2.0
18;61;1052;1072;20;501;2.0
18;62;1072;1080;8;501;2.0
18;63;1080;1086;6;501;2.0
18;64;1086;1092;6;501;2.0
18;65;1092;1101;9;501;2.0
18;66;1101;1104;3;501;2.0
18;67;1104;1151;47;501;2.0
18;68;1151;1174;23;501;2.0
18;69;1174;1211;37;501;2.0
18;70;1211;1224;13;501;2.0
18;71;1224;1271;47;501;2.0
18;72;1271;1284;13;501;2.0
18;73;1284;1321;37;501;2.0
18;74;1321;1341;20;501;2.0
18;75;1341;1385;44;501;2.0
18;76;1385;1389;4;501;2.0
18;77;1389;1404;15;501;2.0
18;78;1404;1419;15;501;2.0
18;79;1419;1434;15;501;2.0
18;80;1434;1449;15;501;2.0
18;81;1449;1464;15;501;2.0
18;82;1464;1479;15;501;2.0
18;83;1479;1494;15;501;2.0
18;84;1494;1509;15;501;2.0
18;85;1509;1524;15;501;2.0
18;86;1524;1539;15;501;2.0
18;87;1539;1554;15;501;2.0
18;88;1554;1569;15;501;2.0
18;89;1569;1584;15;501;2.0
18;90;1584;1599;15;501;2.0
18;91;1599;1614;15;501;2.0
18;92;1614;1629;15;501;2.0
18;93;1629;1644;15;501;2.0
18;94;1644;1659;15;501;2.0
18;95;1659;1680;21;501;2.0
19;0;250;342;92;66;2.0
19;1;342;345;3;66;2.0
19;2;345;357;12;66;2.0
19;3;357;365;8;66;2.0
19;4;365;372;7;66;2.0
19;5;372;380;8;66;2.0
19;6;380;392;12;66;2.0
19;7;392;400;8;66;2.0
19;8;400;407;7;66;2.0
19;9;407;415;8;66;2.0
19;10;415;427;12;66;2.0
19;11;427;428;1;66;2.0
19;12;428;435;7;66;2.0
19;13;435;450;15;66;2.0
19;14;450;460;10;66;2.0
19;15;460;462;2;66;2.0
19;16;462;463;1;66;2.0
19;17;463;470;7;66;2.0
19;18;470;473;3;66;2.0
19;19;473;483;10;66;2.0
19;20;483;505;22;66;2.0
19;21;505;514;9;66;2.0
19;22;514;523;9;66;2.0
19;23;523;535;12;66;2.0
19;24;535;542;7;66;2.0
19;25;542;553;11;66;2.0
19;26;553;559;6;66;2.0
19;27;559;590;31;66;2.0
19;28;590;603;13;66;2.0
19;29;603;640;37;66;2.0
19;30;640;667;27;66;2.0
19;31;667;710;43;66;2.0
19;32;710;728;18;66;2.0
19;33;728;757;29;66;2.0
19;34;757;770;13;66;2.0
19;35;770;788;18;66;2.0
19;36;788;805;17;66;2.0
19;37;805;830;25;66;2.0
19;38;830;832;2;66;2.0
19;39;832;843;11;66;2.0
19;40;843;855;12;66;2.0
19;41;855;875;20;66;2.0
19;42;875;882;7;66;2.0
19;43;882;890;8;66;2.0
19;44;890;898;8;66;2.0
19;45;898;910;12;66;2.0
19;46;910;913;3;66;2.0
19;47;913;925;12;66;2.0
19;48;925;942;17;66;2.0
19;49;942;948;6;66;2.0
19;50;948;950;2;66;2.0
19;51;950;965;15;66;2.0
19;52;965;968;3;66;2.0
19;53;968;985;17;66;2.0
19;54;985;988;3;66;2.0
19;55;988;1003;15;66;2.0
19;56;1003;1005;2;66;2.0
19;57;1005;1032;27;66;2.0
19;58;1032;1035;3;66;2.0
19;59;1035;1053;18;66;2.0
19;60;1053;1055;2;66;2.0
19;61;1055;1075;20;66;2.0
19;62;1075;1087;12;66;2.0
19;63;1087;1093;6;66;2.0
19;64;1093;1095;2;66;2.0
19;65;1095;1108;13;66;2.0
19;66;1108;1111;3;66;2.0
19;67;1111;1154;43;66;2.0
19;68;1154;1181;27;66;2.0
19;69;1181;1214;33;66;2.0
19;70;1214;1231;17;66;2.0
19;71;1231;1274;43;66;2.0
19;72;1274;1291;17;66;2.0
19;73;1291;1324;33;66;2.0
19;74;1324;1348;24;66;2.0
19;75;1348;1388;40;66;2.0
19;76;1388;1396;8;66;2.0
19;77;1396;1411;15;66;2.0
19;78;1411;1426;15;66;2.0
19;79;1426;1441;15;66;2.0
19;80;1441;1456;15;66;2.0
19;81;1456;1471;15;66;2.0
19;82;1471;1486;15;66;2.0
19;83;1486;1501;15;66;2.0
19;84;1501;1516;15;66;2.0
19;85;1516;1531;15;66;2.0
19;86;1531;1546;15;66;2.0
19;87;1546;1561;15;66;2.0
19;88;1561;1576;15;66;2.0
19;89;1576;1591;15;66;2.0
19;90;1591;1606;15;66;2.0
19;91;1606;1621;15;66;2.0
19;92;1621;1636;15;66;2.0
19;93;1636;1651;15;66;2.0
19;94;1651;1666;15;66;2.0
19;95;1666;1680;14;66;2.0
20;0;252;344;92;63;2.0
20;1;344;347;3;63;2.0
20;2;347;359;12;63;2.0
20;3;359;367;8;63;2.0
20;4;367;374;7;63;2.0
20;5;374;382;8;63;2.0
20;6;382;394;12;63;2.0
20;7;394;402;8;63;2.0
20;8;402;409;7;63;2.0
20;9;409;417;8;63;2.0
20;10;417;429;12;63;2.0
20;11;429;430;1;63;2.0
20;12;430;437;7;63;2.0
20;13;437;452;15;63;2.0
20;14;452;462;10;63;2.0
20;15;462;464;2;63;2.0
20;16;464;465;1;63;2.0
20;17;465;472;7;63;2.0
20;18;472;475;3;63;2.0
20;19;475;485;10;63;2.0
20;20;485;507;22;63;2.0
20;21;507;516;9;63;2.0
20;22;516;525;9;63;2.0
20;23;525;537;12;63;2.0
20;24;537;544;7;63;2.0
20;25;544;555;11;63;2.0
20;26;555;561;6;63;2.0
20;27;561;592;31;63;2.0
20;28;592;605;13;63;2.0
20;29;605;642;37;63;2.0
20;30;642;669;27;63;2.0
20;31;669;712;43;63;2.0
20;32;712;730;18;63;2.0
20;33;730;759;29;63;2.0
20;34;759;772;13;63;2.0
20;35;772;790;18;63;2.0
20;36;790;807;17;63;2.0
20;37;807;832;25;63;2.0
20;38;832;834;2;63;2.0
20;39;834;845;11;63;2.0
20;40;845;857;12;63;2.0
20;41;857;877;20;63;2.0
20;42;877;884;7;63;2.0
20;43;884;892;8;63;2.0
20;44;892;900;8;63;2.0
20;45;900;912;12;63;2.0
20;46;912;915;3;63;2.0
20;47;915;927;12;63;2.0
20;48;927;944;17;63;2.0
20;49;944;950;6;63;2.0
20;50;950;952;2;63;2.0
20;51;952;967;15;63;2.0
20;52;967;970;3;63;2.0
20;53;970;987;17;63;2.0
20;54;987;990;3;63;2.0
20;55;990;1005;15;63;2.0
20;56;1005;1007;2;63;2.0
20;57;1007;1034;27;63;2.0
20;58;1034;1037;3;63;2.0
20;59;1037;1055;18;63;2.0
20;60;1055;1057;2;63;2.0
20;61;1057;1077;20;63;2.0
20;62;1077;1089;12;63;2.0
20;63;1089;1095;6;63;2.0
20;64;1095;1097;2;63;2.0
20;65;1097;1110;13;63;2.0
20;66;1110;1113;3;63;2.0
20;67;1113;1156;43;63;2.0
20;68;1156;1183;27;63;2.0
20;69;1183;1216;33;63;2.0
20;70;1216;1233;17;63;2.0
20;71;1233;1276;43;63;2.0
20;72;1276;1293;17;63;2.0
20;73;1293;1326;33;63;2.0
20;74;1326;1350;24;63;2.0
20;75;1350;1390;40;63;2.0
20;76;1390;1398;8;63;2.0
20;77;1398;1413;15;63;2.0
20;78;1413;1428;15;63;2.0
20;79;1428;1443;15;63;2.0
20;80;1443;1458;15;63;2.0
20;81;1458;1473;15;63;2.0
20;82;1473;1488;15;63;2.0
20;83;1488;1503;15;63;2.0
20;84;1503;1518;15;63;2.0
20;85;1518;1533;15;63;2.0
20;86;1533;1548;15;63;2.0
20;87;1548;1563;15;63;2.0
20;88;1563;1578;15;63;2.0
20;89;1578;1593;15;63;2.0
20;90;1593;1608;15;63;2.0
20;91;1608;1623;15;63;2.0
20;92;1623;1638;15;63;2.0
20;93;1638;1653;15;63;2.0
20;94;1653;1680;27;63;2.0
21;0;249;329;80;114;2.0
21;1;329;342;13;114;2.0
21;2;342;344;2;114;2.0
21;3;344;359;15;114;2.0
21;4;359;362;3;114;2.0
21;5;362;377;15;114;2.0
21;6;377;379;2;114;2.0
21;7;379;394;15;114;2.0
21;8;394;397;3;114;2.0
21;9;397;412;15;114;2.0
21;10;412;414;2;114;2.0
21;11;414;421;7;114;2.0
21;12;421;432;11;114;2.0
21;13;432;447;15;114;2.0
21;14;447;449;2;114;2.0
21;15;449;456;7;114;2.0
21;16;456;457;1;114;2.0
21;17;457;466;9;114;2.0
21;18;466;467;1;114;2.0
21;19;467;476;9;114;2.0
21;20;476;502;26;114;2.0
21;21;502;507;5;114;2.0
21;22;507;516;9;114;2.0
21;23;516;529;13;114;2.0
21;24;529;532;3;114;2.0
21;25;532;546;14;114;2.0
21;26;546;552;6;114;2.0
21;27;552;587;35;114;2.0
21;28;587;596;9;114;2.0
21;29;596;637;41;114;2.0
21;30;637;654;17;114;2.0
21;31;654;707;53;114;2.0
21;32;707;721;14;114;2.0
21;33;721;744;23;114;2.0
21;34;744;767;23;114;2.0
21;35;767;781;14;114;2.0
21;36;781;802;21;114;2.0
21;37;802;819;17;114;2.0
21;38;819;827;8;114;2.0
21;39;827;836;9;114;2.0
21;40;836;852;16;114;2.0
21;41;852;869;17;114;2.0
21;42;869;872;3;114;2.0
21;43;872;887;15;114;2.0
21;44;887;891;4;114;2.0
21;45;891;906;15;114;2.0
21;46;906;907;1;114;2.0
21;47;907;922;15;114;2.0
21;48;922;929;7;114;2.0
21;49;929;941;12;114;2.0
21;50;941;947;6;114;2.0
21;51;947;961;14;114;2.0
21;52;961;962;1;114;2.0
21;53;962;981;19;114;2.0
21;54;981;982;1;114;2.0
21;55;982;996;14;114;2.0
21;56;996;1002;6;114;2.0
21;57;1002;1019;17;114;2.0
21;58;1019;1032;13;114;2.0
21;59;1032;1046;14;114;2.0
21;60;1046;1052;6;114;2.0
21;61;1052;1072;20;114;2.0
21;62;1072;1074;2;114;2.0
21;63;1074;1086;12;114;2.0
21;64;1086;1092;6;114;2.0
21;65;1092;1101;9;114;2.0
21;66;1101;1104;3;114;2.0
21;67;1104;1151;47;114;2.0
21;68;1151;1174;23;114;2.0
21;69;1174;1211;37;114;2.0
21;70;1211;1224;13;114;2.0
21;71;1224;1271;47;114;2.0
21;72;1271;1284;13;114;2.0
21;73;1284;1321;37;114;2.0
21;74;1321;1335;14;114;2.0
21;75;1335;1385;50;114;2.0
21;76;1385;1389;4;114;2.0
21;77;1389;1404;15;114;2.0
21;78;1404;1419;15;114;2.0
21;79;1419;1434;15;114;2.0
21;80;1434;1449;15;114;2.0
21;81;1449;1464;15;114;2.0
21;82;1464;1479;15;114;2.0
21;83;1479;1494;15;114;2.0
21;84;1494;1509;15;114;2.0
21;85;1509;1524;15;114;2.0
21;86;1524;1539;15;114;2.0
21;87;1539;1554;15;114;2.0
21;88;1554;1569;15;114;2.0
21;89;1569;1584;15;114;2.0
21;90;1584;1599;15;114;2.0
21;91;1599;1614;15;114;2.0
21;92;1614;1629;15;114;2.0
21;93;1629;1644;15;114;2.0
21;94;1644;1659;15;114;2.0
21;95;1659;1680;21;114;2.0
22;0;243;333;90;42;2.0
22;1;333;339;6;42;2.0
22;2;339;348;9;42;2.0
22;3;348;359;11;42;2.0
22;4;359;363;4;42;2.0
22;5;363;374;11;42;2.0
22;6;374;383;9;42;2.0
22;7;383;394;11;42;2.0
22;8;394;398;4;42;2.0
22;9;398;409;11;42;2.0
22;10;409;417;8;42;2.0
22;11;417;418;1;42;2.0
22;12;418;429;11;42;2.0
22;13;429;444;15;42;2.0
22;14;444;452;8;42;2.0
22;15;452;453;1;42;2.0
22;16;453;454;1;42;2.0
22;17;454;462;8;42;2.0
22;18;462;464;2;42;2.0
22;19;464;472;8;42;2.0
22;20;472;499;27;42;2.0
22;21;499;503;4;42;2.0
22;22;503;512;9;42;2.0
22;23;512;529;17;42;2.0
22;24;529;533;4;42;2.0
22;25;533;542;9;42;2.0
22;26;542;548;6;42;2.0
22;27;548;584;36;42;2.0
22;28;584;592;8;42;2.0
22;29;592;634;42;42;2.0
22;30;634;658;24;42;2.0
22;31;658;704;46;42;2.0
22;32;704;717;13;42;2.0
22;33;717;748;31;42;2.0
22;34;748;764;16;42;2.0
22;35;764;777;13;42;2.0
22;36;777;799;22;42;2.0
22;37;799;823;24;42;2.0
22;38;823;824;1;42;2.0
22;39;824;832;8;42;2.0
22;40;832;849;17;42;2.0
22;41;849;869;20;42;2.0
22;42;869;873;4;42;2.0
22;43;873;884;11;42;2.0
22;44;884;887;3;42;2.0
22;45;887;902;15;42;2.0
22;46;902;904;2;42;2.0
22;47;904;919;15;42;2.0
22;48;919;933;14;42;2.0
22;49;933;937;4;42;2.0
22;50;937;944;7;42;2.0
22;51;944;957;13;42;2.0
22;52;957;959;2;42;2.0
22;53;959;977;18;42;2.0
22;54;977;979;2;42;2.0
22;55;979;992;13;42;2.0
22;56;992;999;7;42;2.0
22;57;999;1023;24;42;2.0
22;58;1023;1029;6;42;2.0
22;59;1029;1042;13;42;2.0
22;60;1042;1049;7;42;2.0
22;61;1049;1069;20;42;2.0
22;62;1069;1078;9;42;2.0
22;63;1078;1082;4;42;2.0
22;64;1082;1089;7;42;2.0
22;65;1089;1097;8;42;2.0
22;66;1097;1100;3;42;2.0
22;67;1100;1148;48;42;2.0
22;68;1148;1170;22;42;2.0
22;69;1170;1208;38;42;2.0
22;70;1208;1220;12;42;2.0
22;71;1220;1268;48;42;2.0
22;72;1268;1280;12;42;2.0
22;73;1280;1318;38;42;2.0
22;74;1318;1339;21;42;2.0
22;75;1339;1382;43;42;2.0
22;76;1382;1385;3;42;2.0
22;77;1385;1400;15;42;2.0
22;78;1400;1415;15;42;2.0
22;79;1415;1430;15;42;2.0
22;80;1430;1445;15;42;2.0
22;81;1445;1460;15;42;2.0
22;82;1460;1475;15;42;2.0
22;83;1475;1490;15;42;2.0
22;84;1490;1505;15;42;2.0
22;85;1505;1520;15;42;2.0
22;86;1520;1535;15;42;2.0
22;87;1535;1550;15;42;2.0
22;88;1550;1565;15;42;2.0
22;89;1565;1580;15;42;2.0
22;90;1580;1595;15;42;2.0
22;91;1595;1610;15;42;2.0
22;92;1610;1625;15;42;2.0
22;93;1625;1640;15;42;2.0
22;94;1640;1655;15;42;2.0
22;95;1655;1670;15;42;2.0
22;96;1670;1680;10;42;2.0
23;0;245;332;87;25;2.0
23;1;332;339;7;25;2.0
23;2;339;347;8;25;2.0
23;3;347;359;12;25;2.0
23;4;359;362;3;25;2.0
23;5;362;374;12;25;2.0
23;6;374;382;8;25;2.0
23;7;382;394;12;25;2.0
23;8;394;397;3;25;2.0
23;9;397;409;12;25;2.0
23;10;409;416;7;25;2.0
23;11;416;417;1;25;2.0
23;12;417;429;12;25;2.0
23;13;429;444;15;25;2.0
23;14;444;451;7;25;2.0
23;15;451;452;1;25;2.0
23;16;452;454;2;25;2.0
23;17;454;461;7;25;2.0
23;18;461;464;3;25;2.0
23;19;464;471;7;25;2.0
23;20;471;499;28;25;2.0
23;21;499;502;3;25;2.0
23;22;502;511;9;25;2.0
23;23;511;529;18;25;2.0
23;24;529;532;3;25;2.0
23;25;532;541;9;25;2.0
23;26;541;547;6;25;2.0
23;27;547;584;37;25;2.0
23;28;584;591;7;25;2.0
23;29;591;634;43;25;2.0
23;30;634;657;23;25;2.0
23;31;657;704;47;25;2.0
23;32;704;716;12;25;2.0
23;33;716;747;31;25;2.0
23;34;747;764;17;25;2.0
23;35;764;776;12;25;2.0
23;36;776;799;23;25;2.0
23;37;799;822;23;25;2.0
23;38;822;824;2;25;2.0
23;39;824;831;7;25;2.0
23;40;831;849;18;25;2.0
23;41;849;869;20;25;2.0
23;42;869;872;3;25;2.0
23;43;872;884;12;25;2.0
23;44;884;886;2;25;2.0
23;45;886;901;15;25;2.0
23;46;901;904;3;25;2.0
23;47;904;919;15;25;2.0
23;48;919;932;13;25;2.0
23;49;932;936;4;25;2.0
23;50;936;944;8;25;2.0
23;51;944;956;12;25;2.0
23;52;956;959;3;25;2.0
23;53;959;976;17;25;2.0
23;54;976;979;3;25;2.0
23;55;979;991;12;25;2.0
23;56;991;999;8;25;2.0
23;57;999;1022;23;25;2.0
23;58;1022;1029;7;25;2.0
23;59;1029;1041;12;25;2.0
23;60;1041;1049;8;25;2.0
23;61;1049;1069;20;25;2.0
23;62;1069;1077;8;25;2.0
23;63;1077;1081;4;25;2.0
23;64;1081;1089;8;25;2.0
23;65;1089;1096;7;25;2.0
23;66;1096;1099;3;25;2.0
23;67;1099;1148;49;25;2.0
23;68;1148;1169;21;25;2.0
23;69;1169;1208;39;25;2.0
23;70;1208;1219;11;25;2.0
23;71;1219;1268;49;25;2.0
23;72;1268;1279;11;25;2.0
23;73;1279;1318;39;25;2.0
23;74;1318;1338;20;25;2.0
23;75;1338;1382;44;25;2.0
23;76;1382;1384;2;25;2.0
23;77;1384;1399;15;25;2.0
23;78;1399;1414;15;25;2.0
23;79;1414;1429;15;25;2.0
23;80;1429;1444;15;25;2.0
23;81;1444;1459;15;25;2.0
23;82;1459;1474;15;25;2.0
23;83;1474;1489;15;25;2.0
23;84;1489;1504;15;25;2.0
23;85;1504;1519;15;25;2.0
23;86;1519;1534;15;25;2.0
23;87;1534;1549;15;25;2.0
23;88;1549;1564;15;25;2.0
23;89;1564;1579;15;25;2.0
23;90;1579;1594;15;25;2.0
23;91;1594;1609;15;25;2.0
23;92;1609;1624;15;25;2.0
23;93;1624;1639;15;25;2.0
23;94;1639;1654;15;25;2.0
23;95;1654;1669;15;25;2.0
23;96;1669;1680;11;25;2.0
24;0;240;336;96;0;0.83
24;1;336;342;6;0;0.83
24;2;342;351;9;0;0.83
24;3;351;362;11;0;0.83
24;4;362;366;4;0;0.83
24;5;366;377;11;0;0.83
24;6;377;386;9;0;0.83
24;7;386;397;11;0;0.83
24;8;397;401;4;0;0.83
24;9;401;412;11;0;0.83
24;10;412;420;8;0;0.83
24;11;420;421;1;0;0.83
24;12;421;432;11;0;0.83
24;13;432;447;15;0;0.83
24;14;447;455;8;0;0.83
24;15;455;456;1;0;0.83
24;16;456;457;1;0;0.83
24;17;457;465;8;0;0.83
24;18;465;467;2;0;0.83
24;19;467;475;8;0;0.83
24;20;475;502;27;0;0.83
24;21;502;506;4;0;0.83
24;22;506;515;9;0;0.83
24;23;515;532;17;0;0.83
24;24;532;536;4;0;0.83
24;25;536;545;9;0;0.83
24;26;545;551;6;0;0.83
24;27;551;587;36;0;0.83
24;28;587;595;8;0;0.83
24;29;595;637;42;0;0.83
24;30;637;661;24;0;0.83
24;31;661;707;46;0;0.83
24;32;707;720;13;0;0.83
24;33;720;751;31;0;0.83
24;34;751;767;16;0;0.83
24;35;767;780;13;0;0.83
24;36;780;802;22;0;0.83
24;37;802;826;24;0;0.83
24;38;826;827;1;0;0.83
24;39;827;835;8;0;0.83
24;40;835;852;17;0;0.83
24;41;852;872;20;0;0.83
24;42;872;876;4;0;0.83
24;43;876;887;11;0;0.83
24;44;887;890;3;0;0.83
24;45;890;905;15;0;0.83
24;46;905;907;2;0;0.83
24;47;907;922;15;0;0.83
24;48;922;936;14;0;0.83
24;49;936;940;4;0;0.83
24;50;940;947;7;0;0.83
24;51;947;960;13;0;0.83
24;52;960;962;2;0;0.83
24;53;962;980;18;0;0.83
24;54;980;982;2;0;0.83
24;55;982;995;13;0;0.83
24;56;995;1002;7;0;0.83
24;57;1002;1026;24;0;0.83
24;58;1026;1032;6;0;0.83
24;59;1032;1045;13;0;0.83
24;60;1045;1052;7;0;0.83
24;61;1052;1072;20;0;0.83
24;62;1072;1081;9;0;0.83
24;63;1081;1085;4;0;0.83
24;64;1085;1092;7;0;0.83
24;65;1092;1100;8;0;0.83
24;66;1100;1103;3;0;0.83
24;67;1103;1151;48;0;0.83
24;68;1151;1173;22;0;0.83
24;69;1173;1211;38;0;0.83
24;70;1211;1223;12;0;0.83
24;71;1223;1271;48;0;0.83
24;72;1271;1283;12;0;0.83
24;73;1283;1321;38;0;0.83
24;74;1321;1342;21;0;0.83
24;75;1342;1385;43;0;0.83
24;76;1385;1388;3;0;0.83
24;77;1388;1403;15;0;0.83
24;78;1403;1418;15;0;0.83
24;79;1418;1433;15;0;0.83
24;80;1433;1448;15;0;0.83
24;81;1448;1463;15;0;0.83
24;82;1463;1478;15;0;0.83
24;83;1478;1493;15;0;0.83
24;84;1493;1508;15;0;0.83
24;85;1508;1523;15;0;0.83
24;86;1523;1538;15;0;0.83
24;87;1538;1553;15;0;0.83
24;88;1553;1568;15;0;0.83
24;89;1568;1583;15;0;0.83
24;90;1583;1598;15;0;0.83
24;91;1598;1613;15;0;0.83
24;92;1613;1628;15;0;0.83
24;93;1628;1643;15;0;0.83
24;94;1643;1658;15;0;0.83
24;95;1658;1673;15;0;0.83
24;96;1673;1680;7;0;0.83
25;0;240;336;96;0;0.83
25;1;336;342;6;0;0.83
25;2;342;351;9;0;0.83
25;3;351;362;11;0;0.83
25;4;362;366;4;0;0.83
25;5;366;377;11;0;0.83
25;6;377;386;9;0;0.83
25;7;386;397;11;0;0.83
25;8;397;401;4;0;0.83
25;9;401;412;11;0;0.83
25;10;412;420;8;0;0.83
25;11;420;421;1;0;0.83
25;12;421;432;11;0;0.83
25;13;432;447;15;0;0.83
25;14;447;455;8;0;0.83
25;15;455;456;1;0;0.83
25;16;456;457;1;0;0.83
25;17;457;465;8;0;0.83
25;18;465;467;2;0;0.83
25;19;467;475;8;0;0.83
25;20;475;502;27;0;0.83
25;21;502;506;4;0;0.83
25;22;506;515;9;0;0.83
25;23;515;532;17;0;0.83
25;24;532;536;4;0;0.83
25;25;536;545;9;0;0.83
25;26;545;551;6;0;0.83
25;27;551;587;36;0;0.83
25;28;587;595;8;0;0.83
25;29;595;637;42;0;0.83
25;30;637;661;24;0;0.83
25;31;661;707;46;0;0.83
25;32;707;720;13;0;0.83
25;33;720;751;31;0;0.83
25;34;751;767;16;0;0.83
25;35;767;780;13;0;0.83
25;36;780;802;22;0;0.83
25;37;802;826;24;0;0.83
25;38;826;827;1;0;0.83
25;39;827;835;8;0;0.83
25;40;835;852;17;0;0.83
25;41;852;872;20;0;0.83
25;42;872;876;4;0;0.83
25;43;876;887;11;0;0.83
25;44;887;890;3;0;0.83
25;45;890;905;15;0;0.83
25;46;905;907;2;0;0.83
25;47;907;922;15;0;0.83
25;48;922;936;14;0;0.83
25;49;936;940;4;0;0.83
25;50;940;947;7;0;0.83
25;51;947;960;13;0;0.83
25;52;960;962;2;0;0.83
25;53;962;980;18;0;0.83
25;54;980;982;2;0;0.83
25;55;982;995;13;0;0.83
25;56;995;1002;7;0;0.83
25;57;1002;1026;24;0;0.83
25;58;1026;1032;6;0;0.83
25;59;1032;1045;13;0;0.83
25;60;1045;1052;7;0;0.83
25;61;1052;1072;20;0;0.83
25;62;1072;1081;9;0;0.83
25;63;1081;1085;4;0;0.83
25;64;1085;1092;7;0;0.83
25;65;1092;1100;8;0;0.83
25;66;1100;1103;3;0;0.83
25;67;1103;1151;48;0;0.83
25;68;1151;1173;22;0;0.83
25;69;1173;1211;38;0;0.83
25;70;1211;1223;12;0;0.83
25;71;1223;1271;48;0;0.83
25;72;1271;1283;12;0;0.83
25;73;1283;1321;38;0;0.83
25;74;1321;1342;21;0;0.83
25;75;1342;1385;43;0;0.83
25;76;1385;1388;3;0;0.83
25;77;1388;1403;15;0;0.83
25;78;1403;1418;15;0;0.83
25;79;1418;1433;15;0;0.83
25;80;1433;1448;15;0;0.83
25;81;1448;1463;15;0;0.83
25;82;1463;1478;15;0;0.83
25;83;1478;1493;15;0;0.83
25;84;1493;1508;15;0;0.83
25;85;1508;1523;15;0;0.83
25;86;1523;1538;15;0;0.83
25;87;1538;1553;15;0;0.83
25;88;1553;1568;15;0;0.83
25;89;1568;1583;15;0;0.83
25;90;1583;1598;15;0;0.83
25;91;1598;1613;15;0;0.83
25;92;1613;1628;15;0;0.83
25;93;1628;1643;15;0;0.83
25;94;1643;1658;15;0;0.83
25;95;1658;1673;15;0;0.83
25;96;1673;1680;7;0;0.83
26;0;240;336;96;0;0.83
26;1;336;342;6;0;0.83
26;2;342;351;9;0;0.83
26;3;351;362;11;0;0.83
26;4;362;366;4;0;0.83
26;5;366;377;11;0;0.83
26;6;377;386;9;0;0.83
26;7;386;397;11;0;0.83
26;8;397;401;4;0;0.83
26;9;401;412;11;0;0.83
26;10;412;420;8;0;0.83
26;11;420;421;1;0;0.83
26;12;421;432;11;0;0.83
26;13;432;447;15;0;0.83
26;14;447;455;8;0;0.83
26;15;455;456;1;0;0.83
26;16;456;457;1;0;0.83
26;17;457;465;8;0;0.83
26;18;465;467;2;0;0.83
26;19;467;475;8;0;0.83
26;20;475;502;27;0;0.83
26;21;502;506;4;0;0.83
26;22;506;515;9;0;0.83
26;23;515;532;17;0;0.83
26;24;532;536;4;0;0.83
26;25;536;545;9;0;0.83
26;26;545;551;6;0;0.83
26;27;551;587;36;0;0.83
26;28;587;595;8;0;0.83
26;29;595;637;42;0;0.83
26;30;637;661;24;0;0.83
26;31;661;707;46;0;0.83
26;32;707;720;13;0;0.83
26;33;720;751;31;0;0.83
26;34;751;767;16;0;0.83
26;35;767;780;13;0;0.83
26;36;780;802;22;0;0.83
26;37;802;826;24;0;0.83
26;38;826;827;1;0;0.83
26;39;827;835;8;0;0.83
26;40;835;852;17;0;0.83
26;41;852;872;20;0;0.83
26;42;872;876;4;0;0.83
26;43;876;887;11;0;0.83
26;44;887;890;3;0;0.83
26;45;890;905;15;0;0.83
26;46;905;907;2;0;0.83
26;47;907;922;15;0;0.83
26;48;922;936;14;0;0.83
26;49;936;940;4;0;0.83
26;50;940;947;7;0;0.83
26;51;947;960;13;0;0.83
26;52;960;962;2;0;0.83
26;53;962;980;18;0;0.83
26;54;980;982;2;0;0.83
26;55;982;995;13;0;0.83
26;56;995;1002;7;0;0.83
26;57;1002;1026;24;0;0.83
26;58;1026;1032;6;0;0.83
26;59;1032;1045;13;0;0.83
26;60;1045;1052;7;0;0.83
26;61;1052;1072;20;0;0.83
26;62;1072;1081;9;0;0.83
26;63;1081;1085;4;0;0.83
26;64;1085;1092;7;0;0.83
26;65;1092;1100;8;0;0.83
26;66;1100;1103;3;0;0.83
26;67;1103;1151;48;0;0.83
26;68;1151;1173;22;0;0.83
26;69;1173;1211;38;0;0.83
26;70;1211;1223;12;0;0.83
26;71;1223;1271;48;0;0.83
26;72;1271;1283;12;0;0.83
26;73;1283;1321;38;0;0.83
26;74;1321;1342;21;0;0.83
26;75;1342;1385;43;0;0.83
26;76;1385;1388;3;0;0.83
26;77;1388;1403;15;0;0.83
26;78;1403;1418;15;0;0.83
26;79;1418;1433;15;0;0.83
26;80;1433;1448;15;0;0.83
26;81;1448;1463;15;0;0.83
26;82;1463;1478;15;0;0.83
26;83;1478;1493;15;0;0.83
26;84;1493;1508;15;0;0.83
26;85;1508;1523;15;0;0.83
26;86;1523;1538;15;0;0.83
26;87;1538;1553;15;0;0.83
26;88;1553;1568;15;0;0.83
26;89;1568;1583;15;0;0.83
26;90;1583;1598;15;0;0.83
26;91;1598;1613;15;0;0.83
26;92;1613;1628;15;0;0.83
26;93;1628;1643;15;0;0.83
26;94;1643;1658;15;0;0.83
26;95;1658;1673;15;0;0.83
26;96;1673;1680;7;0;0.83
27;0;240;336;96;0;0.83
27;1;336;342;6;0;0.83
27;2;342;351;9;0;0.83
27;3;351;362;11;0;0.83
27;4;362;366;4;0;0.83
27;5;366;377;11;0;0.83
27;6;377;386;9;0;0.83
27;7;386;397;11;0;0.83
27;8;397;401;4;0;0.83
27;9;401;412;11;0;0.83
27;10;412;420;8;0;0.83
27;11;420;421;1;0;0.83
27;12;421;432;11;0;0.83
27;13;432;447;15;0;0.83
27;14;447;455;8;0;0.83
27;15;455;456;1;0;0.83
27;16;456;457;1;0;0.83
27;17;457;465;8;0;0.83
27;18;465;467;2;0;0.83
27;19;467;475;8;0;0.83
27;20;475;502;27;0;0.83
27;21;502;506;4;0;0.83
27;22;506;515;9;0;0.83
27;23;515;532;17;0;0.83
27;24;532;536;4;0;0.83
27;25;536;545;9;0;0.83
27;26;545;551;6;0;0.83
27;27;551;587;36;0;0.83
27;28;587;595;8;0;0.83
27;29;595;637;42;0;0.83
27;30;637;661;24;0;0.83
27;31;661;707;46;0;0.83
27;32;707;720;13;0;0.83
27;33;720;751;31;0;0.83
27;34;751;767;16;0;0.83
27;35;767;780;13;0;0.83
27;36;780;802;22;0;0.83
27;37;802;826;24;0;0.83
27;38;826;827;1;0;0.83
27;39;827;835;8;0;0.83
27;40;835;852;17;0;0.83
27;41;852;872;20;0;0.83
27;42;872;876;4;0;0.83
27;43;876;887;11;0;0.83
27;44;887;890;3;0;0.83
27;45;890;905;15;0;0.83
27;46;905;907;2;0;0.83
27;47;907;922;15;0;0.83
27;48;922;936;14;0;0.83
27;49;936;940;4;0;0.83
27;50;940;947;7;0;0.83
27;51;947;960;13;0;0.83
27;52;960;962;2;0;0.83
27;53;962;980;18;0;0.83
27;54;980;982;2;0;0.83
27;55;982;995;13;0;0.83
27;56;995;1002;7;0;0.83
27;57;1002;1026;24;0;0.83
27;58;1026;1032;6;0;0.83
27;59;1032;1045;13;0;0.83
27;60;1045;1052;7;0;0.83
27;61;1052;1072;20;0;0.83
27;62;1072;1081;9;0;0.83
27;63;1081;1085;4;0;0.83
27;64;1085;1092;7;0;0.83
27;65;1092;1100;8;0;0.83
27;66;1100;1103;3;0;0.83
27;67;1103;1151;48;0;0.83
27;68;1151;1173;22;0;0.83
27;69;1173;1211;38;0;0.83
27;70;1211;1223;12;0;0.83
27;71;1223;1271;48;0;0.83
27;72;1271;1283;12;0;0.83
27;73;1283;1321;38;0;0.83
27;74;1321;1342;21;0;0.83
27;75;1342;1385;43;0;0.83
27;76;1385;1388;3;0;0.83
27;77;1388;1403;15;0;0.83
27;78;1403;1418;15;0;0.83
27;79;1418;1433;15;0;0.83
27;80;1433;1448;15;0;0.83
27;81;1448;1463;15;0;0.83
27;82;1463;1478;15;0;0.83
27;83;1478;1493;15;0;0.83
27;84;1493;1508;15;0;0.83
27;85;1508;1523;15;0;0.83
27;86;1523;1538;15;0;0.83
27;87;1538;1553;15;0;0.83
27;88;1553;1568;15;0;0.83
27;89;1568;1583;15;0;0.83
27;90;1583;1598;15;0;0.83
27;91;1598;1613;15;0;0.83
27;92;1613;1628;15;0;0.83
27;93;1628;1643;15;0;0.83
27;94;1643;1658;15;0;0.83
27;95;1658;1673;15;0;0.83
27;96;1673;1680;7;0;0.83
28;0;240;336;96;0;0.83
28;1;336;342;6;0;0.83
28;2;342;351;9;0;0.83
28;3;351;362;11;0;0.83
28;4;362;366;4;0;0.83
28;5;366;377;11;0;0.83
28;6;377;386;9;0;0.83
28;7;386;397;11;0;0.83
28;8;397;401;4;0;0.83
28;9;401;412;11;0;0.83
28;10;412;420;8;0;0.83
28;11;420;421;1;0;0.83
28;12;421;432;11;0;0.83
28;13;432;447;15;0;0.83
28;14;447;455;8;0;0.83
28;15;455;456;1;0;0.83
28;16;456;457;1;0;0.83
28;17;457;465;8;0;0.83
28;18;465;467;2;0;0.83
28;19;467;475;8;0;0.83
28;20;475;502;27;0;0.83
28;21;502;506;4;0;0.83
28;22;506;515;9;0;0.83
28;23;515;532;17;0;0.83
28;24;532;536;4;0;0.83
28;25;536;545;9;0;0.83
28;26;545;551;6;0;0.83
28;27;551;587;36;0;0.83
28;28;587;595;8;0;0.83
28;29;595;637;42;0;0.83
28;30;637;661;24;0;0.83
28;31;661;707;46;0;0.83
28;32;707;720;13;0;0.83
28;33;720;751;31;0;0.83
28;34;751;767;16;0;0.83
28;35;767;780;13;0;0.83
28;36;780;802;22;0;0.83
28;37;802;826;24;0;0.83
28;38;826;827;1;0;0.83
28;39;827;835;8;0;0.83
28;40;835;852;17;0;0.83
28;41;852;872;20;0;0.83
28;42;872;876;4;0;0.83
28;43;876;887;11;0;0.83
28;44;887;890;3;0;0.83
28;45;890;905;15;0;0.83
28;46;905;907;2;0;0.83
28;47;907;922;15;0;0.83
28;48;922;936;14;0;0.83
28;49;936;940;4;0;0.83
28;50;940;947;7;0;0.83
28;51;947;960;13;0;0.83
28;52;960;962;2;0;0.83
28;53;962;980;18;0;0.83
28;54;980;982;2;0;0.83
28;55;982;995;13;0;0.83
28;56;995;1002;7;0;0.83
28;57;1002;1026;24;0;0.83
28;58;1026;1032;6;0;0.83
28;59;1032;1045;13;0;0.83
28;60;1045;1052;7;0;0.83
28;61;1052;1072;20;0;0.83
28;62;1072;1081;9;0;0.83
28;63;1081;1085;4;0;0.83
28;64;1085;1092;7;0;0.83
28;65;1092;1100;8;0;0.83
28;66;1100;1103;3;0;0.83
28;67;1103;1151;48;0;0.83
28;68;1151;1173;22;0;0.83
28;69;1173;1211;38;0;0.83
28;70;1211;1223;12;0;0.83
28;71;1223;1271;48;0;0.83
28;72;1271;1283;12;0;0.83
28;73;1283;1321;38;0;0.83
28;74;1321;1342;21;0;0.83
28;75;1342;1385;43;0;0.83
28;76;1385;1388;3;0;0.83
28;77;1388;1403;15;0;0.83
28;78;1403;1418;15;0;0.83
28;79;1418;1433;15;0;0.83
28;80;1433;1448;15;0;0.83
28;81;1448;1463;15;0;0.83
28;82;1463;1478;15;0;0.83
28;83;1478;1493;15;0;0.83
28;84;1493;1508;15;0;0.83
28;85;1508;1523;15;0;0.83
28;86;1523;1538;15;0;0.83
28;87;1538;1553;15;0;0.83
28;88;1553;1568;15;0;0.83
28;89;1568;1583;15;0;0.83
28;90;1583;1598;15;0;0.83
28;91;1598;1613;15;0;0.83
28;92;1613;1628;15;0;0.83
28;93;1628;1643;15;0;0.83
28;94;1643;1658;15;0;0.83
28;95;1658;1673;15;0;0.83
28;96;1673;1680;7;0;0.83
29;0;240;336;96;0;2.0
29;1;336;342;6;0;2.0
29;2;342;351;9;0;2.0
29;3;351;362;11;0;2.0
29;4;362;366;4;0;2.0
29;5;366;377;11;0;2.0
29;6;377;386;9;0;2.0
29;7;386;397;11;0;2.0
29;8;397;401;4;0;2.0
29;9;401;412;11;0;2.0
29;10;412;420;8;0;2.0
29;11;420;421;1;0;2.0
29;12;421;432;11;0;2.0
29;13;432;447;15;0;2.0
29;14;447;455;8;0;2.0
29;15;455;456;1;0;2.0
29;16;456;457;1;0;2.0
29;17;457;465;8;0;2.0
29;18;465;467;2;0;2.0
29;19;467;475;8;0;2.0
29;20;475;502;27;0;2.0
29;21;502;506;4;0;2.0
29;22;506;515;9;0;2.0
29;23;515;532;17;0;2.0
29;24;532;536;4;0;2.0
29;25;536;545;9;0;2.0
29;26;545;551;6;0;2.0
29;27;551;587;36;0;2.0
29;28;587;595;8;0;2.0
29;29;595;637;42;0;2.0
29;30;637;661;24;0;2.0
29;31;661;707;46;0;2.0
29;32;707;720;13;0;2.0
29;33;720;751;31;0;2.0
29;34;751;767;16;0;2.0
29;35;767;780;13;0;2.0
29;36;780;802;22;0;2.0
29;37;802;826;24;0;2.0
29;38;826;827;1;0;2.0
29;39;827;835;8;0;2.0
29;40;835;852;17;0;2.0
29;41;852;872;20;0;2.0
29;42;872;876;4;0;2.0
29;43;876;887;11;0;2.0
29;44;887;890;3;0;2.0
29;45;890;905;15;0;2.0
29;46;905;907;2;0;2.0
29;47;907;922;15;0;2.0
29;48;922;936;14;0;2.0
29;49;936;940;4;0;2.0
29;50;940;947;7;0;2.0
29;51;947;960;13;0;2.0
29;52;960;962;2;0;2.0
29;53;962;980;18;0;2.0
29;54;980;982;2;0;2.0
29;55;982;995;13;0;2.0
29;56;995;1002;7;0;2.0
29;57;1002;1026;24;0;2.0
29;58;1026;1032;6;0;2.0
29;59;1032;1045;13;0;2.0
29;60;1045;1052;7;0;2.0
29;61;1052;1072;20;0;2.0
29;62;1072;1081;9;0;2.0
29;63;1081;1085;4;0;2.0
29;64;1085;1092;7;0;2.0
29;65;1092;1100;8;0;2.0
29;66;1100;1103;3;0;2.0
29;67;1103;1151;48;0;2.0
29;68;1151;1173;22;0;2.0
29;69;1173;1211;38;0;2.0
29;70;1211;1223;12;0;2.0
29;71;1223;1271;48;0;2.0
29;72;1271;1283;12;0;2.0
29;73;1283;1321;38;0;2.0
29;74;1321;1342;21;0;2.0
29;75;1342;1385;43;0;2.0
29;76;1385;1388;3;0;2.0
29;77;1388;1403;15;0;2.0
29;78;1403;1418;15;0;2.0
29;79;1418;1433;15;0;2.0
29;80;1433;1448;15;0;2.0
29;81;1448;1463;15;0;2.0
29;82;1463;1478;15;0;2.0
29;83;1478;1493;15;0;2.0
29;84;1493;1508;15;0;2.0
29;85;1508;1523;15;0;2.0
29;86;1523;1538;15;0;2.0
29;87;1538;1553;15;0;2.0
29;88;1553;1568;15;0;2.0
29;89;1568;1583;15;0;2.0
29;90;1583;1598;15;0;2.0
29;91;1598;1613;15;0;2.0
29;92;1613;1628;15;0;2.0
29;93;1628;1643;15;0;2.0
29;94;1643;1658;15;0;2.0
29;95;1658;1673;15;0;2.0
29;96;1673;1680;7;0;2.0
30;0;240;336;96;0;2.0
30;1;336;342;6;0;2.0
30;2;342;351;9;0;2.0
30;3;351;362;11;0;2.0
30;4;362;366;4;0;2.0
30;5;366;377;11;0;2.0
30;6;377;386;9;0;2.0
30;7;386;397;11;0;2.0
30;8;397;401;4;0;2.0
30;9;401;412;11;0;2.0
30;10;412;420;8;0;2.0
30;11;420;421;1;0;2.0
30;12;421;432;11;0;2.0
30;13;432;447;15;0;2.0
30;14;447;455;8;0;2.0
30;15;455;456;1;0;2.0
30;16;456;457;1;0;2.0
30;17;457;465;8;0;2.0
30;18;465;467;2;0;2.0
30;19;467;475;8;0;2.0
30;20;475;502;27;0;2.0
30;21;502;506;4;0;2.0
30;22;506;515;9;0;2.0
30;23;515;532;17;0;2.0
30;24;532;536;4;0;2.0
30;25;536;545;9;0;2.0
30;26;545;551;6;0;2.0
30;27;551;587;36;0;2.0
30;28;587;595;8;0;2.0
30;29;595;637;42;0;2.0
30;30;637;661;24;0;2.0
30;31;661;707;46;0;2.0
30;32;707;720;13;0;2.0
30;33;720;751;31;0;2.0
30;34;751;767;16;0;2.0
30;35;767;780;13;0;2.0
30;36;780;802;22;0;2.0
30;37;802;826;24;0;2.0
30;38;826;827;1;0;2.0
30;39;827;835;8;0;2.0
30;40;835;852;17;0;2.0
30;41;852;872;20;0;2.0
30;42;872;876;4;0;2.0
30;43;876;887;11;0;2.0
30;44;887;890;3;0;2.0
30;45;890;905;15;0;2.0
30;46;905;907;2;0;2.0
30;47;907;922;15;0;2.0
30;48;922;936;14;0;2.0
30;49;936;940;4;0;2.0
30;50;940;947;7;0;2.0
30;51;947;960;13;0;2.0
30;52;960;962;2;0;2.0
30;53;962;980;18;0;2.0
30;54;980;982;2;0;2.0
30;55;982;995;13;0;2.0
30;56;995;1002;7;0;2.0
30;57;1002;1026;24;0;2.0
30;58;1026;1032;6;0;2.0
30;59;1032;1045;13;0;2.0
30;60;1045;1052;7;0;2.0
30;61;1052;1072;20;0;2.0
30;62;1072;1081;9;0;2.0
30;63;1081;1085;4;0;2.0
30;64;1085;1092;7;0;2.0
30;65;1092;1100;8;0;2.0
30;66;1100;1103;3;0;2.0
30;67;1103;1151;48;0;2.0
30;68;1151;1173;22;0;2.0
30;69;1173;1211;38;0;2.0
30;70;1211;1223;12;0;2.0
30;71;1223;1271;48;0;2.0
30;72;1271;1283;12;0;2.0
30;73;1283;1321;38;0;2.0
30;74;1321;1342;21;0;2.0
30;75;1342;1385;43;0;2.0
30;76;1385;1388;3;0;2.0
30;77;1388;1403;15;0;2.0
30;78;1403;1418;15;0;2.0
30;79;1418;1433;15;0;2.0
30;80;1433;1448;15;0;2.0
30;81;1448;1463;15;0;2.0
30;82;1463;1478;15;0;2.0
30;83;1478;1493;15;0;2.0
30;84;1493;1508;15;0;2.0
30;85;1508;1523;15;0;2.0
30;86;1523;1538;15;0;2.0
30;87;1538;1553;15;0;2.0
30;88;1553;1568;15;0;2.0
30;89;1568;1583;15;0;2.0
30;90;1583;1598;15;0;2.0
30;91;1598;1613;15;0;2.0
30;92;1613;1628;15;0;2.0
30;93;1628;1643;15;0;2.0
30;94;1643;1658;15;0;2.0
30;95;1658;1673;15;0;2.0
30;96;1673;1680;7;0;2.0
