Index Nabijacky;Index Udalosti;Cas Zaciatku;Cas Konca;CasTrvania;Miesto;Rychlost nabijania
0;0;249;328;79;112;2.0
0;1;328;331;3;112;2.0
0;2;331;335;4;112;2.0
0;3;335;336;1;112;2.0
0;4;336;337;1;112;2.0
0;5;337;341;4;112;2.0
0;6;341;343;2;112;2.0
0;7;343;346;3;112;2.0
0;8;346;347;1;112;2.0
0;9;347;351;4;112;2.0
0;10;351;358;7;112;2.0
0;11;358;361;3;112;2.0
0;12;361;362;1;112;2.0
0;13;362;367;5;112;2.0
0;14;367;370;3;112;2.0
0;15;370;376;6;112;2.0
0;16;376;378;2;112;2.0
0;17;378;387;9;112;2.0
0;18;387;391;4;112;2.0
0;19;391;393;2;112;2.0
0;20;393;396;3;112;2.0
0;21;396;398;2;112;2.0
0;22;398;406;8;112;2.0
0;23;406;410;4;112;2.0
0;24;410;411;1;112;2.0
0;25;411;413;2;112;2.0
0;26;413;420;7;112;2.0
0;27;420;421;1;112;2.0
0;28;421;427;6;112;2.0
0;29;427;431;4;112;2.0
0;30;431;436;5;112;2.0
0;31;436;437;1;112;2.0
0;32;437;446;9;112;2.0
0;33;446;448;2;112;2.0
0;34;448;450;2;112;2.0
0;35;450;451;1;112;2.0
0;36;451;452;1;112;2.0
0;37;452;455;3;112;2.0
0;38;455;456;1;112;2.0
0;39;456;465;9;112;2.0
0;40;465;466;1;112;2.0
0;41;466;467;1;112;2.0
0;42;467;471;4;112;2.0
0;43;471;475;4;112;2.0
0;44;475;481;6;112;2.0
0;45;481;482;1;112;2.0
0;46;482;484;2;112;2.0
0;47;484;486;2;112;2.0
0;48;486;496;10;112;2.0
0;49;496;501;5;112;2.0
0;50;501;506;5;112;2.0
0;51;506;507;1;112;2.0
0;52;507;515;8;112;2.0
0;53;515;521;6;112;2.0
0;54;521;528;7;112;2.0
0;55;528;529;1;112;2.0
0;56;529;531;2;112;2.0
0;57;531;539;8;112;2.0
0;58;539;545;6;112;2.0
0;59;545;547;2;112;2.0
0;60;547;551;4;112;2.0
0;61;551;552;1;112;2.0
0;62;552;555;3;112;2.0
0;63;555;586;31;112;2.0
0;64;586;587;1;112;2.0
0;65;587;590;3;112;2.0
0;66;590;591;1;112;2.0
0;67;591;595;4;112;2.0
0;68;595;626;31;112;2.0
0;69;626;627;1;112;2.0
0;70;627;635;8;112;2.0
0;71;635;636;1;112;2.0
0;72;636;653;17;112;2.0
0;73;653;657;4;112;2.0
0;74;657;661;4;112;2.0
0;75;661;671;10;112;2.0
0;76;671;675;4;112;2.0
0;77;675;696;21;112;2.0
0;78;696;697;1;112;2.0
0;79;697;706;9;112;2.0
0;80;706;720;14;112;2.0
0;81;720;721;1;112;2.0
0;82;721;727;6;112;2.0
0;83;727;731;4;112;2.0
0;84;731;743;12;112;2.0
0;85;743;752;9;112;2.0
0;86;752;765;13;112;2.0
0;87;765;766;1;112;2.0
0;88;766;771;5;112;2.0
0;89;771;777;6;112;2.0
0;90;777;780;3;112;2.0
0;91;780;786;6;112;2.0
0;92;786;791;5;112;2.0
0;93;791;801;10;112;2.0
0;94;801;802;1;112;2.0
0;95;802;806;4;112;2.0
0;96;806;807;1;112;2.0
0;97;807;816;9;112;2.0
0;98;816;818;2;112;2.0
0;99;818;821;3;112;2.0
0;100;821;822;1;112;2.0
0;101;822;826;4;112;2.0
0;102;826;834;8;112;2.0
0;103;834;835;1;112;2.0
0;104;835;839;4;112;2.0
0;105;839;841;2;112;2.0
0;106;841;851;10;112;2.0
0;107;851;854;3;112;2.0
0;108;854;857;3;112;2.0
0;109;857;861;4;112;2.0
0;110;861;866;5;112;2.0
0;111;866;868;2;112;2.0
0;112;868;871;3;112;2.0
0;113;871;883;12;112;2.0
0;114;883;886;3;112;2.0
0;115;886;887;1;112;2.0
0;116;887;889;2;112;2.0
0;117;889;890;1;112;2.0
0;118;890;891;1;112;2.0
0;119;891;897;6;112;2.0
0;120;897;905;8;112;2.0
0;121;905;906;1;112;2.0
0;122;906;909;3;112;2.0
0;123;909;914;5;112;2.0
0;124;914;918;4;112;2.0
0;125;918;921;3;112;2.0
0;126;921;927;6;112;2.0
0;127;927;928;1;112;2.0
0;128;928;929;1;112;2.0
0;129;929;938;9;112;2.0
0;130;938;940;2;112;2.0
0;131;940;941;1;112;2.0
0;132;941;942;1;112;2.0
0;133;942;946;4;112;2.0
0;134;946;949;3;112;2.0
0;135;949;957;8;112;2.0
0;136;957;960;3;112;2.0
0;137;960;961;1;112;2.0
0;138;961;968;7;112;2.0
0;139;968;969;1;112;2.0
0;140;969;977;8;112;2.0
0;141;977;980;3;112;2.0
0;142;980;981;1;112;2.0
0;143;981;983;2;112;2.0
0;144;983;995;12;112;2.0
0;145;995;1001;6;112;2.0
0;146;1001;1002;1;112;2.0
0;147;1002;1003;1;112;2.0
0;148;1003;1016;13;112;2.0
0;149;1016;1018;2;112;2.0
0;150;1018;1019;1;112;2.0
0;151;1019;1021;2;112;2.0
0;152;1021;1025;4;112;2.0
0;153;1025;1031;6;112;2.0
0;154;1031;1033;2;112;2.0
0;155;1033;1034;1;112;2.0
0;156;1034;1045;11;112;2.0
0;157;1045;1046;1;112;2.0
0;158;1046;1049;3;112;2.0
0;159;1049;1051;2;112;2.0
0;160;1051;1057;6;112;2.0
0;161;1057;1058;1;112;2.0
0;162;1058;1061;3;112;2.0
0;163;1061;1071;10;112;2.0
0;164;1071;1073;2;112;2.0
0;165;1073;1080;7;112;2.0
0;166;1080;1081;1;112;2.0
0;167;1081;1083;2;112;2.0
0;168;1083;1085;2;112;2.0
0;169;1085;1087;2;112;2.0
0;170;1087;1091;4;112;2.0
0;171;1091;1096;5;112;2.0
0;172;1096;1100;4;112;2.0
0;173;1100;1103;3;112;2.0
0;174;1103;1107;4;112;2.0
0;175;1107;1108;1;112;2.0
0;176;1108;1113;5;112;2.0
0;177;1113;1123;10;112;2.0
0;178;1123;1137;14;112;2.0
0;179;1137;1143;6;112;2.0
0;180;1143;1150;7;112;2.0
0;181;1150;1154;4;112;2.0
0;182;1154;1173;19;112;2.0
0;183;1173;1177;4;112;2.0
0;184;1177;1183;6;112;2.0
0;185;1183;1198;15;112;2.0
0;186;1198;1209;11;112;2.0
0;187;1209;1210;1;112;2.0
0;188;1210;1212;2;112;2.0
0;189;1212;1223;11;112;2.0
0;190;1223;1233;10;112;2.0
0;191;1233;1258;25;112;2.0
0;192;1258;1262;4;112;2.0
0;193;1262;1267;5;112;2.0
0;194;1267;1270;3;112;2.0
0;195;1270;1272;2;112;2.0
0;196;1272;1283;11;112;2.0
0;197;1283;1293;10;112;2.0
0;198;1293;1298;5;112;2.0
0;199;1298;1320;22;112;2.0
0;200;1320;1322;2;112;2.0
0;201;1322;1326;4;112;2.0
0;202;1326;1334;8;112;2.0
0;203;1334;1342;8;112;2.0
0;204;1342;1359;17;112;2.0
0;205;1359;1362;3;112;2.0
0;206;1362;1365;3;112;2.0
0;207;1365;1369;4;112;2.0
0;208;1369;1377;8;112;2.0
0;209;1377;1383;6;112;2.0
0;210;1383;1384;1;112;2.0
0;211;1384;1388;4;112;2.0
0;212;1388;1403;15;112;2.0
0;213;1403;1418;15;112;2.0
0;214;1418;1433;15;112;2.0
0;215;1433;1448;15;112;2.0
0;216;1448;1463;15;112;2.0
0;217;1463;1478;15;112;2.0
0;218;1478;1493;15;112;2.0
0;219;1493;1508;15;112;2.0
0;220;1508;1523;15;112;2.0
0;221;1523;1538;15;112;2.0
0;222;1538;1553;15;112;2.0
0;223;1553;1568;15;112;2.0
0;224;1568;1583;15;112;2.0
0;225;1583;1598;15;112;2.0
0;226;1598;1613;15;112;2.0
0;227;1613;1628;15;112;2.0
0;228;1628;1643;15;112;2.0
0;229;1643;1658;15;112;2.0
0;230;1658;1680;22;112;2.0
1;0;245;335;90;93;2.0
1;1;335;337;2;93;2.0
1;2;337;340;3;93;2.0
1;3;340;341;1;93;2.0
1;4;341;350;9;93;2.0
1;5;350;351;1;93;2.0
1;6;351;352;1;93;2.0
1;7;352;360;8;93;2.0
1;8;360;361;1;93;2.0
1;9;361;365;4;93;2.0
1;10;365;367;2;93;2.0
1;11;367;370;3;93;2.0
1;12;370;372;2;93;2.0
1;13;372;375;3;93;2.0
1;14;375;385;10;93;2.0
1;15;385;391;6;93;2.0
1;16;391;392;1;93;2.0
1;17;392;395;3;93;2.0
1;18;395;398;3;93;2.0
1;19;398;400;2;93;2.0
1;20;400;403;3;93;2.0
1;21;403;406;3;93;2.0
1;22;406;410;4;93;2.0
1;23;410;411;1;93;2.0
1;24;411;415;4;93;2.0
1;25;415;420;5;93;2.0
1;26;420;421;1;93;2.0
1;27;421;422;1;93;2.0
1;28;422;425;3;93;2.0
1;29;425;430;5;93;2.0
1;30;430;431;1;93;2.0
1;31;431;432;1;93;2.0
1;32;432;440;8;93;2.0
1;33;440;442;2;93;2.0
1;34;442;445;3;93;2.0
1;35;445;450;5;93;2.0
1;36;450;455;5;93;2.0
1;37;455;457;2;93;2.0
1;38;457;465;8;93;2.0
1;39;465;467;2;93;2.0
1;40;467;470;3;93;2.0
1;41;470;471;1;93;2.0
1;42;471;472;1;93;2.0
1;43;472;477;5;93;2.0
1;44;477;481;4;93;2.0
1;45;481;485;4;93;2.0
1;46;485;486;1;93;2.0
1;47;486;487;1;93;2.0
1;48;487;498;11;93;2.0
1;49;498;500;2;93;2.0
1;50;500;508;8;93;2.0
1;51;508;512;4;93;2.0
1;52;512;517;5;93;2.0
1;53;517;520;3;93;2.0
1;54;520;521;1;93;2.0
1;55;521;530;9;93;2.0
1;56;530;535;5;93;2.0
1;57;535;541;6;93;2.0
1;58;541;547;6;93;2.0
1;59;547;553;6;93;2.0
1;60;553;557;4;93;2.0
1;61;557;560;3;93;2.0
1;62;560;585;25;93;2.0
1;63;585;591;6;93;2.0
1;64;591;592;1;93;2.0
1;65;592;595;3;93;2.0
1;66;595;597;2;93;2.0
1;67;597;626;29;93;2.0
1;68;626;632;6;93;2.0
1;69;632;633;1;93;2.0
1;70;633;635;2;93;2.0
1;71;635;640;5;93;2.0
1;72;640;660;20;93;2.0
1;73;660;661;1;93;2.0
1;74;661;662;1;93;2.0
1;75;662;675;13;93;2.0
1;76;675;680;5;93;2.0
1;77;680;696;16;93;2.0
1;78;696;702;6;93;2.0
1;79;702;705;3;93;2.0
1;80;705;722;17;93;2.0
1;81;722;725;3;93;2.0
1;82;725;731;6;93;2.0
1;83;731;732;1;93;2.0
1;84;732;750;18;93;2.0
1;85;750;753;3;93;2.0
1;86;753;765;12;93;2.0
1;87;765;770;5;93;2.0
1;88;770;771;1;93;2.0
1;89;771;782;11;93;2.0
1;90;782;788;6;93;2.0
1;91;788;791;3;93;2.0
1;92;791;800;9;93;2.0
1;93;800;803;3;93;2.0
1;94;803;810;7;93;2.0
1;95;810;812;2;93;2.0
1;96;812;818;6;93;2.0
1;97;818;821;3;93;2.0
1;98;821;823;2;93;2.0
1;99;823;825;2;93;2.0
1;100;825;837;12;93;2.0
1;101;837;839;2;93;2.0
1;102;839;841;2;93;2.0
1;103;841;844;3;93;2.0
1;104;844;850;6;93;2.0
1;105;850;851;1;93;2.0
1;106;851;859;8;93;2.0
1;107;859;862;3;93;2.0
1;108;862;865;3;93;2.0
1;109;865;866;1;93;2.0
1;110;866;870;4;93;2.0
1;111;870;875;5;93;2.0
1;112;875;876;1;93;2.0
1;113;876;885;9;93;2.0
1;114;885;887;2;93;2.0
1;115;887;891;4;93;2.0
1;116;891;892;1;93;2.0
1;117;892;894;2;93;2.0
1;118;894;902;8;93;2.0
1;119;902;905;3;93;2.0
1;120;905;906;1;93;2.0
1;121;906;907;1;93;2.0
1;122;907;914;7;93;2.0
1;123;914;919;5;93;2.0
1;124;919;920;1;93;2.0
1;125;920;921;1;93;2.0
1;126;921;922;1;93;2.0
1;127;922;930;8;93;2.0
1;128;930;932;2;93;2.0
1;129;932;935;3;93;2.0
1;130;935;941;6;93;2.0
1;131;941;942;1;93;2.0
1;132;942;945;3;93;2.0
1;133;945;947;2;93;2.0
1;134;947;954;7;93;2.0
1;135;954;960;6;93;2.0
1;136;960;961;1;93;2.0
1;137;961;962;1;93;2.0
1;138;962;970;8;93;2.0
1;139;970;974;4;93;2.0
1;140;974;980;6;93;2.0
1;141;980;981;1;93;2.0
1;142;981;982;1;93;2.0
1;143;982;985;3;93;2.0
1;144;985;997;12;93;2.0
1;145;997;1000;3;93;2.0
1;146;1000;1001;1;93;2.0
1;147;1001;1007;6;93;2.0
1;148;1007;1018;11;93;2.0
1;149;1018;1020;2;93;2.0
1;150;1020;1021;1;93;2.0
1;151;1021;1025;4;93;2.0
1;152;1025;1030;5;93;2.0
1;153;1030;1037;7;93;2.0
1;154;1037;1039;2;93;2.0
1;155;1039;1047;8;93;2.0
1;156;1047;1050;3;93;2.0
1;157;1050;1051;1;93;2.0
1;158;1051;1061;10;93;2.0
1;159;1061;1062;1;93;2.0
1;160;1062;1070;8;93;2.0
1;161;1070;1080;10;93;2.0
1;162;1080;1081;1;93;2.0
1;163;1081;1087;6;93;2.0
1;164;1087;1090;3;93;2.0
1;165;1090;1092;2;93;2.0
1;166;1092;1101;9;93;2.0
1;167;1101;1102;1;93;2.0
1;168;1102;1105;3;93;2.0
1;169;1105;1108;3;93;2.0
1;170;1108;1114;6;93;2.0
1;171;1114;1118;4;93;2.0
1;172;1118;1128;10;93;2.0
1;173;1128;1137;9;93;2.0
1;174;1137;1141;4;93;2.0
1;175;1141;1148;7;93;2.0
1;176;1148;1149;1;93;2.0
1;177;1149;1156;7;93;2.0
1;178;1156;1175;19;93;2.0
1;179;1175;1177;2;93;2.0
1;180;1177;1178;1;93;2.0
1;181;1178;1188;10;93;2.0
1;182;1188;1204;16;93;2.0
1;183;1204;1209;5;93;2.0
1;184;1209;1210;1;93;2.0
1;185;1210;1212;2;93;2.0
1;186;1212;1225;13;93;2.0
1;187;1225;1238;13;93;2.0
1;188;1238;1263;25;93;2.0
1;189;1263;1266;3;93;2.0
1;190;1266;1268;2;93;2.0
1;191;1268;1269;1;93;2.0
1;192;1269;1272;3;93;2.0
1;193;1272;1285;13;93;2.0
1;194;1285;1298;13;93;2.0
1;195;1298;1303;5;93;2.0
1;196;1303;1319;16;93;2.0
1;197;1319;1326;7;93;2.0
1;198;1326;1341;15;93;2.0
1;199;1341;1347;6;93;2.0
1;200;1347;1364;17;93;2.0
1;201;1364;1367;3;93;2.0
1;202;1367;1370;3;93;2.0
1;203;1370;1377;7;93;2.0
1;204;1377;1383;6;93;2.0
1;205;1383;1384;1;93;2.0
1;206;1384;1390;6;93;2.0
1;207;1390;1405;15;93;2.0
1;208;1405;1420;15;93;2.0
1;209;1420;1435;15;93;2.0
1;210;1435;1450;15;93;2.0
1;211;1450;1465;15;93;2.0
1;212;1465;1480;15;93;2.0
1;213;1480;1495;15;93;2.0
1;214;1495;1510;15;93;2.0
1;215;1510;1525;15;93;2.0
1;216;1525;1540;15;93;2.0
1;217;1540;1555;15;93;2.0
1;218;1555;1570;15;93;2.0
1;219;1570;1585;15;93;2.0
1;220;1585;1600;15;93;2.0
1;221;1600;1615;15;93;2.0
1;222;1615;1630;15;93;2.0
1;223;1630;1645;15;93;2.0
1;224;1645;1660;15;93;2.0
1;225;1660;1680;20;93;2.0
2;0;246;334;88;92;2.0
2;1;334;335;1;92;2.0
2;2;335;336;1;92;2.0
2;3;336;340;4;92;2.0
2;4;340;349;9;92;2.0
2;5;349;350;1;92;2.0
2;6;350;351;1;92;2.0
2;7;351;360;9;92;2.0
2;8;360;364;4;92;2.0
2;9;364;365;1;92;2.0
2;10;365;366;1;92;2.0
2;11;366;369;3;92;2.0
2;12;369;371;2;92;2.0
2;13;371;375;4;92;2.0
2;14;375;385;10;92;2.0
2;15;385;390;5;92;2.0
2;16;390;391;1;92;2.0
2;17;391;394;3;92;2.0
2;18;394;395;1;92;2.0
2;19;395;397;2;92;2.0
2;20;397;400;3;92;2.0
2;21;400;402;2;92;2.0
2;22;402;405;3;92;2.0
2;23;405;409;4;92;2.0
2;24;409;410;1;92;2.0
2;25;410;414;4;92;2.0
2;26;414;420;6;92;2.0
2;27;420;421;1;92;2.0
2;28;421;424;3;92;2.0
2;29;424;430;6;92;2.0
2;30;430;431;1;92;2.0
2;31;431;439;8;92;2.0
2;32;439;441;2;92;2.0
2;33;441;445;4;92;2.0
2;34;445;449;4;92;2.0
2;35;449;454;5;92;2.0
2;36;454;455;1;92;2.0
2;37;455;456;1;92;2.0
2;38;456;465;9;92;2.0
2;39;465;466;1;92;2.0
2;40;466;469;3;92;2.0
2;41;469;470;1;92;2.0
2;42;470;471;1;92;2.0
2;43;471;476;5;92;2.0
2;44;476;480;4;92;2.0
2;45;480;484;4;92;2.0
2;46;484;485;1;92;2.0
2;47;485;486;1;92;2.0
2;48;486;497;11;92;2.0
2;49;497;499;2;92;2.0
2;50;499;500;1;92;2.0
2;51;500;507;7;92;2.0
2;52;507;511;4;92;2.0
2;53;511;516;5;92;2.0
2;54;516;520;4;92;2.0
2;55;520;529;9;92;2.0
2;56;529;530;1;92;2.0
2;57;530;535;5;92;2.0
2;58;535;540;5;92;2.0
2;59;540;546;6;92;2.0
2;60;546;552;6;92;2.0
2;61;552;556;4;92;2.0
2;62;556;560;4;92;2.0
2;63;560;585;25;92;2.0
2;64;585;590;5;92;2.0
2;65;590;591;1;92;2.0
2;66;591;594;3;92;2.0
2;67;594;595;1;92;2.0
2;68;595;596;1;92;2.0
2;69;596;625;29;92;2.0
2;70;625;631;6;92;2.0
2;71;631;632;1;92;2.0
2;72;632;635;3;92;2.0
2;73;635;640;5;92;2.0
2;74;640;660;20;92;2.0
2;75;660;661;1;92;2.0
2;76;661;674;13;92;2.0
2;77;674;680;6;92;2.0
2;78;680;695;15;92;2.0
2;79;695;701;6;92;2.0
2;80;701;705;4;92;2.0
2;81;705;721;16;92;2.0
2;82;721;724;3;92;2.0
2;83;724;725;1;92;2.0
2;84;725;730;5;92;2.0
2;85;730;731;1;92;2.0
2;86;731;750;19;92;2.0
2;87;750;752;2;92;2.0
2;88;752;765;13;92;2.0
2;89;765;769;4;92;2.0
2;90;769;770;1;92;2.0
2;91;770;781;11;92;2.0
2;92;781;787;6;92;2.0
2;93;787;790;3;92;2.0
2;94;790;800;10;92;2.0
2;95;800;802;2;92;2.0
2;96;802;809;7;92;2.0
2;97;809;811;2;92;2.0
2;98;811;817;6;92;2.0
2;99;817;820;3;92;2.0
2;100;820;822;2;92;2.0
2;101;822;825;3;92;2.0
2;102;825;836;11;92;2.0
2;103;836;838;2;92;2.0
2;104;838;840;2;92;2.0
2;105;840;843;3;92;2.0
2;106;843;850;7;92;2.0
2;107;850;858;8;92;2.0
2;108;858;861;3;92;2.0
2;109;861;864;3;92;2.0
2;110;864;865;1;92;2.0
2;111;865;870;5;92;2.0
2;112;870;874;4;92;2.0
2;113;874;875;1;92;2.0
2;114;875;876;1;92;2.0
2;115;876;885;9;92;2.0
2;116;885;886;1;92;2.0
2;117;886;890;4;92;2.0
2;118;890;891;1;92;2.0
2;119;891;893;2;92;2.0
2;120;893;901;8;92;2.0
2;121;901;905;4;92;2.0
2;122;905;906;1;92;2.0
2;123;906;913;7;92;2.0
2;124;913;918;5;92;2.0
2;125;918;920;2;92;2.0
2;126;920;921;1;92;2.0
2;127;921;929;8;92;2.0
2;128;929;931;2;92;2.0
2;129;931;935;4;92;2.0
2;130;935;940;5;92;2.0
2;131;940;941;1;92;2.0
2;132;941;945;4;92;2.0
2;133;945;946;1;92;2.0
2;134;946;953;7;92;2.0
2;135;953;960;7;92;2.0
2;136;960;961;1;92;2.0
2;137;961;969;8;92;2.0
2;138;969;973;4;92;2.0
2;139;973;980;7;92;2.0
2;140;980;981;1;92;2.0
2;141;981;984;3;92;2.0
2;142;984;996;12;92;2.0
2;143;996;1000;4;92;2.0
2;144;1000;1006;6;92;2.0
2;145;1006;1017;11;92;2.0
2;146;1017;1019;2;92;2.0
2;147;1019;1020;1;92;2.0
2;148;1020;1025;5;92;2.0
2;149;1025;1029;4;92;2.0
2;150;1029;1030;1;92;2.0
2;151;1030;1036;6;92;2.0
2;152;1036;1038;2;92;2.0
2;153;1038;1046;8;92;2.0
2;154;1046;1049;3;92;2.0
2;155;1049;1050;1;92;2.0
2;156;1050;1060;10;92;2.0
2;157;1060;1061;1;92;2.0
2;158;1061;1062;1;92;2.0
2;159;1062;1070;8;92;2.0
2;160;1070;1080;10;92;2.0
2;161;1080;1086;6;92;2.0
2;162;1086;1090;4;92;2.0
2;163;1090;1092;2;92;2.0
2;164;1092;1100;8;92;2.0
2;165;1100;1101;1;92;2.0
2;166;1101;1104;3;92;2.0
2;167;1104;1107;3;92;2.0
2;168;1107;1113;6;92;2.0
2;169;1113;1118;5;92;2.0
2;170;1118;1127;9;92;2.0
2;171;1127;1136;9;92;2.0
2;172;1136;1140;4;92;2.0
2;173;1140;1148;8;92;2.0
2;174;1148;1149;1;92;2.0
2;175;1149;1155;6;92;2.0
2;176;1155;1174;19;92;2.0
2;177;1174;1176;2;92;2.0
2;178;1176;1178;2;92;2.0
2;179;1178;1187;9;92;2.0
2;180;1187;1203;16;92;2.0
2;181;1203;1209;6;92;2.0
2;182;1209;1211;2;92;2.0
2;183;1211;1224;13;92;2.0
2;184;1224;1238;14;92;2.0
2;185;1238;1262;24;92;2.0
2;186;1262;1265;3;92;2.0
2;187;1265;1267;2;92;2.0
2;188;1267;1269;2;92;2.0
2;189;1269;1271;2;92;2.0
2;190;1271;1284;13;92;2.0
2;191;1284;1298;14;92;2.0
2;192;1298;1302;4;92;2.0
2;193;1302;1319;17;92;2.0
2;194;1319;1325;6;92;2.0
2;195;1325;1341;16;92;2.0
2;196;1341;1347;6;92;2.0
2;197;1347;1364;17;92;2.0
2;198;1364;1366;2;92;2.0
2;199;1366;1369;3;92;2.0
2;200;1369;1376;7;92;2.0
2;201;1376;1383;7;92;2.0
2;202;1383;1389;6;92;2.0
2;203;1389;1404;15;92;2.0
2;204;1404;1419;15;92;2.0
2;205;1419;1434;15;92;2.0
2;206;1434;1449;15;92;2.0
2;207;1449;1464;15;92;2.0
2;208;1464;1479;15;92;2.0
2;209;1479;1494;15;92;2.0
2;210;1494;1509;15;92;2.0
2;211;1509;1524;15;92;2.0
2;212;1524;1539;15;92;2.0
2;213;1539;1554;15;92;2.0
2;214;1554;1569;15;92;2.0
2;215;1569;1584;15;92;2.0
2;216;1584;1599;15;92;2.0
2;217;1599;1614;15;92;2.0
2;218;1614;1629;15;92;2.0
2;219;1629;1644;15;92;2.0
2;220;1644;1659;15;92;2.0
2;221;1659;1674;15;92;2.0
2;222;1674;1680;6;92;2.0
3;0;248;332;84;77;2.0
3;1;332;335;3;77;2.0
3;2;335;340;5;77;2.0
3;3;340;343;3;77;2.0
3;4;343;346;3;77;2.0
3;5;346;347;1;77;2.0
3;6;347;350;3;77;2.0
3;7;350;351;1;77;2.0
3;8;351;356;5;77;2.0
3;9;356;362;6;77;2.0
3;10;362;363;1;77;2.0
3;11;363;365;2;77;2.0
3;12;365;366;1;77;2.0
3;13;366;371;5;77;2.0
3;14;371;378;7;77;2.0
3;15;378;385;7;77;2.0
3;16;385;386;1;77;2.0
3;17;386;391;5;77;2.0
3;18;391;392;1;77;2.0
3;19;392;397;5;77;2.0
3;20;397;398;1;77;2.0
3;21;398;400;2;77;2.0
3;22;400;401;1;77;2.0
3;23;401;402;1;77;2.0
3;24;402;407;5;77;2.0
3;25;407;410;3;77;2.0
3;26;410;413;3;77;2.0
3;27;413;414;1;77;2.0
3;28;414;416;2;77;2.0
3;29;416;420;4;77;2.0
3;30;420;421;1;77;2.0
3;31;421;422;1;77;2.0
3;32;422;424;2;77;2.0
3;33;424;426;2;77;2.0
3;34;426;431;5;77;2.0
3;35;431;433;2;77;2.0
3;36;433;437;4;77;2.0
3;37;437;441;4;77;2.0
3;38;441;445;4;77;2.0
3;39;445;448;3;77;2.0
3;40;448;452;4;77;2.0
3;41;452;455;3;77;2.0
3;42;455;456;1;77;2.0
3;43;456;458;2;77;2.0
3;44;458;466;8;77;2.0
3;45;466;467;1;77;2.0
3;46;467;468;1;77;2.0
3;47;468;471;3;77;2.0
3;48;471;476;5;77;2.0
3;49;476;481;5;77;2.0
3;50;481;482;1;77;2.0
3;51;482;485;3;77;2.0
3;52;485;486;1;77;2.0
3;53;486;497;11;77;2.0
3;54;497;503;6;77;2.0
3;55;503;507;4;77;2.0
3;56;507;511;4;77;2.0
3;57;511;516;5;77;2.0
3;58;516;520;4;77;2.0
3;59;520;529;9;77;2.0
3;60;529;533;4;77;2.0
3;61;533;535;2;77;2.0
3;62;535;540;5;77;2.0
3;63;540;546;6;77;2.0
3;64;546;549;3;77;2.0
3;65;549;552;3;77;2.0
3;66;552;556;4;77;2.0
3;67;556;560;4;77;2.0
3;68;560;586;26;77;2.0
3;69;586;588;2;77;2.0
3;70;588;591;3;77;2.0
3;71;591;592;1;77;2.0
3;72;592;595;3;77;2.0
3;73;595;596;1;77;2.0
3;74;596;621;25;77;2.0
3;75;621;629;8;77;2.0
3;76;629;631;2;77;2.0
3;77;631;638;7;77;2.0
3;78;638;640;2;77;2.0
3;79;640;656;16;77;2.0
3;80;656;660;4;77;2.0
3;81;660;661;1;77;2.0
3;82;661;672;11;77;2.0
3;83;672;680;8;77;2.0
3;84;680;691;11;77;2.0
3;85;691;701;10;77;2.0
3;86;701;708;7;77;2.0
3;87;708;721;13;77;2.0
3;88;721;722;1;77;2.0
3;89;722;725;3;77;2.0
3;90;725;726;1;77;2.0
3;91;726;731;5;77;2.0
3;92;731;750;19;77;2.0
3;93;750;752;2;77;2.0
3;94;752;766;14;77;2.0
3;95;766;767;1;77;2.0
3;96;767;768;1;77;2.0
3;97;768;770;2;77;2.0
3;98;770;781;11;77;2.0
3;99;781;786;5;77;2.0
3;100;786;787;1;77;2.0
3;101;787;802;15;77;2.0
3;102;802;803;1;77;2.0
3;103;803;807;4;77;2.0
3;104;807;811;4;77;2.0
3;105;811;816;5;77;2.0
3;106;816;817;1;77;2.0
3;107;817;822;5;77;2.0
3;108;822;825;3;77;2.0
3;109;825;828;3;77;2.0
3;110;828;836;8;77;2.0
3;111;836;838;2;77;2.0
3;112;838;843;5;77;2.0
3;113;843;846;3;77;2.0
3;114;846;853;7;77;2.0
3;115;853;858;5;77;2.0
3;116;858;861;3;77;2.0
3;117;861;862;1;77;2.0
3;118;862;872;10;77;2.0
3;119;872;873;1;77;2.0
3;120;873;875;2;77;2.0
3;121;875;884;9;77;2.0
3;122;884;886;2;77;2.0
3;123;886;888;2;77;2.0
3;124;888;891;3;77;2.0
3;125;891;893;2;77;2.0
3;126;893;901;8;77;2.0
3;127;901;906;5;77;2.0
3;128;906;908;2;77;2.0
3;129;908;913;5;77;2.0
3;130;913;916;3;77;2.0
3;131;916;918;2;77;2.0
3;132;918;919;1;77;2.0
3;133;919;923;4;77;2.0
3;134;923;929;6;77;2.0
3;135;929;931;2;77;2.0
3;136;931;935;4;77;2.0
3;137;935;936;1;77;2.0
3;138;936;939;3;77;2.0
3;139;939;941;2;77;2.0
3;140;941;946;5;77;2.0
3;141;946;948;2;77;2.0
3;142;948;953;5;77;2.0
3;143;953;956;3;77;2.0
3;144;956;961;5;77;2.0
3;145;961;963;2;77;2.0
3;146;963;969;6;77;2.0
3;147;969;973;4;77;2.0
3;148;973;976;3;77;2.0
3;149;976;981;5;77;2.0
3;150;981;983;2;77;2.0
3;151;983;984;1;77;2.0
3;152;984;996;12;77;2.0
3;153;996;1003;7;77;2.0
3;154;1003;1004;1;77;2.0
3;155;1004;1006;2;77;2.0
3;156;1006;1016;10;77;2.0
3;157;1016;1017;1;77;2.0
3;158;1017;1019;2;77;2.0
3;159;1019;1025;6;77;2.0
3;160;1025;1029;4;77;2.0
3;161;1029;1033;4;77;2.0
3;162;1033;1034;1;77;2.0
3;163;1034;1038;4;77;2.0
3;164;1038;1046;8;77;2.0
3;165;1046;1049;3;77;2.0
3;166;1049;1050;1;77;2.0
3;167;1050;1053;3;77;2.0
3;168;1053;1056;3;77;2.0
3;169;1056;1059;3;77;2.0
3;170;1059;1062;3;77;2.0
3;171;1062;1073;11;77;2.0
3;172;1073;1076;3;77;2.0
3;173;1076;1080;4;77;2.0
3;174;1080;1084;4;77;2.0
3;175;1084;1086;2;77;2.0
3;176;1086;1092;6;77;2.0
3;177;1092;1093;1;77;2.0
3;178;1093;1100;7;77;2.0
3;179;1100;1101;1;77;2.0
3;180;1101;1104;3;77;2.0
3;181;1104;1107;3;77;2.0
3;182;1107;1110;3;77;2.0
3;183;1110;1118;8;77;2.0
3;184;1118;1127;9;77;2.0
3;185;1127;1132;5;77;2.0
3;186;1132;1138;6;77;2.0
3;187;1138;1148;10;77;2.0
3;188;1148;1152;4;77;2.0
3;189;1152;1155;3;77;2.0
3;190;1155;1172;17;77;2.0
3;191;1172;1174;2;77;2.0
3;192;1174;1178;4;77;2.0
3;193;1178;1187;9;77;2.0
3;194;1187;1200;13;77;2.0
3;195;1200;1207;7;77;2.0
3;196;1207;1209;2;77;2.0
3;197;1209;1212;3;77;2.0
3;198;1212;1224;12;77;2.0
3;199;1224;1238;14;77;2.0
3;200;1238;1262;24;77;2.0
3;201;1262;1263;1;77;2.0
3;202;1263;1267;4;77;2.0
3;203;1267;1272;5;77;2.0
3;204;1272;1284;12;77;2.0
3;205;1284;1298;14;77;2.0
3;206;1298;1302;4;77;2.0
3;207;1302;1321;19;77;2.0
3;208;1321;1322;1;77;2.0
3;209;1322;1323;1;77;2.0
3;210;1323;1341;18;77;2.0
3;211;1341;1346;5;77;2.0
3;212;1346;1364;18;77;2.0
3;213;1364;1366;2;77;2.0
3;214;1366;1369;3;77;2.0
3;215;1369;1372;3;77;2.0
3;216;1372;1383;11;77;2.0
3;217;1383;1386;3;77;2.0
3;218;1386;1389;3;77;2.0
3;219;1389;1404;15;77;2.0
3;220;1404;1419;15;77;2.0
3;221;1419;1434;15;77;2.0
3;222;1434;1449;15;77;2.0
3;223;1449;1464;15;77;2.0
3;224;1464;1479;15;77;2.0
3;225;1479;1494;15;77;2.0
3;226;1494;1509;15;77;2.0
3;227;1509;1524;15;77;2.0
3;228;1524;1539;15;77;2.0
3;229;1539;1554;15;77;2.0
3;230;1554;1569;15;77;2.0
3;231;1569;1584;15;77;2.0
3;232;1584;1599;15;77;2.0
3;233;1599;1614;15;77;2.0
3;234;1614;1629;15;77;2.0
3;235;1629;1644;15;77;2.0
3;236;1644;1659;15;77;2.0
3;237;1659;1680;21;77;2.0
4;0;245;333;88;119;2.0
4;1;333;336;3;119;2.0
4;2;336;338;2;119;2.0
4;3;338;340;2;119;2.0
4;4;340;348;8;119;2.0
4;5;348;349;1;119;2.0
4;6;349;350;1;119;2.0
4;7;350;360;10;119;2.0
4;8;360;363;3;119;2.0
4;9;363;364;1;119;2.0
4;10;364;369;5;119;2.0
4;11;369;375;6;119;2.0
4;12;375;383;8;119;2.0
4;13;383;389;6;119;2.0
4;14;389;390;1;119;2.0
4;15;390;393;3;119;2.0
4;16;393;395;2;119;2.0
4;17;395;398;3;119;2.0
4;18;398;400;2;119;2.0
4;19;400;405;5;119;2.0
4;20;405;408;3;119;2.0
4;21;408;410;2;119;2.0
4;22;410;412;2;119;2.0
4;23;412;418;6;119;2.0
4;24;418;419;1;119;2.0
4;25;419;420;1;119;2.0
4;26;420;422;2;119;2.0
4;27;422;423;1;119;2.0
4;28;423;429;6;119;2.0
4;29;429;430;1;119;2.0
4;30;430;438;8;119;2.0
4;31;438;439;1;119;2.0
4;32;439;445;6;119;2.0
4;33;445;449;4;119;2.0
4;34;449;453;4;119;2.0
4;35;453;454;1;119;2.0
4;36;454;455;1;119;2.0
4;37;455;464;9;119;2.0
4;38;464;465;1;119;2.0
4;39;465;468;3;119;2.0
4;40;468;469;1;119;2.0
4;41;469;470;1;119;2.0
4;42;470;474;4;119;2.0
4;43;474;480;6;119;2.0
4;44;480;483;3;119;2.0
4;45;483;484;1;119;2.0
4;46;484;485;1;119;2.0
4;47;485;495;10;119;2.0
4;48;495;498;3;119;2.0
4;49;498;500;2;119;2.0
4;50;500;505;5;119;2.0
4;51;505;509;4;119;2.0
4;52;509;514;5;119;2.0
4;53;514;518;4;119;2.0
4;54;518;520;2;119;2.0
4;55;520;527;7;119;2.0
4;56;527;530;3;119;2.0
4;57;530;533;3;119;2.0
4;58;533;538;5;119;2.0
4;59;538;544;6;119;2.0
4;60;544;550;6;119;2.0
4;61;550;554;4;119;2.0
4;62;554;558;4;119;2.0
4;63;558;585;27;119;2.0
4;64;585;589;4;119;2.0
4;65;589;590;1;119;2.0
4;66;590;593;3;119;2.0
4;67;593;594;1;119;2.0
4;68;594;625;31;119;2.0
4;69;625;629;4;119;2.0
4;70;629;630;1;119;2.0
4;71;630;635;5;119;2.0
4;72;635;638;3;119;2.0
4;73;638;658;20;119;2.0
4;74;658;659;1;119;2.0
4;75;659;660;1;119;2.0
4;76;660;673;13;119;2.0
4;77;673;678;5;119;2.0
4;78;678;695;17;119;2.0
4;79;695;699;4;119;2.0
4;80;699;705;6;119;2.0
4;81;705;719;14;119;2.0
4;82;719;723;4;119;2.0
4;83;723;729;6;119;2.0
4;84;729;730;1;119;2.0
4;85;730;748;18;119;2.0
4;86;748;750;2;119;2.0
4;87;750;765;15;119;2.0
4;88;765;768;3;119;2.0
4;89;768;770;2;119;2.0
4;90;770;779;9;119;2.0
4;91;779;785;6;119;2.0
4;92;785;790;5;119;2.0
4;93;790;800;10;119;2.0
4;94;800;808;8;119;2.0
4;95;808;809;1;119;2.0
4;96;809;815;6;119;2.0
4;97;815;820;5;119;2.0
4;98;820;823;3;119;2.0
4;99;823;825;2;119;2.0
4;100;825;834;9;119;2.0
4;101;834;836;2;119;2.0
4;102;836;840;4;119;2.0
4;103;840;841;1;119;2.0
4;104;841;850;9;119;2.0
4;105;850;856;6;119;2.0
4;106;856;859;3;119;2.0
4;107;859;863;4;119;2.0
4;108;863;865;2;119;2.0
4;109;865;870;5;119;2.0
4;110;870;873;3;119;2.0
4;111;873;874;1;119;2.0
4;112;874;885;11;119;2.0
4;113;885;889;4;119;2.0
4;114;889;890;1;119;2.0
4;115;890;891;1;119;2.0
4;116;891;899;8;119;2.0
4;117;899;904;5;119;2.0
4;118;904;905;1;119;2.0
4;119;905;911;6;119;2.0
4;120;911;916;5;119;2.0
4;121;916;920;4;119;2.0
4;122;920;927;7;119;2.0
4;123;927;929;2;119;2.0
4;124;929;933;4;119;2.0
4;125;933;939;6;119;2.0
4;126;939;940;1;119;2.0
4;127;940;944;4;119;2.0
4;128;944;945;1;119;2.0
4;129;945;951;6;119;2.0
4;130;951;959;8;119;2.0
4;131;959;960;1;119;2.0
4;132;960;967;7;119;2.0
4;133;967;971;4;119;2.0
4;134;971;979;8;119;2.0
4;135;979;980;1;119;2.0
4;136;980;982;2;119;2.0
4;137;982;994;12;119;2.0
4;138;994;1000;6;119;2.0
4;139;1000;1004;4;119;2.0
4;140;1004;1005;1;119;2.0
4;141;1005;1015;10;119;2.0
4;142;1015;1017;2;119;2.0
4;143;1017;1020;3;119;2.0
4;144;1020;1023;3;119;2.0
4;145;1023;1027;4;119;2.0
4;146;1027;1030;3;119;2.0
4;147;1030;1035;5;119;2.0
4;148;1035;1036;1;119;2.0
4;149;1036;1044;8;119;2.0
4;150;1044;1047;3;119;2.0
4;151;1047;1048;1;119;2.0
4;152;1048;1050;2;119;2.0
4;153;1050;1060;10;119;2.0
4;154;1060;1070;10;119;2.0
4;155;1070;1078;8;119;2.0
4;156;1078;1080;2;119;2.0
4;157;1080;1084;4;119;2.0
4;158;1084;1085;1;119;2.0
4;159;1085;1090;5;119;2.0
4;160;1090;1098;8;119;2.0
4;161;1098;1099;1;119;2.0
4;162;1099;1102;3;119;2.0
4;163;1102;1105;3;119;2.0
4;164;1105;1111;6;119;2.0
4;165;1111;1116;5;119;2.0
4;166;1116;1125;9;119;2.0
4;167;1125;1136;11;119;2.0
4;168;1136;1139;3;119;2.0
4;169;1139;1146;7;119;2.0
4;170;1146;1149;3;119;2.0
4;171;1149;1153;4;119;2.0
4;172;1153;1172;19;119;2.0
4;173;1172;1176;4;119;2.0
4;174;1176;1185;9;119;2.0
4;175;1185;1201;16;119;2.0
4;176;1201;1207;6;119;2.0
4;177;1207;1209;2;119;2.0
4;178;1209;1211;2;119;2.0
4;179;1211;1222;11;119;2.0
4;180;1222;1236;14;119;2.0
4;181;1236;1260;24;119;2.0
4;182;1260;1264;4;119;2.0
4;183;1264;1265;1;119;2.0
4;184;1265;1269;4;119;2.0
4;185;1269;1271;2;119;2.0
4;186;1271;1282;11;119;2.0
4;187;1282;1296;14;119;2.0
4;188;1296;1300;4;119;2.0
4;189;1300;1319;19;119;2.0
4;190;1319;1324;5;119;2.0
4;191;1324;1325;1;119;2.0
4;192;1325;1339;14;119;2.0
4;193;1339;1345;6;119;2.0
4;194;1345;1362;17;119;2.0
4;195;1362;1364;2;119;2.0
4;196;1364;1367;3;119;2.0
4;197;1367;1376;9;119;2.0
4;198;1376;1381;5;119;2.0
4;199;1381;1383;2;119;2.0
4;200;1383;1387;4;119;2.0
4;201;1387;1402;15;119;2.0
4;202;1402;1417;15;119;2.0
4;203;1417;1432;15;119;2.0
4;204;1432;1447;15;119;2.0
4;205;1447;1462;15;119;2.0
4;206;1462;1477;15;119;2.0
4;207;1477;1492;15;119;2.0
4;208;1492;1507;15;119;2.0
4;209;1507;1522;15;119;2.0
4;210;1522;1537;15;119;2.0
4;211;1537;1552;15;119;2.0
4;212;1552;1567;15;119;2.0
4;213;1567;1582;15;119;2.0
4;214;1582;1597;15;119;2.0
4;215;1597;1612;15;119;2.0
4;216;1612;1627;15;119;2.0
4;217;1627;1642;15;119;2.0
4;218;1642;1657;15;119;2.0
4;219;1657;1672;15;119;2.0
4;220;1672;1680;8;119;2.0
5;0;243;335;92;96;2.0
5;1;335;338;3;96;2.0
5;2;338;339;1;96;2.0
5;3;339;350;11;96;2.0
5;4;350;352;2;96;2.0
5;5;352;358;6;96;2.0
5;6;358;362;4;96;2.0
5;7;362;365;3;96;2.0
5;8;365;370;5;96;2.0
5;9;370;371;1;96;2.0
5;10;371;373;2;96;2.0
5;11;373;385;12;96;2.0
5;12;385;390;5;96;2.0
5;13;390;392;2;96;2.0
5;14;392;393;1;96;2.0
5;15;393;395;2;96;2.0
5;16;395;396;1;96;2.0
5;17;396;400;4;96;2.0
5;18;400;401;1;96;2.0
5;19;401;407;6;96;2.0
5;20;407;408;1;96;2.0
5;21;408;409;1;96;2.0
5;22;409;410;1;96;2.0
5;23;410;413;3;96;2.0
5;24;413;420;7;96;2.0
5;25;420;421;1;96;2.0
5;26;421;422;1;96;2.0
5;27;422;423;1;96;2.0
5;28;423;425;2;96;2.0
5;29;425;428;3;96;2.0
5;30;428;430;2;96;2.0
5;31;430;432;2;96;2.0
5;32;432;440;8;96;2.0
5;33;440;443;3;96;2.0
5;34;443;451;8;96;2.0
5;35;451;453;2;96;2.0
5;36;453;455;2;96;2.0
5;37;455;456;1;96;2.0
5;38;456;463;7;96;2.0
5;39;463;466;3;96;2.0
5;40;466;470;4;96;2.0
5;41;470;472;2;96;2.0
5;42;472;476;4;96;2.0
5;43;476;482;6;96;2.0
5;44;482;485;3;96;2.0
5;45;485;487;2;96;2.0
5;46;487;497;10;96;2.0
5;47;497;498;1;96;2.0
5;48;498;500;2;96;2.0
5;49;500;507;7;96;2.0
5;50;507;510;3;96;2.0
5;51;510;516;6;96;2.0
5;52;516;518;2;96;2.0
5;53;518;522;4;96;2.0
5;54;522;528;6;96;2.0
5;55;528;535;7;96;2.0
5;56;535;540;5;96;2.0
5;57;540;546;6;96;2.0
5;58;546;552;6;96;2.0
5;59;552;555;3;96;2.0
5;60;555;558;3;96;2.0
5;61;558;583;25;96;2.0
5;62;583;590;7;96;2.0
5;63;590;592;2;96;2.0
5;64;592;593;1;96;2.0
5;65;593;595;2;96;2.0
5;66;595;596;1;96;2.0
5;67;596;627;31;96;2.0
5;68;627;630;3;96;2.0
5;69;630;632;2;96;2.0
5;70;632;633;1;96;2.0
5;71;633;638;5;96;2.0
5;72;638;660;22;96;2.0
5;73;660;662;2;96;2.0
5;74;662;675;13;96;2.0
5;75;675;678;3;96;2.0
5;76;678;697;19;96;2.0
5;77;697;700;3;96;2.0
5;78;700;703;3;96;2.0
5;79;703;721;18;96;2.0
5;80;721;723;2;96;2.0
5;81;723;725;2;96;2.0
5;82;725;730;5;96;2.0
5;83;730;732;2;96;2.0
5;84;732;750;18;96;2.0
5;85;750;751;1;96;2.0
5;86;751;763;12;96;2.0
5;87;763;768;5;96;2.0
5;88;768;770;2;96;2.0
5;89;770;772;2;96;2.0
5;90;772;780;8;96;2.0
5;91;780;781;1;96;2.0
5;92;781;787;6;96;2.0
5;93;787;792;5;96;2.0
5;94;792;798;6;96;2.0
5;95;798;801;3;96;2.0
5;96;801;810;9;96;2.0
5;97;810;817;7;96;2.0
5;98;817;821;4;96;2.0
5;99;821;822;1;96;2.0
5;100;822;823;1;96;2.0
5;101;823;825;2;96;2.0
5;102;825;836;11;96;2.0
5;103;836;837;1;96;2.0
5;104;837;842;5;96;2.0
5;105;842;848;6;96;2.0
5;106;848;852;4;96;2.0
5;107;852;857;5;96;2.0
5;108;857;860;3;96;2.0
5;109;860;865;5;96;2.0
5;110;865;867;2;96;2.0
5;111;867;868;1;96;2.0
5;112;868;874;6;96;2.0
5;113;874;875;1;96;2.0
5;114;875;883;8;96;2.0
5;115;883;887;4;96;2.0
5;116;887;890;3;96;2.0
5;117;890;891;1;96;2.0
5;118;891;892;1;96;2.0
5;119;892;900;8;96;2.0
5;120;900;903;3;96;2.0
5;121;903;906;3;96;2.0
5;122;906;907;1;96;2.0
5;123;907;912;5;96;2.0
5;124;912;917;5;96;2.0
5;125;917;918;1;96;2.0
5;126;918;922;4;96;2.0
5;127;922;928;6;96;2.0
5;128;928;930;2;96;2.0
5;129;930;935;5;96;2.0
5;130;935;941;6;96;2.0
5;131;941;942;1;96;2.0
5;132;942;943;1;96;2.0
5;133;943;945;2;96;2.0
5;134;945;952;7;96;2.0
5;135;952;958;6;96;2.0
5;136;958;960;2;96;2.0
5;137;960;961;1;96;2.0
5;138;961;962;1;96;2.0
5;139;962;969;7;96;2.0
5;140;969;972;3;96;2.0
5;141;972;978;6;96;2.0
5;142;978;980;2;96;2.0
5;143;980;981;1;96;2.0
5;144;981;982;1;96;2.0
5;145;982;984;2;96;2.0
5;146;984;996;12;96;2.0
5;147;996;998;2;96;2.0
5;148;998;1002;4;96;2.0
5;149;1002;1005;3;96;2.0
5;150;1005;1007;2;96;2.0
5;151;1007;1017;10;96;2.0
5;152;1017;1018;1;96;2.0
5;153;1018;1022;4;96;2.0
5;154;1022;1025;3;96;2.0
5;155;1025;1028;3;96;2.0
5;156;1028;1037;9;96;2.0
5;157;1037;1046;9;96;2.0
5;158;1046;1048;2;96;2.0
5;159;1048;1049;1;96;2.0
5;160;1049;1060;11;96;2.0
5;161;1060;1062;2;96;2.0
5;162;1062;1068;6;96;2.0
5;163;1068;1079;11;96;2.0
5;164;1079;1080;1;96;2.0
5;165;1080;1082;2;96;2.0
5;166;1082;1086;4;96;2.0
5;167;1086;1087;1;96;2.0
5;168;1087;1088;1;96;2.0
5;169;1088;1090;2;96;2.0
5;170;1090;1099;9;96;2.0
5;171;1099;1101;2;96;2.0
5;172;1101;1104;3;96;2.0
5;173;1104;1106;2;96;2.0
5;174;1106;1113;7;96;2.0
5;175;1113;1116;3;96;2.0
5;176;1116;1126;10;96;2.0
5;177;1126;1138;12;96;2.0
5;178;1138;1141;3;96;2.0
5;179;1141;1146;5;96;2.0
5;180;1146;1147;1;96;2.0
5;181;1147;1155;8;96;2.0
5;182;1155;1174;19;96;2.0
5;183;1174;1176;2;96;2.0
5;184;1176;1178;2;96;2.0
5;185;1178;1186;8;96;2.0
5;186;1186;1203;17;96;2.0
5;187;1203;1207;4;96;2.0
5;188;1207;1208;1;96;2.0
5;189;1208;1213;5;96;2.0
5;190;1213;1224;11;96;2.0
5;191;1224;1236;12;96;2.0
5;192;1236;1261;25;96;2.0
5;193;1261;1266;5;96;2.0
5;194;1266;1267;1;96;2.0
5;195;1267;1273;6;96;2.0
5;196;1273;1284;11;96;2.0
5;197;1284;1296;12;96;2.0
5;198;1296;1301;5;96;2.0
5;199;1301;1317;16;96;2.0
5;200;1317;1326;9;96;2.0
5;201;1326;1327;1;96;2.0
5;202;1327;1341;14;96;2.0
5;203;1341;1345;4;96;2.0
5;204;1345;1362;17;96;2.0
5;205;1362;1365;3;96;2.0
5;206;1365;1366;1;96;2.0
5;207;1366;1368;2;96;2.0
5;208;1368;1378;10;96;2.0
5;209;1378;1381;3;96;2.0
5;210;1381;1382;1;96;2.0
5;211;1382;1389;7;96;2.0
5;212;1389;1404;15;96;2.0
5;213;1404;1419;15;96;2.0
5;214;1419;1434;15;96;2.0
5;215;1434;1449;15;96;2.0
5;216;1449;1464;15;96;2.0
5;217;1464;1479;15;96;2.0
5;218;1479;1494;15;96;2.0
5;219;1494;1509;15;96;2.0
5;220;1509;1524;15;96;2.0
5;221;1524;1539;15;96;2.0
5;222;1539;1554;15;96;2.0
5;223;1554;1569;15;96;2.0
5;224;1569;1584;15;96;2.0
5;225;1584;1599;15;96;2.0
5;226;1599;1614;15;96;2.0
5;227;1614;1629;15;96;2.0
5;228;1629;1644;15;96;2.0
5;229;1644;1659;15;96;2.0
5;230;1659;1674;15;96;2.0
5;231;1674;1680;6;96;2.0
6;0;252;326;74;160;2.0
6;1;326;331;5;160;2.0
6;2;331;337;6;160;2.0
6;3;337;340;3;160;2.0
6;4;340;342;2;160;2.0
6;5;342;343;1;160;2.0
6;6;343;346;3;160;2.0
6;7;346;348;2;160;2.0
6;8;348;350;2;160;2.0
6;9;350;352;2;160;2.0
6;10;352;354;2;160;2.0
6;11;354;359;5;160;2.0
6;12;359;361;2;160;2.0
6;13;361;367;6;160;2.0
6;14;367;368;1;160;2.0
6;15;368;369;1;160;2.0
6;16;369;374;5;160;2.0
6;17;374;380;6;160;2.0
6;18;380;383;3;160;2.0
6;19;383;387;4;160;2.0
6;20;387;391;4;160;2.0
6;21;391;394;3;160;2.0
6;22;394;395;1;160;2.0
6;23;395;400;5;160;2.0
6;24;400;402;2;160;2.0
6;25;402;403;1;160;2.0
6;26;403;405;2;160;2.0
6;27;405;406;1;160;2.0
6;28;406;410;4;160;2.0
6;29;410;413;3;160;2.0
6;30;413;417;4;160;2.0
6;31;417;418;1;160;2.0
6;32;418;420;2;160;2.0
6;33;420;421;1;160;2.0
6;34;421;422;1;160;2.0
6;35;422;425;3;160;2.0
6;36;425;427;2;160;2.0
6;37;427;434;7;160;2.0
6;38;434;436;2;160;2.0
6;39;436;438;2;160;2.0
6;40;438;439;1;160;2.0
6;41;439;444;5;160;2.0
6;42;444;451;7;160;2.0
6;43;451;453;2;160;2.0
6;44;453;457;4;160;2.0
6;45;457;459;2;160;2.0
6;46;459;460;1;160;2.0
6;47;460;463;3;160;2.0
6;48;463;466;3;160;2.0
6;49;466;470;4;160;2.0
6;50;470;473;3;160;2.0
6;51;473;474;1;160;2.0
6;52;474;475;1;160;2.0
6;53;475;477;2;160;2.0
6;54;477;480;3;160;2.0
6;55;480;481;1;160;2.0
6;56;481;489;8;160;2.0
6;57;489;496;7;160;2.0
6;58;496;501;5;160;2.0
6;59;501;508;7;160;2.0
6;60;508;510;2;160;2.0
6;61;510;511;1;160;2.0
6;62;511;514;3;160;2.0
6;63;514;520;6;160;2.0
6;64;520;522;2;160;2.0
6;65;522;535;13;160;2.0
6;66;535;537;2;160;2.0
6;67;537;538;1;160;2.0
6;68;538;544;6;160;2.0
6;69;544;549;5;160;2.0
6;70;549;550;1;160;2.0
6;71;550;556;6;160;2.0
6;72;556;559;3;160;2.0
6;73;559;562;3;160;2.0
6;74;562;580;18;160;2.0
6;75;580;591;11;160;2.0
6;76;591;593;2;160;2.0
6;77;593;594;1;160;2.0
6;78;594;597;3;160;2.0
6;79;597;600;3;160;2.0
6;80;600;615;15;160;2.0
6;81;615;629;14;160;2.0
6;82;629;634;5;160;2.0
6;83;634;642;8;160;2.0
6;84;642;643;1;160;2.0
6;85;643;650;7;160;2.0
6;86;650;662;12;160;2.0
6;87;662;664;2;160;2.0
6;88;664;671;7;160;2.0
6;89;671;682;11;160;2.0
6;90;682;685;3;160;2.0
6;91;685;704;19;160;2.0
6;92;704;713;9;160;2.0
6;93;713;720;7;160;2.0
6;94;720;721;1;160;2.0
6;95;721;725;4;160;2.0
6;96;725;727;2;160;2.0
6;97;727;734;7;160;2.0
6;98;734;752;18;160;2.0
6;99;752;758;6;160;2.0
6;100;758;760;2;160;2.0
6;101;760;766;6;160;2.0
6;102;766;772;6;160;2.0
6;103;772;773;1;160;2.0
6;104;773;780;7;160;2.0
6;105;780;784;4;160;2.0
6;106;784;785;1;160;2.0
6;107;785;791;6;160;2.0
6;108;791;806;15;160;2.0
6;109;806;808;2;160;2.0
6;110;808;810;2;160;2.0
6;111;810;814;4;160;2.0
6;112;814;821;7;160;2.0
6;113;821;827;6;160;2.0
6;114;827;828;1;160;2.0
6;115;828;830;2;160;2.0
6;116;830;833;3;160;2.0
6;117;833;840;7;160;2.0
6;118;840;841;1;160;2.0
6;119;841;846;5;160;2.0
6;120;846;855;9;160;2.0
6;121;855;858;3;160;2.0
6;122;858;861;3;160;2.0
6;123;861;864;3;160;2.0
6;124;864;871;7;160;2.0
6;125;871;877;6;160;2.0
6;126;877;878;1;160;2.0
6;127;878;880;2;160;2.0
6;128;880;883;3;160;2.0
6;129;883;893;10;160;2.0
6;130;893;894;1;160;2.0
6;131;894;895;1;160;2.0
6;132;895;896;1;160;2.0
6;133;896;904;8;160;2.0
6;134;904;910;6;160;2.0
6;135;910;913;3;160;2.0
6;136;913;916;3;160;2.0
6;137;916;918;2;160;2.0
6;138;918;921;3;160;2.0
6;139;921;928;7;160;2.0
6;140;928;930;2;160;2.0
6;141;930;934;4;160;2.0
6;142;934;935;1;160;2.0
6;143;935;937;2;160;2.0
6;144;937;938;1;160;2.0
6;145;938;945;7;160;2.0
6;146;945;949;4;160;2.0
6;147;949;950;1;160;2.0
6;148;950;953;3;160;2.0
6;149;953;956;3;160;2.0
6;150;956;964;8;160;2.0
6;151;964;965;1;160;2.0
6;152;965;968;3;160;2.0
6;153;968;970;2;160;2.0
6;154;970;973;3;160;2.0
6;155;973;976;3;160;2.0
6;156;976;984;8;160;2.0
6;157;984;985;1;160;2.0
6;158;985;988;3;160;2.0
6;159;988;990;2;160;2.0
6;160;990;1000;10;160;2.0
6;161;1000;1003;3;160;2.0
6;162;1003;1008;5;160;2.0
6;163;1008;1009;1;160;2.0
6;164;1009;1010;1;160;2.0
6;165;1010;1021;11;160;2.0
6;166;1021;1025;4;160;2.0
6;167;1025;1027;2;160;2.0
6;168;1027;1032;5;160;2.0
6;169;1032;1033;1;160;2.0
6;170;1033;1038;5;160;2.0
6;171;1038;1041;3;160;2.0
6;172;1041;1050;9;160;2.0
6;173;1050;1053;3;160;2.0
6;174;1053;1055;2;160;2.0
6;175;1055;1058;3;160;2.0
6;176;1058;1064;6;160;2.0
6;177;1064;1070;6;160;2.0
6;178;1070;1078;8;160;2.0
6;179;1078;1082;4;160;2.0
6;180;1082;1083;1;160;2.0
6;181;1083;1086;3;160;2.0
6;182;1086;1090;4;160;2.0
6;183;1090;1094;4;160;2.0
6;184;1094;1098;4;160;2.0
6;185;1098;1103;5;160;2.0
6;186;1103;1105;2;160;2.0
6;187;1105;1108;3;160;2.0
6;188;1108;1110;2;160;2.0
6;189;1110;1113;3;160;2.0
6;190;1113;1120;7;160;2.0
6;191;1120;1126;6;160;2.0
6;192;1126;1130;4;160;2.0
6;193;1130;1137;7;160;2.0
6;194;1137;1150;13;160;2.0
6;195;1150;1157;7;160;2.0
6;196;1157;1159;2;160;2.0
6;197;1159;1166;7;160;2.0
6;198;1166;1178;12;160;2.0
6;199;1178;1180;2;160;2.0
6;200;1180;1190;10;160;2.0
6;201;1190;1200;10;160;2.0
6;202;1200;1201;1;160;2.0
6;203;1201;1215;14;160;2.0
6;204;1215;1217;2;160;2.0
6;205;1217;1228;11;160;2.0
6;206;1228;1240;12;160;2.0
6;207;1240;1261;21;160;2.0
6;208;1261;1262;1;160;2.0
6;209;1262;1265;3;160;2.0
6;210;1265;1273;8;160;2.0
6;211;1273;1277;4;160;2.0
6;212;1277;1288;11;160;2.0
6;213;1288;1300;12;160;2.0
6;214;1300;1305;5;160;2.0
6;215;1305;1315;10;160;2.0
6;216;1315;1322;7;160;2.0
6;217;1322;1327;5;160;2.0
6;218;1327;1343;16;160;2.0
6;219;1343;1349;6;160;2.0
6;220;1349;1366;17;160;2.0
6;221;1366;1369;3;160;2.0
6;222;1369;1370;1;160;2.0
6;223;1370;1375;5;160;2.0
6;224;1375;1389;14;160;2.0
6;225;1389;1391;2;160;2.0
6;226;1391;1393;2;160;2.0
6;227;1393;1408;15;160;2.0
6;228;1408;1423;15;160;2.0
6;229;1423;1438;15;160;2.0
6;230;1438;1453;15;160;2.0
6;231;1453;1468;15;160;2.0
6;232;1468;1483;15;160;2.0
6;233;1483;1498;15;160;2.0
6;234;1498;1513;15;160;2.0
6;235;1513;1528;15;160;2.0
6;236;1528;1543;15;160;2.0
6;237;1543;1558;15;160;2.0
6;238;1558;1573;15;160;2.0
6;239;1573;1588;15;160;2.0
6;240;1588;1603;15;160;2.0
6;241;1603;1618;15;160;2.0
6;242;1618;1633;15;160;2.0
6;243;1633;1648;15;160;2.0
6;244;1648;1663;15;160;2.0
6;245;1663;1680;17;160;2.0
7;0;250;324;74;1;2.0
7;1;324;333;9;1;2.0
7;2;333;339;6;1;2.0
7;3;339;340;1;1;2.0
7;4;340;341;1;1;2.0
7;5;341;346;5;1;2.0
7;6;346;347;1;1;2.0
7;7;347;348;1;1;2.0
7;8;348;352;4;1;2.0
7;9;352;354;2;1;2.0
7;10;354;357;3;1;2.0
7;11;357;363;6;1;2.0
7;12;363;366;3;1;2.0
7;13;366;367;1;1;2.0
7;14;367;372;5;1;2.0
7;15;372;381;9;1;2.0
7;16;381;383;2;1;2.0
7;17;383;384;1;1;2.0
7;18;384;387;3;1;2.0
7;19;387;392;5;1;2.0
7;20;392;398;6;1;2.0
7;21;398;399;1;1;2.0
7;22;399;401;2;1;2.0
7;23;401;402;1;1;2.0
7;24;402;403;1;1;2.0
7;25;403;411;8;1;2.0
7;26;411;414;3;1;2.0
7;27;414;415;1;1;2.0
7;28;415;416;1;1;2.0
7;29;416;417;1;1;2.0
7;30;417;418;1;1;2.0
7;31;418;423;5;1;2.0
7;32;423;425;2;1;2.0
7;33;425;427;2;1;2.0
7;34;427;429;2;1;2.0
7;35;429;432;3;1;2.0
7;36;432;436;4;1;2.0
7;37;436;442;6;1;2.0
7;38;442;444;2;1;2.0
7;39;444;446;2;1;2.0
7;40;446;451;5;1;2.0
7;41;451;453;2;1;2.0
7;42;453;457;4;1;2.0
7;43;457;458;1;1;2.0
7;44;458;459;1;1;2.0
7;45;459;461;2;1;2.0
7;46;461;467;6;1;2.0
7;47;467;468;1;1;2.0
7;48;468;471;3;1;2.0
7;49;471;472;1;1;2.0
7;50;472;474;2;1;2.0
7;51;474;475;1;1;2.0
7;52;475;477;2;1;2.0
7;53;477;478;1;1;2.0
7;54;478;482;4;1;2.0
7;55;482;487;5;1;2.0
7;56;487;489;2;1;2.0
7;57;489;499;10;1;2.0
7;58;499;506;7;1;2.0
7;59;506;509;3;1;2.0
7;60;509;512;3;1;2.0
7;61;512;517;5;1;2.0
7;62;517;518;1;1;2.0
7;63;518;520;2;1;2.0
7;64;520;533;13;1;2.0
7;65;533;536;3;1;2.0
7;66;536;542;6;1;2.0
7;67;542;544;2;1;2.0
7;68;544;548;4;1;2.0
7;69;548;554;6;1;2.0
7;70;554;557;3;1;2.0
7;71;557;560;3;1;2.0
7;72;560;584;24;1;2.0
7;73;584;587;3;1;2.0
7;74;587;591;4;1;2.0
7;75;591;592;1;1;2.0
7;76;592;595;3;1;2.0
7;77;595;598;3;1;2.0
7;78;598;622;24;1;2.0
7;79;622;624;2;1;2.0
7;80;624;632;8;1;2.0
7;81;632;640;8;1;2.0
7;82;640;641;1;1;2.0
7;83;641;657;16;1;2.0
7;84;657;658;1;1;2.0
7;85;658;662;4;1;2.0
7;86;662;664;2;1;2.0
7;87;664;680;16;1;2.0
7;88;680;692;12;1;2.0
7;89;692;702;10;1;2.0
7;90;702;711;9;1;2.0
7;91;711;714;3;1;2.0
7;92;714;723;9;1;2.0
7;93;723;725;2;1;2.0
7;94;725;727;2;1;2.0
7;95;727;732;5;1;2.0
7;96;732;748;16;1;2.0
7;97;748;756;8;1;2.0
7;98;756;759;3;1;2.0
7;99;759;767;8;1;2.0
7;100;767;770;3;1;2.0
7;101;770;771;1;1;2.0
7;102;771;782;11;1;2.0
7;103;782;783;1;1;2.0
7;104;783;787;4;1;2.0
7;105;787;789;2;1;2.0
7;106;789;799;10;1;2.0
7;107;799;806;7;1;2.0
7;108;806;812;6;1;2.0
7;109;812;817;5;1;2.0
7;110;817;819;2;1;2.0
7;111;819;823;4;1;2.0
7;112;823;826;3;1;2.0
7;113;826;831;5;1;2.0
7;114;831;837;6;1;2.0
7;115;837;838;1;1;2.0
7;116;838;839;1;1;2.0
7;117;839;844;5;1;2.0
7;118;844;847;3;1;2.0
7;119;847;854;7;1;2.0
7;120;854;856;2;1;2.0
7;121;856;859;3;1;2.0
7;122;859;862;3;1;2.0
7;123;862;864;2;1;2.0
7;124;864;873;9;1;2.0
7;125;873;876;3;1;2.0
7;126;876;887;11;1;2.0
7;127;887;891;4;1;2.0
7;128;891;892;1;1;2.0
7;129;892;893;1;1;2.0
7;130;893;894;1;1;2.0
7;131;894;902;8;1;2.0
7;132;902;908;6;1;2.0
7;133;908;911;3;1;2.0
7;134;911;914;3;1;2.0
7;135;914;917;3;1;2.0
7;136;917;919;2;1;2.0
7;137;919;926;7;1;2.0
7;138;926;931;5;1;2.0
7;139;931;932;1;1;2.0
7;140;932;933;1;1;2.0
7;141;933;937;4;1;2.0
7;142;937;943;6;1;2.0
7;143;943;947;4;1;2.0
7;144;947;951;4;1;2.0
7;145;951;954;3;1;2.0
7;146;954;957;3;1;2.0
7;147;957;962;5;1;2.0
7;148;962;963;1;1;2.0
7;149;963;966;3;1;2.0
7;150;966;971;5;1;2.0
7;151;971;974;3;1;2.0
7;152;974;977;3;1;2.0
7;153;977;982;5;1;2.0
7;154;982;983;1;1;2.0
7;155;983;986;3;1;2.0
7;156;986;996;10;1;2.0
7;157;996;997;1;1;2.0
7;158;997;998;1;1;2.0
7;159;998;1006;8;1;2.0
7;160;1006;1007;1;1;2.0
7;161;1007;1017;10;1;2.0
7;162;1017;1019;2;1;2.0
7;163;1019;1023;4;1;2.0
7;164;1023;1026;3;1;2.0
7;165;1026;1030;4;1;2.0
7;166;1030;1036;6;1;2.0
7;167;1036;1039;3;1;2.0
7;168;1039;1048;9;1;2.0
7;169;1048;1051;3;1;2.0
7;170;1051;1053;2;1;2.0
7;171;1053;1056;3;1;2.0
7;172;1056;1057;1;1;2.0
7;173;1057;1062;5;1;2.0
7;174;1062;1076;14;1;2.0
7;175;1076;1077;1;1;2.0
7;176;1077;1078;1;1;2.0
7;177;1078;1084;6;1;2.0
7;178;1084;1088;4;1;2.0
7;179;1088;1092;4;1;2.0
7;180;1092;1096;4;1;2.0
7;181;1096;1101;5;1;2.0
7;182;1101;1103;2;1;2.0
7;183;1103;1105;2;1;2.0
7;184;1105;1106;1;1;2.0
7;185;1106;1111;5;1;2.0
7;186;1111;1118;7;1;2.0
7;187;1118;1128;10;1;2.0
7;188;1128;1130;2;1;2.0
7;189;1130;1133;3;1;2.0
7;190;1133;1148;15;1;2.0
7;191;1148;1155;7;1;2.0
7;192;1155;1157;2;1;2.0
7;193;1157;1173;16;1;2.0
7;194;1173;1176;3;1;2.0
7;195;1176;1178;2;1;2.0
7;196;1178;1188;10;1;2.0
7;197;1188;1195;7;1;2.0
7;198;1195;1208;13;1;2.0
7;199;1208;1213;5;1;2.0
7;200;1213;1215;2;1;2.0
7;201;1215;1226;11;1;2.0
7;202;1226;1238;12;1;2.0
7;203;1238;1255;17;1;2.0
7;204;1255;1263;8;1;2.0
7;205;1263;1268;5;1;2.0
7;206;1268;1271;3;1;2.0
7;207;1271;1275;4;1;2.0
7;208;1275;1286;11;1;2.0
7;209;1286;1298;12;1;2.0
7;210;1298;1303;5;1;2.0
7;211;1303;1315;12;1;2.0
7;212;1315;1322;7;1;2.0
7;213;1322;1325;3;1;2.0
7;214;1325;1339;14;1;2.0
7;215;1339;1347;8;1;2.0
7;216;1347;1364;17;1;2.0
7;217;1364;1367;3;1;2.0
7;218;1367;1368;1;1;2.0
7;219;1368;1373;5;1;2.0
7;220;1373;1387;14;1;2.0
7;221;1387;1389;2;1;2.0
7;222;1389;1391;2;1;2.0
7;223;1391;1406;15;1;2.0
7;224;1406;1421;15;1;2.0
7;225;1421;1436;15;1;2.0
7;226;1436;1451;15;1;2.0
7;227;1451;1466;15;1;2.0
7;228;1466;1481;15;1;2.0
7;229;1481;1496;15;1;2.0
7;230;1496;1511;15;1;2.0
7;231;1511;1526;15;1;2.0
7;232;1526;1541;15;1;2.0
7;233;1541;1556;15;1;2.0
7;234;1556;1571;15;1;2.0
7;235;1571;1586;15;1;2.0
7;236;1586;1601;15;1;2.0
7;237;1601;1616;15;1;2.0
7;238;1616;1631;15;1;2.0
7;239;1631;1646;15;1;2.0
7;240;1646;1661;15;1;2.0
7;241;1661;1680;19;1;2.0
8;0;250;327;77;43;2.0
8;1;327;334;7;43;2.0
8;2;334;337;3;43;2.0
8;3;337;338;1;43;2.0
8;4;338;339;1;43;2.0
8;5;339;342;3;43;2.0
8;6;342;345;3;43;2.0
8;7;345;352;7;43;2.0
8;8;352;353;1;43;2.0
8;9;353;354;1;43;2.0
8;10;354;356;2;43;2.0
8;11;356;359;3;43;2.0
8;12;359;365;6;43;2.0
8;13;365;366;1;43;2.0
8;14;366;367;1;43;2.0
8;15;367;368;1;43;2.0
8;16;368;374;6;43;2.0
8;17;374;375;1;43;2.0
8;18;375;385;10;43;2.0
8;19;385;387;2;43;2.0
8;20;387;394;7;43;2.0
8;21;394;396;2;43;2.0
8;22;396;398;2;43;2.0
8;23;398;402;4;43;2.0
8;24;402;404;2;43;2.0
8;25;404;409;5;43;2.0
8;26;409;411;2;43;2.0
8;27;411;412;1;43;2.0
8;28;412;413;1;43;2.0
8;29;413;422;9;43;2.0
8;30;422;425;3;43;2.0
8;31;425;426;1;43;2.0
8;32;426;428;2;43;2.0
8;33;428;429;1;43;2.0
8;34;429;435;6;43;2.0
8;35;435;436;1;43;2.0
8;36;436;443;7;43;2.0
8;37;443;444;1;43;2.0
8;38;444;450;6;43;2.0
8;39;450;454;4;43;2.0
8;40;454;455;1;43;2.0
8;41;455;457;2;43;2.0
8;42;457;458;1;43;2.0
8;43;458;459;1;43;2.0
8;44;459;464;5;43;2.0
8;45;464;465;1;43;2.0
8;46;465;467;2;43;2.0
8;47;467;472;5;43;2.0
8;48;472;473;1;43;2.0
8;49;473;474;1;43;2.0
8;50;474;476;2;43;2.0
8;51;476;477;1;43;2.0
8;52;477;486;9;43;2.0
8;53;486;488;2;43;2.0
8;54;488;491;3;43;2.0
8;55;491;498;7;43;2.0
8;56;498;499;1;43;2.0
8;57;499;503;4;43;2.0
8;58;503;505;2;43;2.0
8;59;505;507;2;43;2.0
8;60;507;508;1;43;2.0
8;61;508;517;9;43;2.0
8;62;517;526;9;43;2.0
8;63;526;529;3;43;2.0
8;64;529;530;1;43;2.0
8;65;530;537;7;43;2.0
8;66;537;541;4;43;2.0
8;67;541;547;6;43;2.0
8;68;547;550;3;43;2.0
8;69;550;553;3;43;2.0
8;70;553;555;2;43;2.0
8;71;555;582;27;43;2.0
8;72;582;584;2;43;2.0
8;73;584;585;1;43;2.0
8;74;585;596;11;43;2.0
8;75;596;597;1;43;2.0
8;76;597;598;1;43;2.0
8;77;598;625;27;43;2.0
8;78;625;627;2;43;2.0
8;79;627;631;4;43;2.0
8;80;631;634;3;43;2.0
8;81;634;635;1;43;2.0
8;82;635;655;20;43;2.0
8;83;655;662;7;43;2.0
8;84;662;666;4;43;2.0
8;85;666;667;1;43;2.0
8;86;667;678;11;43;2.0
8;87;678;695;17;43;2.0
8;88;695;701;6;43;2.0
8;89;701;704;3;43;2.0
8;90;704;712;8;43;2.0
8;91;712;722;10;43;2.0
8;92;722;725;3;43;2.0
8;93;725;728;3;43;2.0
8;94;728;736;8;43;2.0
8;95;736;752;16;43;2.0
8;96;752;753;1;43;2.0
8;97;753;757;4;43;2.0
8;98;757;764;7;43;2.0
8;99;764;773;9;43;2.0
8;100;773;775;2;43;2.0
8;101;775;776;1;43;2.0
8;102;776;782;6;43;2.0
8;103;782;788;6;43;2.0
8;104;788;796;8;43;2.0
8;105;796;799;3;43;2.0
8;106;799;803;4;43;2.0
8;107;803;805;2;43;2.0
8;108;805;813;8;43;2.0
8;109;813;818;5;43;2.0
8;110;818;823;5;43;2.0
8;111;823;824;1;43;2.0
8;112;824;826;2;43;2.0
8;113;826;827;1;43;2.0
8;114;827;831;4;43;2.0
8;115;831;832;1;43;2.0
8;116;832;837;5;43;2.0
8;117;837;846;9;43;2.0
8;118;846;849;3;43;2.0
8;119;849;855;6;43;2.0
8;120;855;856;1;43;2.0
8;121;856;868;12;43;2.0
8;122;868;869;1;43;2.0
8;123;869;871;2;43;2.0
8;124;871;877;6;43;2.0
8;125;877;878;1;43;2.0
8;126;878;881;3;43;2.0
8;127;881;884;3;43;2.0
8;128;884;885;1;43;2.0
8;129;885;890;5;43;2.0
8;130;890;892;2;43;2.0
8;131;892;895;3;43;2.0
8;132;895;896;1;43;2.0
8;133;896;901;5;43;2.0
8;134;901;904;3;43;2.0
8;135;904;907;3;43;2.0
8;136;907;911;4;43;2.0
8;137;911;912;1;43;2.0
8;138;912;919;7;43;2.0
8;139;919;925;6;43;2.0
8;140;925;926;1;43;2.0
8;141;926;930;4;43;2.0
8;142;930;937;7;43;2.0
8;143;937;940;3;43;2.0
8;144;940;941;1;43;2.0
8;145;941;942;1;43;2.0
8;146;942;944;2;43;2.0
8;147;944;945;1;43;2.0
8;148;945;946;1;43;2.0
8;149;946;955;9;43;2.0
8;150;955;959;4;43;2.0
8;151;959;961;2;43;2.0
8;152;961;962;1;43;2.0
8;153;962;966;4;43;2.0
8;154;966;970;4;43;2.0
8;155;970;975;5;43;2.0
8;156;975;979;4;43;2.0
8;157;979;982;3;43;2.0
8;158;982;985;3;43;2.0
8;159;985;986;1;43;2.0
8;160;986;997;11;43;2.0
8;161;997;999;2;43;2.0
8;162;999;1000;1;43;2.0
8;163;1000;1006;6;43;2.0
8;164;1006;1010;4;43;2.0
8;165;1010;1018;8;43;2.0
8;166;1018;1020;2;43;2.0
8;167;1020;1023;3;43;2.0
8;168;1023;1026;3;43;2.0
8;169;1026;1027;1;43;2.0
8;170;1027;1029;2;43;2.0
8;171;1029;1040;11;43;2.0
8;172;1040;1044;4;43;2.0
8;173;1044;1047;3;43;2.0
8;174;1047;1049;2;43;2.0
8;175;1049;1050;1;43;2.0
8;176;1050;1065;15;43;2.0
8;177;1065;1066;1;43;2.0
8;178;1066;1069;3;43;2.0
8;179;1069;1079;10;43;2.0
8;180;1079;1081;2;43;2.0
8;181;1081;1082;1;43;2.0
8;182;1082;1086;4;43;2.0
8;183;1086;1087;1;43;2.0
8;184;1087;1089;2;43;2.0
8;185;1089;1090;1;43;2.0
8;186;1090;1094;4;43;2.0
8;187;1094;1102;8;43;2.0
8;188;1102;1105;3;43;2.0
8;189;1105;1108;3;43;2.0
8;190;1108;1116;8;43;2.0
8;191;1116;1121;5;43;2.0
8;192;1121;1135;14;43;2.0
8;193;1135;1142;7;43;2.0
8;194;1142;1144;2;43;2.0
8;195;1144;1148;4;43;2.0
8;196;1148;1156;8;43;2.0
8;197;1156;1165;9;43;2.0
8;198;1165;1175;10;43;2.0
8;199;1175;1181;6;43;2.0
8;200;1181;1182;1;43;2.0
8;201;1182;1206;24;43;2.0
8;202;1206;1208;2;43;2.0
8;203;1208;1210;2;43;2.0
8;204;1210;1217;7;43;2.0
8;205;1217;1225;8;43;2.0
8;206;1225;1256;31;43;2.0
8;207;1256;1268;12;43;2.0
8;208;1268;1269;1;43;2.0
8;209;1269;1277;8;43;2.0
8;210;1277;1285;8;43;2.0
8;211;1285;1296;11;43;2.0
8;212;1296;1318;22;43;2.0
8;213;1318;1329;11;43;2.0
8;214;1329;1331;2;43;2.0
8;215;1331;1340;9;43;2.0
8;216;1340;1343;3;43;2.0
8;217;1343;1351;8;43;2.0
8;218;1351;1360;9;43;2.0
8;219;1360;1367;7;43;2.0
8;220;1367;1370;3;43;2.0
8;221;1370;1382;12;43;2.0
8;222;1382;1384;2;43;2.0
8;223;1384;1390;6;43;2.0
8;224;1390;1405;15;43;2.0
8;225;1405;1420;15;43;2.0
8;226;1420;1435;15;43;2.0
8;227;1435;1450;15;43;2.0
8;228;1450;1465;15;43;2.0
8;229;1465;1480;15;43;2.0
8;230;1480;1495;15;43;2.0
8;231;1495;1510;15;43;2.0
8;232;1510;1525;15;43;2.0
8;233;1525;1540;15;43;2.0
8;234;1540;1555;15;43;2.0
8;235;1555;1570;15;43;2.0
8;236;1570;1585;15;43;2.0
8;237;1585;1600;15;43;2.0
8;238;1600;1615;15;43;2.0
8;239;1615;1630;15;43;2.0
8;240;1630;1645;15;43;2.0
8;241;1645;1660;15;43;2.0
8;242;1660;1680;20;43;2.0
9;0;250;326;76;4;2.0
9;1;326;331;5;4;2.0
9;2;331;333;2;4;2.0
9;3;333;339;6;4;2.0
9;4;339;340;1;4;2.0
9;5;340;341;1;4;2.0
9;6;341;344;3;4;2.0
9;7;344;346;2;4;2.0
9;8;346;347;1;4;2.0
9;9;347;351;4;4;2.0
9;10;351;356;5;4;2.0
9;11;356;357;1;4;2.0
9;12;357;361;4;4;2.0
9;13;361;364;3;4;2.0
9;14;364;366;2;4;2.0
9;15;366;371;5;4;2.0
9;16;371;379;8;4;2.0
9;17;379;381;2;4;2.0
9;18;381;386;5;4;2.0
9;19;386;387;1;4;2.0
9;20;387;391;4;4;2.0
9;21;391;396;5;4;2.0
9;22;396;397;1;4;2.0
9;23;397;399;2;4;2.0
9;24;399;401;2;4;2.0
9;25;401;402;1;4;2.0
9;26;402;410;8;4;2.0
9;27;410;414;4;4;2.0
9;28;414;416;2;4;2.0
9;29;416;417;1;4;2.0
9;30;417;422;5;4;2.0
9;31;422;424;2;4;2.0
9;32;424;427;3;4;2.0
9;33;427;431;4;4;2.0
9;34;431;434;3;4;2.0
9;35;434;441;7;4;2.0
9;36;441;446;5;4;2.0
9;37;446;449;3;4;2.0
9;38;449;451;2;4;2.0
9;39;451;456;5;4;2.0
9;40;456;457;1;4;2.0
9;41;457;459;2;4;2.0
9;42;459;461;2;4;2.0
9;43;461;467;6;4;2.0
9;44;467;469;2;4;2.0
9;45;469;471;2;4;2.0
9;46;471;473;2;4;2.0
9;47;473;476;3;4;2.0
9;48;476;477;1;4;2.0
9;49;477;482;5;4;2.0
9;50;482;486;4;4;2.0
9;51;486;491;5;4;2.0
9;52;491;498;7;4;2.0
9;53;498;504;6;4;2.0
9;54;504;508;4;4;2.0
9;55;508;511;3;4;2.0
9;56;511;517;6;4;2.0
9;57;517;519;2;4;2.0
9;58;519;531;12;4;2.0
9;59;531;534;3;4;2.0
9;60;534;541;7;4;2.0
9;61;541;543;2;4;2.0
9;62;543;547;4;4;2.0
9;63;547;553;6;4;2.0
9;64;553;556;3;4;2.0
9;65;556;559;3;4;2.0
9;66;559;586;27;4;2.0
9;67;586;587;1;4;2.0
9;68;587;589;2;4;2.0
9;69;589;591;2;4;2.0
9;70;591;594;3;4;2.0
9;71;594;597;3;4;2.0
9;72;597;622;25;4;2.0
9;73;622;623;1;4;2.0
9;74;623;631;8;4;2.0
9;75;631;639;8;4;2.0
9;76;639;656;17;4;2.0
9;77;656;657;1;4;2.0
9;78;657;661;4;4;2.0
9;79;661;666;5;4;2.0
9;80;666;679;13;4;2.0
9;81;679;692;13;4;2.0
9;82;692;701;9;4;2.0
9;83;701;709;8;4;2.0
9;84;709;716;7;4;2.0
9;85;716;722;6;4;2.0
9;86;722;724;2;4;2.0
9;87;724;727;3;4;2.0
9;88;727;731;4;4;2.0
9;89;731;746;15;4;2.0
9;90;746;754;8;4;2.0
9;91;754;761;7;4;2.0
9;92;761;767;6;4;2.0
9;93;767;769;2;4;2.0
9;94;769;781;12;4;2.0
9;95;781;782;1;4;2.0
9;96;782;787;5;4;2.0
9;97;787;788;1;4;2.0
9;98;788;801;13;4;2.0
9;99;801;804;3;4;2.0
9;100;804;811;7;4;2.0
9;101;811;817;6;4;2.0
9;102;817;818;1;4;2.0
9;103;818;821;3;4;2.0
9;104;821;824;3;4;2.0
9;105;824;829;5;4;2.0
9;106;829;837;8;4;2.0
9;107;837;838;1;4;2.0
9;108;838;843;5;4;2.0
9;109;843;847;4;4;2.0
9;110;847;854;7;4;2.0
9;111;854;856;2;4;2.0
9;112;856;858;2;4;2.0
9;113;858;861;3;4;2.0
9;114;861;862;1;4;2.0
9;115;862;866;4;4;2.0
9;116;866;871;5;4;2.0
9;117;871;874;3;4;2.0
9;118;874;875;1;4;2.0
9;119;875;878;3;4;2.0
9;120;878;887;9;4;2.0
9;121;887;889;2;4;2.0
9;122;889;891;2;4;2.0
9;123;891;892;1;4;2.0
9;124;892;893;1;4;2.0
9;125;893;901;8;4;2.0
9;126;901;902;1;4;2.0
9;127;902;907;5;4;2.0
9;128;907;909;2;4;2.0
9;129;909;913;4;4;2.0
9;130;913;917;4;4;2.0
9;131;917;918;1;4;2.0
9;132;918;924;6;4;2.0
9;133;924;931;7;4;2.0
9;134;931;933;2;4;2.0
9;135;933;937;4;4;2.0
9;136;937;942;5;4;2.0
9;137;942;946;4;4;2.0
9;138;946;949;3;4;2.0
9;139;949;953;4;4;2.0
9;140;953;957;4;4;2.0
9;141;957;961;4;4;2.0
9;142;961;962;1;4;2.0
9;143;962;964;2;4;2.0
9;144;964;970;6;4;2.0
9;145;970;973;3;4;2.0
9;146;973;977;4;4;2.0
9;147;977;981;4;4;2.0
9;148;981;982;1;4;2.0
9;149;982;984;2;4;2.0
9;150;984;985;1;4;2.0
9;151;985;997;12;4;2.0
9;152;997;998;1;4;2.0
9;153;998;1004;6;4;2.0
9;154;1004;1006;2;4;2.0
9;155;1006;1017;11;4;2.0
9;156;1017;1018;1;4;2.0
9;157;1018;1021;3;4;2.0
9;158;1021;1028;7;4;2.0
9;159;1028;1029;1;4;2.0
9;160;1029;1034;5;4;2.0
9;161;1034;1038;4;4;2.0
9;162;1038;1047;9;4;2.0
9;163;1047;1050;3;4;2.0
9;164;1050;1051;1;4;2.0
9;165;1051;1053;2;4;2.0
9;166;1053;1054;1;4;2.0
9;167;1054;1057;3;4;2.0
9;168;1057;1061;4;4;2.0
9;169;1061;1074;13;4;2.0
9;170;1074;1076;2;4;2.0
9;171;1076;1077;1;4;2.0
9;172;1077;1078;1;4;2.0
9;173;1078;1082;4;4;2.0
9;174;1082;1087;5;4;2.0
9;175;1087;1091;4;4;2.0
9;176;1091;1094;3;4;2.0
9;177;1094;1100;6;4;2.0
9;178;1100;1102;2;4;2.0
9;179;1102;1104;2;4;2.0
9;180;1104;1105;1;4;2.0
9;181;1105;1109;4;4;2.0
9;182;1109;1117;8;4;2.0
9;183;1117;1127;10;4;2.0
9;184;1127;1132;5;4;2.0
9;185;1132;1133;1;4;2.0
9;186;1133;1147;14;4;2.0
9;187;1147;1153;6;4;2.0
9;188;1153;1156;3;4;2.0
9;189;1156;1173;17;4;2.0
9;190;1173;1175;2;4;2.0
9;191;1175;1177;2;4;2.0
9;192;1177;1187;10;4;2.0
9;193;1187;1194;7;4;2.0
9;194;1194;1208;14;4;2.0
9;195;1208;1211;3;4;2.0
9;196;1211;1213;2;4;2.0
9;197;1213;1225;12;4;2.0
9;198;1225;1237;12;4;2.0
9;199;1237;1257;20;4;2.0
9;200;1257;1262;5;4;2.0
9;201;1262;1268;6;4;2.0
9;202;1268;1269;1;4;2.0
9;203;1269;1273;4;4;2.0
9;204;1273;1285;12;4;2.0
9;205;1285;1297;12;4;2.0
9;206;1297;1302;5;4;2.0
9;207;1302;1317;15;4;2.0
9;208;1317;1322;5;4;2.0
9;209;1322;1323;1;4;2.0
9;210;1323;1337;14;4;2.0
9;211;1337;1346;9;4;2.0
9;212;1346;1363;17;4;2.0
9;213;1363;1366;3;4;2.0
9;214;1366;1367;1;4;2.0
9;215;1367;1371;4;4;2.0
9;216;1371;1373;2;4;2.0
9;217;1373;1385;12;4;2.0
9;218;1385;1387;2;4;2.0
9;219;1387;1390;3;4;2.0
9;220;1390;1405;15;4;2.0
9;221;1405;1420;15;4;2.0
9;222;1420;1435;15;4;2.0
9;223;1435;1450;15;4;2.0
9;224;1450;1465;15;4;2.0
9;225;1465;1480;15;4;2.0
9;226;1480;1495;15;4;2.0
9;227;1495;1510;15;4;2.0
9;228;1510;1525;15;4;2.0
9;229;1525;1540;15;4;2.0
9;230;1540;1555;15;4;2.0
9;231;1555;1570;15;4;2.0
9;232;1570;1585;15;4;2.0
9;233;1585;1600;15;4;2.0
9;234;1600;1615;15;4;2.0
9;235;1615;1630;15;4;2.0
9;236;1630;1645;15;4;2.0
9;237;1645;1660;15;4;2.0
9;238;1660;1680;20;4;2.0
10;0;252;326;74;11;2.0
10;1;326;335;9;11;2.0
10;2;335;337;2;11;2.0
10;3;337;338;1;11;2.0
10;4;338;339;1;11;2.0
10;5;339;343;4;11;2.0
10;6;343;347;4;11;2.0
10;7;347;352;5;11;2.0
10;8;352;354;2;11;2.0
10;9;354;357;3;11;2.0
10;10;357;358;1;11;2.0
10;11;358;362;4;11;2.0
10;12;362;367;5;11;2.0
10;13;367;369;2;11;2.0
10;14;369;373;4;11;2.0
10;15;373;376;3;11;2.0
10;16;376;377;1;11;2.0
10;17;377;387;10;11;2.0
10;18;387;388;1;11;2.0
10;19;388;393;5;11;2.0
10;20;393;396;3;11;2.0
10;21;396;397;1;11;2.0
10;22;397;399;2;11;2.0
10;23;399;402;3;11;2.0
10;24;402;408;6;11;2.0
10;25;408;410;2;11;2.0
10;26;410;412;2;11;2.0
10;27;412;414;2;11;2.0
10;28;414;417;3;11;2.0
10;29;417;420;3;11;2.0
10;30;420;422;2;11;2.0
10;31;422;423;1;11;2.0
10;32;423;427;4;11;2.0
10;33;427;428;1;11;2.0
10;34;428;429;1;11;2.0
10;35;429;437;8;11;2.0
10;36;437;442;5;11;2.0
10;37;442;443;1;11;2.0
10;38;443;444;1;11;2.0
10;39;444;452;8;11;2.0
10;40;452;453;1;11;2.0
10;41;453;456;3;11;2.0
10;42;456;457;1;11;2.0
10;43;457;458;1;11;2.0
10;44;458;459;1;11;2.0
10;45;459;463;4;11;2.0
10;46;463;467;4;11;2.0
10;47;467;468;1;11;2.0
10;48;468;473;5;11;2.0
10;49;473;474;1;11;2.0
10;50;474;477;3;11;2.0
10;51;477;478;1;11;2.0
10;52;478;482;4;11;2.0
10;53;482;487;5;11;2.0
10;54;487;489;2;11;2.0
10;55;489;492;3;11;2.0
10;56;492;497;5;11;2.0
10;57;497;498;1;11;2.0
10;58;498;499;1;11;2.0
10;59;499;504;5;11;2.0
10;60;504;509;5;11;2.0
10;61;509;515;6;11;2.0
10;62;515;518;3;11;2.0
10;63;518;527;9;11;2.0
10;64;527;528;1;11;2.0
10;65;528;531;3;11;2.0
10;66;531;537;6;11;2.0
10;67;537;542;5;11;2.0
10;68;542;548;6;11;2.0
10;69;548;554;6;11;2.0
10;70;554;555;1;11;2.0
10;71;555;577;22;11;2.0
10;72;577;583;6;11;2.0
10;73;583;590;7;11;2.0
10;74;590;597;7;11;2.0
10;75;597;598;1;11;2.0
10;76;598;599;1;11;2.0
10;77;599;617;18;11;2.0
10;78;617;632;15;11;2.0
10;79;632;633;1;11;2.0
10;80;633;635;2;11;2.0
10;81;635;647;12;11;2.0
10;82;647;662;15;11;2.0
10;83;662;667;5;11;2.0
10;84;667;675;8;11;2.0
10;85;675;679;4;11;2.0
10;86;679;687;8;11;2.0
10;87;687;702;15;11;2.0
10;88;702;703;1;11;2.0
10;89;703;717;14;11;2.0
10;90;717;720;3;11;2.0
10;91;720;723;3;11;2.0
10;92;723;729;6;11;2.0
10;93;729;737;8;11;2.0
10;94;737;752;15;11;2.0
10;95;752;754;2;11;2.0
10;96;754;763;9;11;2.0
10;97;763;765;2;11;2.0
10;98;765;767;2;11;2.0
10;99;767;774;7;11;2.0
10;100;774;777;3;11;2.0
10;101;777;783;6;11;2.0
10;102;783;789;6;11;2.0
10;103;789;797;8;11;2.0
10;104;797;798;1;11;2.0
10;105;798;804;6;11;2.0
10;106;804;807;3;11;2.0
10;107;807;814;7;11;2.0
10;108;814;819;5;11;2.0
10;109;819;823;4;11;2.0
10;110;823;824;1;11;2.0
10;111;824;827;3;11;2.0
10;112;827;838;11;11;2.0
10;113;838;839;1;11;2.0
10;114;839;847;8;11;2.0
10;115;847;848;1;11;2.0
10;116;848;854;6;11;2.0
10;117;854;857;3;11;2.0
10;118;857;868;11;11;2.0
10;119;868;869;1;11;2.0
10;120;869;870;1;11;2.0
10;121;870;872;2;11;2.0
10;122;872;877;5;11;2.0
10;123;877;879;2;11;2.0
10;124;879;883;4;11;2.0
10;125;883;887;4;11;2.0
10;126;887;889;2;11;2.0
10;127;889;891;2;11;2.0
10;128;891;893;2;11;2.0
10;129;893;897;4;11;2.0
10;130;897;903;6;11;2.0
10;131;903;904;1;11;2.0
10;132;904;908;4;11;2.0
10;133;908;909;1;11;2.0
10;134;909;912;3;11;2.0
10;135;912;917;5;11;2.0
10;136;917;918;1;11;2.0
10;137;918;926;8;11;2.0
10;138;926;927;1;11;2.0
10;139;927;931;4;11;2.0
10;140;931;932;1;11;2.0
10;141;932;937;5;11;2.0
10;142;937;943;6;11;2.0
10;143;943;946;3;11;2.0
10;144;946;947;1;11;2.0
10;145;947;949;2;11;2.0
10;146;949;958;9;11;2.0
10;147;958;963;5;11;2.0
10;148;963;967;4;11;2.0
10;149;967;969;2;11;2.0
10;150;969;971;2;11;2.0
10;151;971;978;7;11;2.0
10;152;978;983;5;11;2.0
10;153;983;986;3;11;2.0
10;154;986;987;1;11;2.0
10;155;987;992;5;11;2.0
10;156;992;998;6;11;2.0
10;157;998;1007;9;11;2.0
10;158;1007;1011;4;11;2.0
10;159;1011;1015;4;11;2.0
10;160;1015;1019;4;11;2.0
10;161;1019;1021;2;11;2.0
10;162;1021;1027;6;11;2.0
10;163;1027;1028;1;11;2.0
10;164;1028;1034;6;11;2.0
10;165;1034;1036;2;11;2.0
10;166;1036;1041;5;11;2.0
10;167;1041;1048;7;11;2.0
10;168;1048;1051;3;11;2.0
10;169;1051;1057;6;11;2.0
10;170;1057;1066;9;11;2.0
10;171;1066;1067;1;11;2.0
10;172;1067;1068;1;11;2.0
10;173;1068;1082;14;11;2.0
10;174;1082;1086;4;11;2.0
10;175;1086;1087;1;11;2.0
10;176;1087;1088;1;11;2.0
10;177;1088;1091;3;11;2.0
10;178;1091;1103;12;11;2.0
10;179;1103;1106;3;11;2.0
10;180;1106;1109;3;11;2.0
10;181;1109;1113;4;11;2.0
10;182;1113;1116;3;11;2.0
10;183;1116;1143;27;11;2.0
10;184;1143;1145;2;11;2.0
10;185;1145;1147;2;11;2.0
10;186;1147;1157;10;11;2.0
10;187;1157;1173;16;11;2.0
10;188;1173;1176;3;11;2.0
10;189;1176;1183;7;11;2.0
10;190;1183;1206;23;11;2.0
10;191;1206;1207;1;11;2.0
10;192;1207;1211;4;11;2.0
10;193;1211;1218;7;11;2.0
10;194;1218;1226;8;11;2.0
10;195;1226;1233;7;11;2.0
10;196;1233;1248;15;11;2.0
10;197;1248;1267;19;11;2.0
10;198;1267;1269;2;11;2.0
10;199;1269;1270;1;11;2.0
10;200;1270;1278;8;11;2.0
10;201;1278;1286;8;11;2.0
10;202;1286;1288;2;11;2.0
10;203;1288;1293;5;11;2.0
10;204;1293;1317;24;11;2.0
10;205;1317;1330;13;11;2.0
10;206;1330;1332;2;11;2.0
10;207;1332;1341;9;11;2.0
10;208;1341;1343;2;11;2.0
10;209;1343;1352;9;11;2.0
10;210;1352;1359;7;11;2.0
10;211;1359;1368;9;11;2.0
10;212;1368;1371;3;11;2.0
10;213;1371;1381;10;11;2.0
10;214;1381;1383;2;11;2.0
10;215;1383;1385;2;11;2.0
10;216;1385;1391;6;11;2.0
10;217;1391;1406;15;11;2.0
10;218;1406;1421;15;11;2.0
10;219;1421;1436;15;11;2.0
10;220;1436;1451;15;11;2.0
10;221;1451;1466;15;11;2.0
10;222;1466;1481;15;11;2.0
10;223;1481;1496;15;11;2.0
10;224;1496;1511;15;11;2.0
10;225;1511;1526;15;11;2.0
10;226;1526;1541;15;11;2.0
10;227;1541;1556;15;11;2.0
10;228;1556;1571;15;11;2.0
10;229;1571;1586;15;11;2.0
10;230;1586;1601;15;11;2.0
10;231;1601;1616;15;11;2.0
10;232;1616;1631;15;11;2.0
10;233;1631;1646;15;11;2.0
10;234;1646;1661;15;11;2.0
10;235;1661;1680;19;11;2.0
11;0;250;340;90;87;2.0
11;1;340;343;3;87;2.0
11;2;343;345;2;87;2.0
11;3;345;346;1;87;2.0
11;4;346;354;8;87;2.0
11;5;354;355;1;87;2.0
11;6;355;357;2;87;2.0
11;7;357;358;1;87;2.0
11;8;358;364;6;87;2.0
11;9;364;366;2;87;2.0
11;10;366;370;4;87;2.0
11;11;370;372;2;87;2.0
11;12;372;373;1;87;2.0
11;13;373;377;4;87;2.0
11;14;377;381;4;87;2.0
11;15;381;393;12;87;2.0
11;16;393;394;1;87;2.0
11;17;394;397;3;87;2.0
11;18;397;400;3;87;2.0
11;19;400;401;1;87;2.0
11;20;401;403;2;87;2.0
11;21;403;408;5;87;2.0
11;22;408;409;1;87;2.0
11;23;409;415;6;87;2.0
11;24;415;416;1;87;2.0
11;25;416;420;4;87;2.0
11;26;420;424;4;87;2.0
11;27;424;428;4;87;2.0
11;28;428;429;1;87;2.0
11;29;429;430;1;87;2.0
11;30;430;434;4;87;2.0
11;31;434;436;2;87;2.0
11;32;436;437;1;87;2.0
11;33;437;445;8;87;2.0
11;34;445;447;2;87;2.0
11;35;447;451;4;87;2.0
11;36;451;453;2;87;2.0
11;37;453;460;7;87;2.0
11;38;460;461;1;87;2.0
11;39;461;462;1;87;2.0
11;40;462;463;1;87;2.0
11;41;463;464;1;87;2.0
11;42;464;471;7;87;2.0
11;43;471;474;3;87;2.0
11;44;474;475;1;87;2.0
11;45;475;477;2;87;2.0
11;46;477;484;7;87;2.0
11;47;484;489;5;87;2.0
11;48;489;490;1;87;2.0
11;49;490;492;2;87;2.0
11;50;492;493;1;87;2.0
11;51;493;505;12;87;2.0
11;52;505;506;1;87;2.0
11;53;506;515;9;87;2.0
11;54;515;517;2;87;2.0
11;55;517;524;7;87;2.0
11;56;524;525;1;87;2.0
11;57;525;535;10;87;2.0
11;58;535;536;1;87;2.0
11;59;536;543;7;87;2.0
11;60;543;548;5;87;2.0
11;61;548;554;6;87;2.0
11;62;554;558;4;87;2.0
11;63;558;560;2;87;2.0
11;64;560;562;2;87;2.0
11;65;562;565;3;87;2.0
11;66;565;591;26;87;2.0
11;67;591;594;3;87;2.0
11;68;594;597;3;87;2.0
11;69;597;600;3;87;2.0
11;70;600;604;4;87;2.0
11;71;604;629;25;87;2.0
11;72;629;637;8;87;2.0
11;73;637;638;1;87;2.0
11;74;638;641;3;87;2.0
11;75;641;645;4;87;2.0
11;76;645;664;19;87;2.0
11;77;664;667;3;87;2.0
11;78;667;668;1;87;2.0
11;79;668;680;12;87;2.0
11;80;680;685;5;87;2.0
11;81;685;699;14;87;2.0
11;82;699;707;8;87;2.0
11;83;707;711;4;87;2.0
11;84;711;729;18;87;2.0
11;85;729;730;1;87;2.0
11;86;730;734;4;87;2.0
11;87;734;737;3;87;2.0
11;88;737;758;21;87;2.0
11;89;758;771;13;87;2.0
11;90;771;774;3;87;2.0
11;91;774;775;1;87;2.0
11;92;775;787;12;87;2.0
11;93;787;789;2;87;2.0
11;94;789;794;5;87;2.0
11;95;794;795;1;87;2.0
11;96;795;806;11;87;2.0
11;97;806;808;2;87;2.0
11;98;808;815;7;87;2.0
11;99;815;817;2;87;2.0
11;100;817;824;7;87;2.0
11;101;824;825;1;87;2.0
11;102;825;828;3;87;2.0
11;103;828;831;3;87;2.0
11;104;831;833;2;87;2.0
11;105;833;844;11;87;2.0
11;106;844;849;5;87;2.0
11;107;849;854;5;87;2.0
11;108;854;856;2;87;2.0
11;109;856;864;8;87;2.0
11;110;864;867;3;87;2.0
11;111;867;869;2;87;2.0
11;112;869;870;1;87;2.0
11;113;870;876;6;87;2.0
11;114;876;880;4;87;2.0
11;115;880;881;1;87;2.0
11;116;881;883;2;87;2.0
11;117;883;891;8;87;2.0
11;118;891;892;1;87;2.0
11;119;892;894;2;87;2.0
11;120;894;897;3;87;2.0
11;121;897;899;2;87;2.0
11;122;899;907;8;87;2.0
11;123;907;909;2;87;2.0
11;124;909;911;2;87;2.0
11;125;911;914;3;87;2.0
11;126;914;919;5;87;2.0
11;127;919;924;5;87;2.0
11;128;924;926;2;87;2.0
11;129;926;927;1;87;2.0
11;130;927;935;8;87;2.0
11;131;935;937;2;87;2.0
11;132;937;943;6;87;2.0
11;133;943;944;1;87;2.0
11;134;944;947;3;87;2.0
11;135;947;949;2;87;2.0
11;136;949;951;2;87;2.0
11;137;951;952;1;87;2.0
11;138;952;959;7;87;2.0
11;139;959;964;5;87;2.0
11;140;964;966;2;87;2.0
11;141;966;967;1;87;2.0
11;142;967;969;2;87;2.0
11;143;969;977;8;87;2.0
11;144;977;979;2;87;2.0
11;145;979;984;5;87;2.0
11;146;984;986;2;87;2.0
11;147;986;987;1;87;2.0
11;148;987;989;2;87;2.0
11;149;989;992;3;87;2.0
11;150;992;1004;12;87;2.0
11;151;1004;1006;2;87;2.0
11;152;1006;1012;6;87;2.0
11;153;1012;1024;12;87;2.0
11;154;1024;1025;1;87;2.0
11;155;1025;1033;8;87;2.0
11;156;1033;1035;2;87;2.0
11;157;1035;1036;1;87;2.0
11;158;1036;1042;6;87;2.0
11;159;1042;1044;2;87;2.0
11;160;1044;1054;10;87;2.0
11;161;1054;1055;1;87;2.0
11;162;1055;1056;1;87;2.0
11;163;1056;1064;8;87;2.0
11;164;1064;1067;3;87;2.0
11;165;1067;1076;9;87;2.0
11;166;1076;1084;8;87;2.0
11;167;1084;1086;2;87;2.0
11;168;1086;1088;2;87;2.0
11;169;1088;1092;4;87;2.0
11;170;1092;1094;2;87;2.0
11;171;1094;1096;2;87;2.0
11;172;1096;1097;1;87;2.0
11;173;1097;1106;9;87;2.0
11;174;1106;1109;3;87;2.0
11;175;1109;1112;3;87;2.0
11;176;1112;1113;1;87;2.0
11;177;1113;1119;6;87;2.0
11;178;1119;1123;4;87;2.0
11;179;1123;1133;10;87;2.0
11;180;1133;1140;7;87;2.0
11;181;1140;1146;6;87;2.0
11;182;1146;1153;7;87;2.0
11;183;1153;1155;2;87;2.0
11;184;1155;1163;8;87;2.0
11;185;1163;1180;17;87;2.0
11;186;1180;1182;2;87;2.0
11;187;1182;1183;1;87;2.0
11;188;1183;1193;10;87;2.0
11;189;1193;1209;16;87;2.0
11;190;1209;1215;6;87;2.0
11;191;1215;1232;17;87;2.0
11;192;1232;1243;11;87;2.0
11;193;1243;1268;25;87;2.0
11;194;1268;1271;3;87;2.0
11;195;1271;1273;2;87;2.0
11;196;1273;1275;2;87;2.0
11;197;1275;1292;17;87;2.0
11;198;1292;1303;11;87;2.0
11;199;1303;1308;5;87;2.0
11;200;1308;1325;17;87;2.0
11;201;1325;1329;4;87;2.0
11;202;1329;1331;2;87;2.0
11;203;1331;1349;18;87;2.0
11;204;1349;1352;3;87;2.0
11;205;1352;1369;17;87;2.0
11;206;1369;1372;3;87;2.0
11;207;1372;1374;2;87;2.0
11;208;1374;1375;1;87;2.0
11;209;1375;1380;5;87;2.0
11;210;1380;1389;9;87;2.0
11;211;1389;1397;8;87;2.0
11;212;1397;1412;15;87;2.0
11;213;1412;1427;15;87;2.0
11;214;1427;1442;15;87;2.0
11;215;1442;1457;15;87;2.0
11;216;1457;1472;15;87;2.0
11;217;1472;1487;15;87;2.0
11;218;1487;1502;15;87;2.0
11;219;1502;1517;15;87;2.0
11;220;1517;1532;15;87;2.0
11;221;1532;1547;15;87;2.0
11;222;1547;1562;15;87;2.0
11;223;1562;1577;15;87;2.0
11;224;1577;1592;15;87;2.0
11;225;1592;1607;15;87;2.0
11;226;1607;1622;15;87;2.0
11;227;1622;1637;15;87;2.0
11;228;1637;1652;15;87;2.0
11;229;1652;1667;15;87;2.0
11;230;1667;1680;13;87;2.0
12;0;246;335;89;72;2.0
12;1;335;336;1;72;2.0
12;2;336;341;5;72;2.0
12;3;341;342;1;72;2.0
12;4;342;350;8;72;2.0
12;5;350;351;1;72;2.0
12;6;351;353;2;72;2.0
12;7;353;360;7;72;2.0
12;8;360;362;2;72;2.0
12;9;362;365;3;72;2.0
12;10;365;366;1;72;2.0
12;11;366;368;2;72;2.0
12;12;368;369;1;72;2.0
12;13;369;373;4;72;2.0
12;14;373;377;4;72;2.0
12;15;377;386;9;72;2.0
12;16;386;390;4;72;2.0
12;17;390;393;3;72;2.0
12;18;393;395;2;72;2.0
12;19;395;397;2;72;2.0
12;20;397;399;2;72;2.0
12;21;399;401;2;72;2.0
12;22;401;404;3;72;2.0
12;23;404;405;1;72;2.0
12;24;405;410;5;72;2.0
12;25;410;412;2;72;2.0
12;26;412;416;4;72;2.0
12;27;416;420;4;72;2.0
12;28;420;421;1;72;2.0
12;29;421;423;2;72;2.0
12;30;423;425;2;72;2.0
12;31;425;426;1;72;2.0
12;32;426;430;4;72;2.0
12;33;430;432;2;72;2.0
12;34;432;433;1;72;2.0
12;35;433;440;7;72;2.0
12;36;440;443;3;72;2.0
12;37;443;447;4;72;2.0
12;38;447;449;2;72;2.0
12;39;449;455;6;72;2.0
12;40;455;456;1;72;2.0
12;41;456;457;1;72;2.0
12;42;457;458;1;72;2.0
12;43;458;467;9;72;2.0
12;44;467;468;1;72;2.0
12;45;468;470;2;72;2.0
12;46;470;472;2;72;2.0
12;47;472;473;1;72;2.0
12;48;473;478;5;72;2.0
12;49;478;480;2;72;2.0
12;50;480;485;5;72;2.0
12;51;485;487;2;72;2.0
12;52;487;488;1;72;2.0
12;53;488;499;11;72;2.0
12;54;499;500;1;72;2.0
12;55;500;502;2;72;2.0
12;56;502;509;7;72;2.0
12;57;509;513;4;72;2.0
12;58;513;518;5;72;2.0
12;59;518;520;2;72;2.0
12;60;520;521;1;72;2.0
12;61;521;530;9;72;2.0
12;62;530;532;2;72;2.0
12;63;532;536;4;72;2.0
12;64;536;542;6;72;2.0
12;65;542;548;6;72;2.0
12;66;548;552;4;72;2.0
12;67;552;554;2;72;2.0
12;68;554;558;4;72;2.0
12;69;558;561;3;72;2.0
12;70;561;587;26;72;2.0
12;71;587;590;3;72;2.0
12;72;590;593;3;72;2.0
12;73;593;595;2;72;2.0
12;74;595;596;1;72;2.0
12;75;596;598;2;72;2.0
12;76;598;625;27;72;2.0
12;77;625;632;7;72;2.0
12;78;632;633;1;72;2.0
12;79;633;637;4;72;2.0
12;80;637;641;4;72;2.0
12;81;641;660;19;72;2.0
12;82;660;661;1;72;2.0
12;83;661;663;2;72;2.0
12;84;663;675;12;72;2.0
12;85;675;681;6;72;2.0
12;86;681;695;14;72;2.0
12;87;695;703;8;72;2.0
12;88;703;707;4;72;2.0
12;89;707;723;16;72;2.0
12;90;723;725;2;72;2.0
12;91;725;726;1;72;2.0
12;92;726;730;4;72;2.0
12;93;730;733;3;72;2.0
12;94;733;751;18;72;2.0
12;95;751;753;2;72;2.0
12;96;753;767;14;72;2.0
12;97;767;770;3;72;2.0
12;98;770;771;1;72;2.0
12;99;771;783;12;72;2.0
12;100;783;789;6;72;2.0
12;101;789;790;1;72;2.0
12;102;790;802;12;72;2.0
12;103;802;803;1;72;2.0
12;104;803;810;7;72;2.0
12;105;810;813;3;72;2.0
12;106;813;819;6;72;2.0
12;107;819;820;1;72;2.0
12;108;820;823;3;72;2.0
12;109;823;826;3;72;2.0
12;110;826;827;1;72;2.0
12;111;827;838;11;72;2.0
12;112;838;840;2;72;2.0
12;113;840;845;5;72;2.0
12;114;845;850;5;72;2.0
12;115;850;852;2;72;2.0
12;116;852;860;8;72;2.0
12;117;860;863;3;72;2.0
12;118;863;865;2;72;2.0
12;119;865;872;7;72;2.0
12;120;872;875;3;72;2.0
12;121;875;876;1;72;2.0
12;122;876;877;1;72;2.0
12;123;877;887;10;72;2.0
12;124;887;890;3;72;2.0
12;125;890;893;3;72;2.0
12;126;893;895;2;72;2.0
12;127;895;903;8;72;2.0
12;128;903;905;2;72;2.0
12;129;905;907;2;72;2.0
12;130;907;908;1;72;2.0
12;131;908;915;7;72;2.0
12;132;915;920;5;72;2.0
12;133;920;922;2;72;2.0
12;134;922;930;8;72;2.0
12;135;930;933;3;72;2.0
12;136;933;936;3;72;2.0
12;137;936;940;4;72;2.0
12;138;940;942;2;72;2.0
12;139;942;943;1;72;2.0
12;140;943;947;4;72;2.0
12;141;947;948;1;72;2.0
12;142;948;955;7;72;2.0
12;143;955;960;5;72;2.0
12;144;960;962;2;72;2.0
12;145;962;963;1;72;2.0
12;146;963;971;8;72;2.0
12;147;971;975;4;72;2.0
12;148;975;980;5;72;2.0
12;149;980;982;2;72;2.0
12;150;982;983;1;72;2.0
12;151;983;986;3;72;2.0
12;152;986;998;12;72;2.0
12;153;998;1000;2;72;2.0
12;154;1000;1002;2;72;2.0
12;155;1002;1007;5;72;2.0
12;156;1007;1008;1;72;2.0
12;157;1008;1019;11;72;2.0
12;158;1019;1020;1;72;2.0
12;159;1020;1026;6;72;2.0
12;160;1026;1031;5;72;2.0
12;161;1031;1032;1;72;2.0
12;162;1032;1037;5;72;2.0
12;163;1037;1040;3;72;2.0
12;164;1040;1048;8;72;2.0
12;165;1048;1050;2;72;2.0
12;166;1050;1052;2;72;2.0
12;167;1052;1060;8;72;2.0
12;168;1060;1062;2;72;2.0
12;169;1062;1063;1;72;2.0
12;170;1063;1072;9;72;2.0
12;171;1072;1080;8;72;2.0
12;172;1080;1081;1;72;2.0
12;173;1081;1087;6;72;2.0
12;174;1087;1088;1;72;2.0
12;175;1088;1092;4;72;2.0
12;176;1092;1093;1;72;2.0
12;177;1093;1102;9;72;2.0
12;178;1102;1103;1;72;2.0
12;179;1103;1106;3;72;2.0
12;180;1106;1108;2;72;2.0
12;181;1108;1113;5;72;2.0
12;182;1113;1119;6;72;2.0
12;183;1119;1129;10;72;2.0
12;184;1129;1136;7;72;2.0
12;185;1136;1141;5;72;2.0
12;186;1141;1149;8;72;2.0
12;187;1149;1151;2;72;2.0
12;188;1151;1157;6;72;2.0
12;189;1157;1176;19;72;2.0
12;190;1176;1179;3;72;2.0
12;191;1179;1189;10;72;2.0
12;192;1189;1203;14;72;2.0
12;193;1203;1210;7;72;2.0
12;194;1210;1211;1;72;2.0
12;195;1211;1226;15;72;2.0
12;196;1226;1239;13;72;2.0
12;197;1239;1264;25;72;2.0
12;198;1264;1266;2;72;2.0
12;199;1266;1268;2;72;2.0
12;200;1268;1271;3;72;2.0
12;201;1271;1286;15;72;2.0
12;202;1286;1299;13;72;2.0
12;203;1299;1304;5;72;2.0
12;204;1304;1321;17;72;2.0
12;205;1321;1325;4;72;2.0
12;206;1325;1326;1;72;2.0
12;207;1326;1342;16;72;2.0
12;208;1342;1348;6;72;2.0
12;209;1348;1365;17;72;2.0
12;210;1365;1368;3;72;2.0
12;211;1368;1370;2;72;2.0
12;212;1370;1376;6;72;2.0
12;213;1376;1384;8;72;2.0
12;214;1384;1385;1;72;2.0
12;215;1385;1391;6;72;2.0
12;216;1391;1406;15;72;2.0
12;217;1406;1421;15;72;2.0
12;218;1421;1436;15;72;2.0
12;219;1436;1451;15;72;2.0
12;220;1451;1466;15;72;2.0
12;221;1466;1481;15;72;2.0
12;222;1481;1496;15;72;2.0
12;223;1496;1511;15;72;2.0
12;224;1511;1526;15;72;2.0
12;225;1526;1541;15;72;2.0
12;226;1541;1556;15;72;2.0
12;227;1556;1571;15;72;2.0
12;228;1571;1586;15;72;2.0
12;229;1586;1601;15;72;2.0
12;230;1601;1616;15;72;2.0
12;231;1616;1631;15;72;2.0
12;232;1631;1646;15;72;2.0
12;233;1646;1661;15;72;2.0
12;234;1661;1680;19;72;2.0
13;0;249;327;78;58;2.0
13;1;327;331;4;58;2.0
13;2;331;333;2;58;2.0
13;3;333;340;7;58;2.0
13;4;340;341;1;58;2.0
13;5;341;342;1;58;2.0
13;6;342;345;3;58;2.0
13;7;345;348;3;58;2.0
13;8;348;352;4;58;2.0
13;9;352;355;3;58;2.0
13;10;355;357;2;58;2.0
13;11;357;363;6;58;2.0
13;12;363;364;1;58;2.0
13;13;364;365;1;58;2.0
13;14;365;367;2;58;2.0
13;15;367;372;5;58;2.0
13;16;372;380;8;58;2.0
13;17;380;383;3;58;2.0
13;18;383;385;2;58;2.0
13;19;385;387;2;58;2.0
13;20;387;392;5;58;2.0
13;21;392;398;6;58;2.0
13;22;398;400;2;58;2.0
13;23;400;402;2;58;2.0
13;24;402;403;1;58;2.0
13;25;403;411;8;58;2.0
13;26;411;415;4;58;2.0
13;27;415;417;2;58;2.0
13;28;417;418;1;58;2.0
13;29;418;423;5;58;2.0
13;30;423;425;2;58;2.0
13;31;425;432;7;58;2.0
13;32;432;435;3;58;2.0
13;33;435;442;7;58;2.0
13;34;442;444;2;58;2.0
13;35;444;447;3;58;2.0
13;36;447;450;3;58;2.0
13;37;450;453;3;58;2.0
13;38;453;457;4;58;2.0
13;39;457;458;1;58;2.0
13;40;458;460;2;58;2.0
13;41;460;462;2;58;2.0
13;42;462;465;3;58;2.0
13;43;465;468;3;58;2.0
13;44;468;470;2;58;2.0
13;45;470;472;2;58;2.0
13;46;472;474;2;58;2.0
13;47;474;475;1;58;2.0
13;48;475;477;2;58;2.0
13;49;477;478;1;58;2.0
13;50;478;480;2;58;2.0
13;51;480;487;7;58;2.0
13;52;487;492;5;58;2.0
13;53;492;499;7;58;2.0
13;54;499;505;6;58;2.0
13;55;505;509;4;58;2.0
13;56;509;512;3;58;2.0
13;57;512;515;3;58;2.0
13;58;515;518;3;58;2.0
13;59;518;520;2;58;2.0
13;60;520;532;12;58;2.0
13;61;532;533;1;58;2.0
13;62;533;535;2;58;2.0
13;63;535;542;7;58;2.0
13;64;542;545;3;58;2.0
13;65;545;548;3;58;2.0
13;66;548;554;6;58;2.0
13;67;554;557;3;58;2.0
13;68;557;560;3;58;2.0
13;69;560;585;25;58;2.0
13;70;585;587;2;58;2.0
13;71;587;590;3;58;2.0
13;72;590;592;2;58;2.0
13;73;592;595;3;58;2.0
13;74;595;598;3;58;2.0
13;75;598;620;22;58;2.0
13;76;620;625;5;58;2.0
13;77;625;632;7;58;2.0
13;78;632;640;8;58;2.0
13;79;640;655;15;58;2.0
13;80;655;658;3;58;2.0
13;81;658;662;4;58;2.0
13;82;662;667;5;58;2.0
13;83;667;680;13;58;2.0
13;84;680;690;10;58;2.0
13;85;690;702;12;58;2.0
13;86;702;710;8;58;2.0
13;87;710;717;7;58;2.0
13;88;717;723;6;58;2.0
13;89;723;725;2;58;2.0
13;90;725;732;7;58;2.0
13;91;732;748;16;58;2.0
13;92;748;755;7;58;2.0
13;93;755;762;7;58;2.0
13;94;762;765;3;58;2.0
13;95;765;770;5;58;2.0
13;96;770;782;12;58;2.0
13;97;782;783;1;58;2.0
13;98;783;785;2;58;2.0
13;99;785;789;4;58;2.0
13;100;789;802;13;58;2.0
13;101;802;805;3;58;2.0
13;102;805;812;7;58;2.0
13;103;812;815;3;58;2.0
13;104;815;819;4;58;2.0
13;105;819;823;4;58;2.0
13;106;823;825;2;58;2.0
13;107;825;830;5;58;2.0
13;108;830;835;5;58;2.0
13;109;835;838;3;58;2.0
13;110;838;839;1;58;2.0
13;111;839;844;5;58;2.0
13;112;844;845;1;58;2.0
13;113;845;855;10;58;2.0
13;114;855;857;2;58;2.0
13;115;857;859;2;58;2.0
13;116;859;860;1;58;2.0
13;117;860;862;2;58;2.0
13;118;862;867;5;58;2.0
13;119;867;873;6;58;2.0
13;120;873;875;2;58;2.0
13;121;875;876;1;58;2.0
13;122;876;879;3;58;2.0
13;123;879;885;6;58;2.0
13;124;885;890;5;58;2.0
13;125;890;892;2;58;2.0
13;126;892;893;1;58;2.0
13;127;893;894;1;58;2.0
13;128;894;900;6;58;2.0
13;129;900;902;2;58;2.0
13;130;902;908;6;58;2.0
13;131;908;910;2;58;2.0
13;132;910;914;4;58;2.0
13;133;914;915;1;58;2.0
13;134;915;919;4;58;2.0
13;135;919;925;6;58;2.0
13;136;925;932;7;58;2.0
13;137;932;933;1;58;2.0
13;138;933;934;1;58;2.0
13;139;934;935;1;58;2.0
13;140;935;943;8;58;2.0
13;141;943;947;4;58;2.0
13;142;947;950;3;58;2.0
13;143;950;954;4;58;2.0
13;144;954;955;1;58;2.0
13;145;955;962;7;58;2.0
13;146;962;963;1;58;2.0
13;147;963;965;2;58;2.0
13;148;965;971;6;58;2.0
13;149;971;974;3;58;2.0
13;150;974;975;1;58;2.0
13;151;975;982;7;58;2.0
13;152;982;983;1;58;2.0
13;153;983;985;2;58;2.0
13;154;985;986;1;58;2.0
13;155;986;995;9;58;2.0
13;156;995;998;3;58;2.0
13;157;998;999;1;58;2.0
13;158;999;1005;6;58;2.0
13;159;1005;1007;2;58;2.0
13;160;1007;1015;8;58;2.0
13;161;1015;1019;4;58;2.0
13;162;1019;1022;3;58;2.0
13;163;1022;1023;1;58;2.0
13;164;1023;1029;6;58;2.0
13;165;1029;1030;1;58;2.0
13;166;1030;1035;5;58;2.0
13;167;1035;1039;4;58;2.0
13;168;1039;1048;9;58;2.0
13;169;1048;1051;3;58;2.0
13;170;1051;1052;1;58;2.0
13;171;1052;1054;2;58;2.0
13;172;1054;1055;1;58;2.0
13;173;1055;1062;7;58;2.0
13;174;1062;1075;13;58;2.0
13;175;1075;1078;3;58;2.0
13;176;1078;1079;1;58;2.0
13;177;1079;1083;4;58;2.0
13;178;1083;1088;5;58;2.0
13;179;1088;1092;4;58;2.0
13;180;1092;1095;3;58;2.0
13;181;1095;1101;6;58;2.0
13;182;1101;1103;2;58;2.0
13;183;1103;1106;3;58;2.0
13;184;1106;1110;4;58;2.0
13;185;1110;1118;8;58;2.0
13;186;1118;1128;10;58;2.0
13;187;1128;1131;3;58;2.0
13;188;1131;1133;2;58;2.0
13;189;1133;1148;15;58;2.0
13;190;1148;1154;6;58;2.0
13;191;1154;1157;3;58;2.0
13;192;1157;1171;14;58;2.0
13;193;1171;1176;5;58;2.0
13;194;1176;1178;2;58;2.0
13;195;1178;1188;10;58;2.0
13;196;1188;1196;8;58;2.0
13;197;1196;1206;10;58;2.0
13;198;1206;1212;6;58;2.0
13;199;1212;1214;2;58;2.0
13;200;1214;1226;12;58;2.0
13;201;1226;1238;12;58;2.0
13;202;1238;1258;20;58;2.0
13;203;1258;1263;5;58;2.0
13;204;1263;1266;3;58;2.0
13;205;1266;1270;4;58;2.0
13;206;1270;1274;4;58;2.0
13;207;1274;1286;12;58;2.0
13;208;1286;1298;12;58;2.0
13;209;1298;1303;5;58;2.0
13;210;1303;1318;15;58;2.0
13;211;1318;1320;2;58;2.0
13;212;1320;1324;4;58;2.0
13;213;1324;1339;15;58;2.0
13;214;1339;1347;8;58;2.0
13;215;1347;1364;17;58;2.0
13;216;1364;1367;3;58;2.0
13;217;1367;1368;1;58;2.0
13;218;1368;1371;3;58;2.0
13;219;1371;1372;1;58;2.0
13;220;1372;1386;14;58;2.0
13;221;1386;1388;2;58;2.0
13;222;1388;1391;3;58;2.0
13;223;1391;1406;15;58;2.0
13;224;1406;1421;15;58;2.0
13;225;1421;1436;15;58;2.0
13;226;1436;1451;15;58;2.0
13;227;1451;1466;15;58;2.0
13;228;1466;1481;15;58;2.0
13;229;1481;1496;15;58;2.0
13;230;1496;1511;15;58;2.0
13;231;1511;1526;15;58;2.0
13;232;1526;1541;15;58;2.0
13;233;1541;1556;15;58;2.0
13;234;1556;1571;15;58;2.0
13;235;1571;1586;15;58;2.0
13;236;1586;1601;15;58;2.0
13;237;1601;1616;15;58;2.0
13;238;1616;1631;15;58;2.0
13;239;1631;1646;15;58;2.0
13;240;1646;1661;15;58;2.0
13;241;1661;1680;19;58;2.0
14;0;257;324;67;115;2.0
14;1;324;340;16;115;2.0
14;2;340;342;2;115;2.0
14;3;342;344;2;115;2.0
14;4;344;345;1;115;2.0
14;5;345;348;3;115;2.0
14;6;348;351;3;115;2.0
14;7;351;354;3;115;2.0
14;8;354;359;5;115;2.0
14;9;359;360;1;115;2.0
14;10;360;362;2;115;2.0
14;11;362;369;7;115;2.0
14;12;369;371;2;115;2.0
14;13;371;372;1;115;2.0
14;14;372;374;2;115;2.0
14;15;374;375;1;115;2.0
14;16;375;379;4;115;2.0
14;17;379;381;2;115;2.0
14;18;381;391;10;115;2.0
14;19;391;394;3;115;2.0
14;20;394;400;6;115;2.0
14;21;400;402;2;115;2.0
14;22;402;405;3;115;2.0
14;23;405;409;4;115;2.0
14;24;409;410;1;115;2.0
14;25;410;414;4;115;2.0
14;26;414;417;3;115;2.0
14;27;417;420;3;115;2.0
14;28;420;427;7;115;2.0
14;29;427;429;2;115;2.0
14;30;429;431;2;115;2.0
14;31;431;432;1;115;2.0
14;32;432;435;3;115;2.0
14;33;435;439;4;115;2.0
14;34;439;441;2;115;2.0
14;35;441;442;1;115;2.0
14;36;442;444;2;115;2.0
14;37;444;449;5;115;2.0
14;38;449;450;1;115;2.0
14;39;450;456;6;115;2.0
14;40;456;459;3;115;2.0
14;41;459;461;2;115;2.0
14;42;461;464;3;115;2.0
14;43;464;465;1;115;2.0
14;44;465;471;6;115;2.0
14;45;471;474;3;115;2.0
14;46;474;479;5;115;2.0
14;47;479;480;1;115;2.0
14;48;480;482;2;115;2.0
14;49;482;484;2;115;2.0
14;50;484;489;5;115;2.0
14;51;489;492;3;115;2.0
14;52;492;493;1;115;2.0
14;53;493;495;2;115;2.0
14;54;495;497;2;115;2.0
14;55;497;505;8;115;2.0
14;56;505;510;5;115;2.0
14;57;510;511;1;115;2.0
14;58;511;514;3;115;2.0
14;59;514;515;1;115;2.0
14;60;515;522;7;115;2.0
14;61;522;524;2;115;2.0
14;62;524;532;8;115;2.0
14;63;532;537;5;115;2.0
14;64;537;544;7;115;2.0
14;65;544;548;4;115;2.0
14;66;548;554;6;115;2.0
14;67;554;556;2;115;2.0
14;68;556;560;4;115;2.0
14;69;560;562;2;115;2.0
14;70;562;569;7;115;2.0
14;71;569;591;22;115;2.0
14;72;591;597;6;115;2.0
14;73;597;602;5;115;2.0
14;74;602;604;2;115;2.0
14;75;604;605;1;115;2.0
14;76;605;619;14;115;2.0
14;77;619;631;12;115;2.0
14;78;631;637;6;115;2.0
14;79;637;642;5;115;2.0
14;80;642;661;19;115;2.0
14;81;661;669;8;115;2.0
14;82;669;672;3;115;2.0
14;83;672;682;10;115;2.0
14;84;682;685;3;115;2.0
14;85;685;689;4;115;2.0
14;86;689;701;12;115;2.0
14;87;701;707;6;115;2.0
14;88;707;727;20;115;2.0
14;89;727;729;2;115;2.0
14;90;729;731;2;115;2.0
14;91;731;735;4;115;2.0
14;92;735;742;7;115;2.0
14;93;742;749;7;115;2.0
14;94;749;759;10;115;2.0
14;95;759;760;1;115;2.0
14;96;760;772;12;115;2.0
14;97;772;780;8;115;2.0
14;98;780;781;1;115;2.0
14;99;781;782;1;115;2.0
14;100;782;784;2;115;2.0
14;101;784;789;5;115;2.0
14;102;789;795;6;115;2.0
14;103;795;802;7;115;2.0
14;104;802;809;7;115;2.0
14;105;809;810;1;115;2.0
14;106;810;811;1;115;2.0
14;107;811;814;3;115;2.0
14;108;814;820;6;115;2.0
14;109;820;825;5;115;2.0
14;110;825;830;5;115;2.0
14;111;830;832;2;115;2.0
14;112;832;834;2;115;2.0
14;113;834;838;4;115;2.0
14;114;838;844;6;115;2.0
14;115;844;846;2;115;2.0
14;116;846;852;6;115;2.0
14;117;852;854;2;115;2.0
14;118;854;861;7;115;2.0
14;119;861;862;1;115;2.0
14;120;862;869;7;115;2.0
14;121;869;875;6;115;2.0
14;122;875;877;2;115;2.0
14;123;877;884;7;115;2.0
14;124;884;885;1;115;2.0
14;125;885;889;4;115;2.0
14;126;889;891;2;115;2.0
14;127;891;896;5;115;2.0
14;128;896;897;1;115;2.0
14;129;897;899;2;115;2.0
14;130;899;901;2;115;2.0
14;131;901;902;1;115;2.0
14;132;902;904;2;115;2.0
14;133;904;914;10;115;2.0
14;134;914;916;2;115;2.0
14;135;916;917;1;115;2.0
14;136;917;918;1;115;2.0
14;137;918;929;11;115;2.0
14;138;929;931;2;115;2.0
14;139;931;932;1;115;2.0
14;140;932;937;5;115;2.0
14;141;937;944;7;115;2.0
14;142;944;946;2;115;2.0
14;143;946;949;3;115;2.0
14;144;949;952;3;115;2.0
14;145;952;956;4;115;2.0
14;146;956;961;5;115;2.0
14;147;961;964;3;115;2.0
14;148;964;969;5;115;2.0
14;149;969;972;3;115;2.0
14;150;972;976;4;115;2.0
14;151;976;977;1;115;2.0
14;152;977;981;4;115;2.0
14;153;981;984;3;115;2.0
14;154;984;989;5;115;2.0
14;155;989;992;3;115;2.0
14;156;992;1004;12;115;2.0
14;157;1004;1006;2;115;2.0
14;158;1006;1012;6;115;2.0
14;159;1012;1014;2;115;2.0
14;160;1014;1017;3;115;2.0
14;161;1017;1025;8;115;2.0
14;162;1025;1027;2;115;2.0
14;163;1027;1029;2;115;2.0
14;164;1029;1032;3;115;2.0
14;165;1032;1034;2;115;2.0
14;166;1034;1041;7;115;2.0
14;167;1041;1047;6;115;2.0
14;168;1047;1050;3;115;2.0
14;169;1050;1054;4;115;2.0
14;170;1054;1057;3;115;2.0
14;171;1057;1064;7;115;2.0
14;172;1064;1072;8;115;2.0
14;173;1072;1074;2;115;2.0
14;174;1074;1088;14;115;2.0
14;175;1088;1089;1;115;2.0
14;176;1089;1092;3;115;2.0
14;177;1092;1094;2;115;2.0
14;178;1094;1097;3;115;2.0
14;179;1097;1100;3;115;2.0
14;180;1100;1109;9;115;2.0
14;181;1109;1112;3;115;2.0
14;182;1112;1115;3;115;2.0
14;183;1115;1120;5;115;2.0
14;184;1120;1123;3;115;2.0
14;185;1123;1127;4;115;2.0
14;186;1127;1133;6;115;2.0
14;187;1133;1148;15;115;2.0
14;188;1148;1150;2;115;2.0
14;189;1150;1151;1;115;2.0
14;190;1151;1163;12;115;2.0
14;191;1163;1180;17;115;2.0
14;192;1180;1182;2;115;2.0
14;193;1182;1187;5;115;2.0
14;194;1187;1188;1;115;2.0
14;195;1188;1193;5;115;2.0
14;196;1193;1213;20;115;2.0
14;197;1213;1217;4;115;2.0
14;198;1217;1223;6;115;2.0
14;199;1223;1232;9;115;2.0
14;200;1232;1240;8;115;2.0
14;201;1240;1253;13;115;2.0
14;202;1253;1262;9;115;2.0
14;203;1262;1275;13;115;2.0
14;204;1275;1276;1;115;2.0
14;205;1276;1283;7;115;2.0
14;206;1283;1292;9;115;2.0
14;207;1292;1300;8;115;2.0
14;208;1300;1302;2;115;2.0
14;209;1302;1303;1;115;2.0
14;210;1303;1336;33;115;2.0
14;211;1336;1337;1;115;2.0
14;212;1337;1348;11;115;2.0
14;213;1348;1350;2;115;2.0
14;214;1350;1366;16;115;2.0
14;215;1366;1367;1;115;2.0
14;216;1367;1374;7;115;2.0
14;217;1374;1377;3;115;2.0
14;218;1377;1388;11;115;2.0
14;219;1388;1391;3;115;2.0
14;220;1391;1397;6;115;2.0
14;221;1397;1412;15;115;2.0
14;222;1412;1427;15;115;2.0
14;223;1427;1442;15;115;2.0
14;224;1442;1457;15;115;2.0
14;225;1457;1472;15;115;2.0
14;226;1472;1487;15;115;2.0
14;227;1487;1502;15;115;2.0
14;228;1502;1517;15;115;2.0
14;229;1517;1532;15;115;2.0
14;230;1532;1547;15;115;2.0
14;231;1547;1562;15;115;2.0
14;232;1562;1577;15;115;2.0
14;233;1577;1592;15;115;2.0
14;234;1592;1607;15;115;2.0
14;235;1607;1622;15;115;2.0
14;236;1622;1637;15;115;2.0
14;237;1637;1652;15;115;2.0
14;238;1652;1680;28;115;2.0
15;0;260;341;81;159;2.0
15;1;341;344;3;159;2.0
15;2;344;346;2;159;2.0
15;3;346;349;3;159;2.0
15;4;349;351;2;159;2.0
15;5;351;356;5;159;2.0
15;6;356;357;1;159;2.0
15;7;357;359;2;159;2.0
15;8;359;363;4;159;2.0
15;9;363;366;3;159;2.0
15;10;366;371;5;159;2.0
15;11;371;373;2;159;2.0
15;12;373;374;1;159;2.0
15;13;374;377;3;159;2.0
15;14;377;382;5;159;2.0
15;15;382;386;4;159;2.0
15;16;386;391;5;159;2.0
15;17;391;397;6;159;2.0
15;18;397;403;6;159;2.0
15;19;403;404;1;159;2.0
15;20;404;406;2;159;2.0
15;21;406;408;2;159;2.0
15;22;408;414;6;159;2.0
15;23;414;416;2;159;2.0
15;24;416;418;2;159;2.0
15;25;418;419;1;159;2.0
15;26;419;421;2;159;2.0
15;27;421;424;3;159;2.0
15;28;424;426;2;159;2.0
15;29;426;430;4;159;2.0
15;30;430;433;3;159;2.0
15;31;433;434;1;159;2.0
15;32;434;437;3;159;2.0
15;33;437;441;4;159;2.0
15;34;441;443;2;159;2.0
15;35;443;447;4;159;2.0
15;36;447;449;2;159;2.0
15;37;449;456;7;159;2.0
15;38;456;461;5;159;2.0
15;39;461;462;1;159;2.0
15;40;462;464;2;159;2.0
15;41;464;465;1;159;2.0
15;42;465;466;1;159;2.0
15;43;466;471;5;159;2.0
15;44;471;475;4;159;2.0
15;45;475;476;1;159;2.0
15;46;476;477;1;159;2.0
15;47;477;479;2;159;2.0
15;48;479;481;2;159;2.0
15;49;481;483;2;159;2.0
15;50;483;485;2;159;2.0
15;51;485;486;1;159;2.0
15;52;486;493;7;159;2.0
15;53;493;494;1;159;2.0
15;54;494;498;4;159;2.0
15;55;498;506;8;159;2.0
15;56;506;509;3;159;2.0
15;57;509;511;2;159;2.0
15;58;511;516;5;159;2.0
15;59;516;517;1;159;2.0
15;60;517;521;4;159;2.0
15;61;521;525;4;159;2.0
15;62;525;533;8;159;2.0
15;63;533;539;6;159;2.0
15;64;539;541;2;159;2.0
15;65;541;549;8;159;2.0
15;66;549;555;6;159;2.0
15;67;555;560;5;159;2.0
15;68;560;561;1;159;2.0
15;69;561;562;1;159;2.0
15;70;562;596;34;159;2.0
15;71;596;597;1;159;2.0
15;72;597;603;6;159;2.0
15;73;603;604;1;159;2.0
15;74;604;605;1;159;2.0
15;75;605;637;32;159;2.0
15;76;637;638;1;159;2.0
15;77;638;640;2;159;2.0
15;78;640;641;1;159;2.0
15;79;641;646;5;159;2.0
15;80;646;666;20;159;2.0
15;81;666;667;1;159;2.0
15;82;667;673;6;159;2.0
15;83;673;681;8;159;2.0
15;84;681;684;3;159;2.0
15;85;684;707;23;159;2.0
15;86;707;708;1;159;2.0
15;87;708;716;8;159;2.0
15;88;716;726;10;159;2.0
15;89;726;730;4;159;2.0
15;90;730;734;4;159;2.0
15;91;734;737;3;159;2.0
15;92;737;743;6;159;2.0
15;93;743;756;13;159;2.0
15;94;756;762;6;159;2.0
15;95;762;771;9;159;2.0
15;96;771;776;5;159;2.0
15;97;776;779;3;159;2.0
15;98;779;783;4;159;2.0
15;99;783;787;4;159;2.0
15;100;787;790;3;159;2.0
15;101;790;796;6;159;2.0
15;102;796;803;7;159;2.0
15;103;803;811;8;159;2.0
15;104;811;812;1;159;2.0
15;105;812;817;5;159;2.0
15;106;817;819;2;159;2.0
15;107;819;826;7;159;2.0
15;108;826;831;5;159;2.0
15;109;831;832;1;159;2.0
15;110;832;833;1;159;2.0
15;111;833;836;3;159;2.0
15;112;836;843;7;159;2.0
15;113;843;844;1;159;2.0
15;114;844;845;1;159;2.0
15;115;845;853;8;159;2.0
15;116;853;858;5;159;2.0
15;117;858;861;3;159;2.0
15;118;861;863;2;159;2.0
15;119;863;867;4;159;2.0
15;120;867;874;7;159;2.0
15;121;874;878;4;159;2.0
15;122;878;881;3;159;2.0
15;123;881;884;3;159;2.0
15;124;884;893;9;159;2.0
15;125;893;896;3;159;2.0
15;126;896;897;1;159;2.0
15;127;897;900;3;159;2.0
15;128;900;903;3;159;2.0
15;129;903;907;4;159;2.0
15;130;907;913;6;159;2.0
15;131;913;915;2;159;2.0
15;132;915;916;1;159;2.0
15;133;916;918;2;159;2.0
15;134;918;924;6;159;2.0
15;135;924;931;7;159;2.0
15;136;931;933;2;159;2.0
15;137;933;937;4;159;2.0
15;138;937;939;2;159;2.0
15;139;939;941;2;159;2.0
15;140;941;950;9;159;2.0
15;141;950;951;1;159;2.0
15;142;951;952;1;159;2.0
15;143;952;953;1;159;2.0
15;144;953;956;3;159;2.0
15;145;956;967;11;159;2.0
15;146;967;970;3;159;2.0
15;147;970;971;1;159;2.0
15;148;971;973;2;159;2.0
15;149;973;978;5;159;2.0
15;150;978;987;9;159;2.0
15;151;987;990;3;159;2.0
15;152;990;991;1;159;2.0
15;153;991;993;2;159;2.0
15;154;993;1005;12;159;2.0
15;155;1005;1011;6;159;2.0
15;156;1011;1012;1;159;2.0
15;157;1012;1013;1;159;2.0
15;158;1013;1016;3;159;2.0
15;159;1016;1026;10;159;2.0
15;160;1026;1029;3;159;2.0
15;161;1029;1031;2;159;2.0
15;162;1031;1033;2;159;2.0
15;163;1033;1035;2;159;2.0
15;164;1035;1038;3;159;2.0
15;165;1038;1041;3;159;2.0
15;166;1041;1046;5;159;2.0
15;167;1046;1055;9;159;2.0
15;168;1055;1056;1;159;2.0
15;169;1056;1059;3;159;2.0
15;170;1059;1061;2;159;2.0
15;171;1061;1063;2;159;2.0
15;172;1063;1071;8;159;2.0
15;173;1071;1073;2;159;2.0
15;174;1073;1081;8;159;2.0
15;175;1081;1086;5;159;2.0
15;176;1086;1090;4;159;2.0
15;177;1090;1093;3;159;2.0
15;178;1093;1095;2;159;2.0
15;179;1095;1096;1;159;2.0
15;180;1096;1101;5;159;2.0
15;181;1101;1106;5;159;2.0
15;182;1106;1110;4;159;2.0
15;183;1110;1113;3;159;2.0
15;184;1113;1117;4;159;2.0
15;185;1117;1119;2;159;2.0
15;186;1119;1121;2;159;2.0
15;187;1121;1133;12;159;2.0
15;188;1133;1149;16;159;2.0
15;189;1149;1150;1;159;2.0
15;190;1150;1160;10;159;2.0
15;191;1160;1164;4;159;2.0
15;192;1164;1179;15;159;2.0
15;193;1179;1183;4;159;2.0
15;194;1183;1189;6;159;2.0
15;195;1189;1193;4;159;2.0
15;196;1193;1211;18;159;2.0
15;197;1211;1219;8;159;2.0
15;198;1219;1220;1;159;2.0
15;199;1220;1224;4;159;2.0
15;200;1224;1233;9;159;2.0
15;201;1233;1239;6;159;2.0
15;202;1239;1268;29;159;2.0
15;203;1268;1275;7;159;2.0
15;204;1275;1277;2;159;2.0
15;205;1277;1280;3;159;2.0
15;206;1280;1284;4;159;2.0
15;207;1284;1293;9;159;2.0
15;208;1293;1299;6;159;2.0
15;209;1299;1308;9;159;2.0
15;210;1308;1330;22;159;2.0
15;211;1330;1335;5;159;2.0
15;212;1335;1338;3;159;2.0
15;213;1338;1347;9;159;2.0
15;214;1347;1352;5;159;2.0
15;215;1352;1365;13;159;2.0
15;216;1365;1372;7;159;2.0
15;217;1372;1375;3;159;2.0
15;218;1375;1379;4;159;2.0
15;219;1379;1389;10;159;2.0
15;220;1389;1393;4;159;2.0
15;221;1393;1394;1;159;2.0
15;222;1394;1398;4;159;2.0
15;223;1398;1413;15;159;2.0
15;224;1413;1428;15;159;2.0
15;225;1428;1443;15;159;2.0
15;226;1443;1458;15;159;2.0
15;227;1458;1473;15;159;2.0
15;228;1473;1488;15;159;2.0
15;229;1488;1503;15;159;2.0
15;230;1503;1518;15;159;2.0
15;231;1518;1533;15;159;2.0
15;232;1533;1548;15;159;2.0
15;233;1548;1563;15;159;2.0
15;234;1563;1578;15;159;2.0
15;235;1578;1593;15;159;2.0
15;236;1593;1608;15;159;2.0
15;237;1608;1623;15;159;2.0
15;238;1623;1638;15;159;2.0
15;239;1638;1653;15;159;2.0
15;240;1653;1680;27;159;2.0
16;0;247;333;86;14;2.0
16;1;333;334;1;14;2.0
16;2;334;335;1;14;2.0
16;3;335;337;2;14;2.0
16;4;337;341;4;14;2.0
16;5;341;344;3;14;2.0
16;6;344;346;2;14;2.0
16;7;346;350;4;14;2.0
16;8;350;352;2;14;2.0
16;9;352;355;3;14;2.0
16;10;355;361;6;14;2.0
16;11;361;364;3;14;2.0
16;12;364;365;1;14;2.0
16;13;365;367;2;14;2.0
16;14;367;370;3;14;2.0
16;15;370;374;4;14;2.0
16;16;374;384;10;14;2.0
16;17;384;385;1;14;2.0
16;18;385;390;5;14;2.0
16;19;390;392;2;14;2.0
16;20;392;395;3;14;2.0
16;21;395;397;2;14;2.0
16;22;397;400;3;14;2.0
16;23;400;403;3;14;2.0
16;24;403;405;2;14;2.0
16;25;405;409;4;14;2.0
16;26;409;410;1;14;2.0
16;27;410;412;2;14;2.0
16;28;412;419;7;14;2.0
16;29;419;420;1;14;2.0
16;30;420;421;1;14;2.0
16;31;421;424;3;14;2.0
16;32;424;425;1;14;2.0
16;33;425;427;2;14;2.0
16;34;427;434;7;14;2.0
16;35;434;435;1;14;2.0
16;36;435;436;1;14;2.0
16;37;436;440;4;14;2.0
16;38;440;442;2;14;2.0
16;39;442;449;7;14;2.0
16;40;449;450;1;14;2.0
16;41;450;451;1;14;2.0
16;42;451;454;3;14;2.0
16;43;454;455;1;14;2.0
16;44;455;456;1;14;2.0
16;45;456;457;1;14;2.0
16;46;457;460;3;14;2.0
16;47;460;464;4;14;2.0
16;48;464;466;2;14;2.0
16;49;466;471;5;14;2.0
16;50;471;472;1;14;2.0
16;51;472;475;3;14;2.0
16;52;475;476;1;14;2.0
16;53;476;481;5;14;2.0
16;54;481;485;4;14;2.0
16;55;485;487;2;14;2.0
16;56;487;490;3;14;2.0
16;57;490;495;5;14;2.0
16;58;495;497;2;14;2.0
16;59;497;502;5;14;2.0
16;60;502;504;2;14;2.0
16;61;504;507;3;14;2.0
16;62;507;514;7;14;2.0
16;63;514;516;2;14;2.0
16;64;516;525;9;14;2.0
16;65;525;529;4;14;2.0
16;66;529;535;6;14;2.0
16;67;535;540;5;14;2.0
16;68;540;546;6;14;2.0
16;69;546;549;3;14;2.0
16;70;549;552;3;14;2.0
16;71;552;553;1;14;2.0
16;72;553;554;1;14;2.0
16;73;554;580;26;14;2.0
16;74;580;584;4;14;2.0
16;75;584;589;5;14;2.0
16;76;589;595;6;14;2.0
16;77;595;596;1;14;2.0
16;78;596;597;1;14;2.0
16;79;597;624;27;14;2.0
16;80;624;630;6;14;2.0
16;81;630;633;3;14;2.0
16;82;633;634;1;14;2.0
16;83;634;654;20;14;2.0
16;84;654;660;6;14;2.0
16;85;660;665;5;14;2.0
16;86;665;674;9;14;2.0
16;87;674;677;3;14;2.0
16;88;677;694;17;14;2.0
16;89;694;700;6;14;2.0
16;90;700;719;19;14;2.0
16;91;719;721;2;14;2.0
16;92;721;724;3;14;2.0
16;93;724;727;3;14;2.0
16;94;727;735;8;14;2.0
16;95;735;750;15;14;2.0
16;96;750;752;2;14;2.0
16;97;752;760;8;14;2.0
16;98;760;764;4;14;2.0
16;99;764;772;8;14;2.0
16;100;772;774;2;14;2.0
16;101;774;775;1;14;2.0
16;102;775;781;6;14;2.0
16;103;781;787;6;14;2.0
16;104;787;795;8;14;2.0
16;105;795;802;7;14;2.0
16;106;802;804;2;14;2.0
16;107;804;806;2;14;2.0
16;108;806;812;6;14;2.0
16;109;812;817;5;14;2.0
16;110;817;820;3;14;2.0
16;111;820;822;2;14;2.0
16;112;822;825;3;14;2.0
16;113;825;831;6;14;2.0
16;114;831;836;5;14;2.0
16;115;836;838;2;14;2.0
16;116;838;845;7;14;2.0
16;117;845;853;8;14;2.0
16;118;853;854;1;14;2.0
16;119;854;855;1;14;2.0
16;120;855;865;10;14;2.0
16;121;865;867;2;14;2.0
16;122;867;868;1;14;2.0
16;123;868;870;2;14;2.0
16;124;870;875;5;14;2.0
16;125;875;877;2;14;2.0
16;126;877;880;3;14;2.0
16;127;880;884;4;14;2.0
16;128;884;888;4;14;2.0
16;129;888;889;1;14;2.0
16;130;889;891;2;14;2.0
16;131;891;894;3;14;2.0
16;132;894;895;1;14;2.0
16;133;895;900;5;14;2.0
16;134;900;906;6;14;2.0
16;135;906;908;2;14;2.0
16;136;908;910;2;14;2.0
16;137;910;911;1;14;2.0
16;138;911;915;4;14;2.0
16;139;915;924;9;14;2.0
16;140;924;925;1;14;2.0
16;141;925;929;4;14;2.0
16;142;929;935;6;14;2.0
16;143;935;939;4;14;2.0
16;144;939;940;1;14;2.0
16;145;940;941;1;14;2.0
16;146;941;944;3;14;2.0
16;147;944;945;1;14;2.0
16;148;945;948;3;14;2.0
16;149;948;954;6;14;2.0
16;150;954;955;1;14;2.0
16;151;955;961;6;14;2.0
16;152;961;965;4;14;2.0
16;153;965;968;3;14;2.0
16;154;968;969;1;14;2.0
16;155;969;974;5;14;2.0
16;156;974;975;1;14;2.0
16;157;975;981;6;14;2.0
16;158;981;984;3;14;2.0
16;159;984;985;1;14;2.0
16;160;985;995;10;14;2.0
16;161;995;996;1;14;2.0
16;162;996;999;3;14;2.0
16;163;999;1005;6;14;2.0
16;164;1005;1009;4;14;2.0
16;165;1009;1017;8;14;2.0
16;166;1017;1019;2;14;2.0
16;167;1019;1022;3;14;2.0
16;168;1022;1025;3;14;2.0
16;169;1025;1033;8;14;2.0
16;170;1033;1039;6;14;2.0
16;171;1039;1043;4;14;2.0
16;172;1043;1045;2;14;2.0
16;173;1045;1046;1;14;2.0
16;174;1046;1049;3;14;2.0
16;175;1049;1056;7;14;2.0
16;176;1056;1064;8;14;2.0
16;177;1064;1065;1;14;2.0
16;178;1065;1080;15;14;2.0
16;179;1080;1085;5;14;2.0
16;180;1085;1086;1;14;2.0
16;181;1086;1089;3;14;2.0
16;182;1089;1093;4;14;2.0
16;183;1093;1101;8;14;2.0
16;184;1101;1104;3;14;2.0
16;185;1104;1107;3;14;2.0
16;186;1107;1112;5;14;2.0
16;187;1112;1114;2;14;2.0
16;188;1114;1120;6;14;2.0
16;189;1120;1141;21;14;2.0
16;190;1141;1142;1;14;2.0
16;191;1142;1143;1;14;2.0
16;192;1143;1144;1;14;2.0
16;193;1144;1155;11;14;2.0
16;194;1155;1172;17;14;2.0
16;195;1172;1174;2;14;2.0
16;196;1174;1180;6;14;2.0
16;197;1180;1181;1;14;2.0
16;198;1181;1204;23;14;2.0
16;199;1204;1209;5;14;2.0
16;200;1209;1216;7;14;2.0
16;201;1216;1224;8;14;2.0
16;202;1224;1232;8;14;2.0
16;203;1232;1255;23;14;2.0
16;204;1255;1264;9;14;2.0
16;205;1264;1267;3;14;2.0
16;206;1267;1268;1;14;2.0
16;207;1268;1276;8;14;2.0
16;208;1276;1284;8;14;2.0
16;209;1284;1292;8;14;2.0
16;210;1292;1295;3;14;2.0
16;211;1295;1314;19;14;2.0
16;212;1314;1328;14;14;2.0
16;213;1328;1330;2;14;2.0
16;214;1330;1339;9;14;2.0
16;215;1339;1341;2;14;2.0
16;216;1341;1358;17;14;2.0
16;217;1358;1359;1;14;2.0
16;218;1359;1366;7;14;2.0
16;219;1366;1369;3;14;2.0
16;220;1369;1378;9;14;2.0
16;221;1378;1381;3;14;2.0
16;222;1381;1383;2;14;2.0
16;223;1383;1389;6;14;2.0
16;224;1389;1404;15;14;2.0
16;225;1404;1419;15;14;2.0
16;226;1419;1434;15;14;2.0
16;227;1434;1449;15;14;2.0
16;228;1449;1464;15;14;2.0
16;229;1464;1479;15;14;2.0
16;230;1479;1494;15;14;2.0
16;231;1494;1509;15;14;2.0
16;232;1509;1524;15;14;2.0
16;233;1524;1539;15;14;2.0
16;234;1539;1554;15;14;2.0
16;235;1554;1569;15;14;2.0
16;236;1569;1584;15;14;2.0
16;237;1584;1599;15;14;2.0
16;238;1599;1614;15;14;2.0
16;239;1614;1629;15;14;2.0
16;240;1629;1644;15;14;2.0
16;241;1644;1659;15;14;2.0
16;242;1659;1680;21;14;2.0
17;0;252;333;81;99;2.0
17;1;333;336;3;99;2.0
17;2;336;338;2;99;2.0
17;3;338;340;2;99;2.0
17;4;340;341;1;99;2.0
17;5;341;344;3;99;2.0
17;6;344;345;1;99;2.0
17;7;345;347;2;99;2.0
17;8;347;353;6;99;2.0
17;9;353;355;2;99;2.0
17;10;355;358;3;99;2.0
17;11;358;360;2;99;2.0
17;12;360;361;1;99;2.0
17;13;361;367;6;99;2.0
17;14;367;368;1;99;2.0
17;15;368;370;2;99;2.0
17;16;370;376;6;99;2.0
17;17;376;377;1;99;2.0
17;18;377;387;10;99;2.0
17;19;387;388;1;99;2.0
17;20;388;391;3;99;2.0
17;21;391;396;5;99;2.0
17;22;396;398;2;99;2.0
17;23;398;400;2;99;2.0
17;24;400;403;3;99;2.0
17;25;403;406;3;99;2.0
17;26;406;408;2;99;2.0
17;27;408;411;3;99;2.0
17;28;411;413;2;99;2.0
17;29;413;415;2;99;2.0
17;30;415;418;3;99;2.0
17;31;418;423;5;99;2.0
17;32;423;424;1;99;2.0
17;33;424;427;3;99;2.0
17;34;427;428;1;99;2.0
17;35;428;430;2;99;2.0
17;36;430;431;1;99;2.0
17;37;431;435;4;99;2.0
17;38;435;437;2;99;2.0
17;39;437;438;1;99;2.0
17;40;438;445;7;99;2.0
17;41;445;446;1;99;2.0
17;42;446;450;4;99;2.0
17;43;450;452;2;99;2.0
17;44;452;456;4;99;2.0
17;45;456;457;1;99;2.0
17;46;457;458;1;99;2.0
17;47;458;459;1;99;2.0
17;48;459;460;1;99;2.0
17;49;460;465;5;99;2.0
17;50;465;466;1;99;2.0
17;51;466;467;1;99;2.0
17;52;467;469;2;99;2.0
17;53;469;474;5;99;2.0
17;54;474;475;1;99;2.0
17;55;475;478;3;99;2.0
17;56;478;479;1;99;2.0
17;57;479;480;1;99;2.0
17;58;480;488;8;99;2.0
17;59;488;490;2;99;2.0
17;60;490;493;3;99;2.0
17;61;493;500;7;99;2.0
17;62;500;501;1;99;2.0
17;63;501;505;4;99;2.0
17;64;505;507;2;99;2.0
17;65;507;510;3;99;2.0
17;66;510;513;3;99;2.0
17;67;513;519;6;99;2.0
17;68;519;528;9;99;2.0
17;69;528;531;3;99;2.0
17;70;531;532;1;99;2.0
17;71;532;538;6;99;2.0
17;72;538;543;5;99;2.0
17;73;543;549;6;99;2.0
17;74;549;552;3;99;2.0
17;75;552;553;1;99;2.0
17;76;553;555;2;99;2.0
17;77;555;556;1;99;2.0
17;78;556;586;30;99;2.0
17;79;586;587;1;99;2.0
17;80;587;588;1;99;2.0
17;81;588;598;10;99;2.0
17;82;598;599;1;99;2.0
17;83;599;600;1;99;2.0
17;84;600;627;27;99;2.0
17;85;627;633;6;99;2.0
17;86;633;636;3;99;2.0
17;87;636;657;21;99;2.0
17;88;657;663;6;99;2.0
17;89;663;668;5;99;2.0
17;90;668;673;5;99;2.0
17;91;673;680;7;99;2.0
17;92;680;697;17;99;2.0
17;93;697;703;6;99;2.0
17;94;703;706;3;99;2.0
17;95;706;718;12;99;2.0
17;96;718;724;6;99;2.0
17;97;724;727;3;99;2.0
17;98;727;730;3;99;2.0
17;99;730;738;8;99;2.0
17;100;738;753;15;99;2.0
17;101;753;755;2;99;2.0
17;102;755;763;8;99;2.0
17;103;763;766;3;99;2.0
17;104;766;775;9;99;2.0
17;105;775;777;2;99;2.0
17;106;777;778;1;99;2.0
17;107;778;784;6;99;2.0
17;108;784;790;6;99;2.0
17;109;790;798;8;99;2.0
17;110;798;801;3;99;2.0
17;111;801;805;4;99;2.0
17;112;805;807;2;99;2.0
17;113;807;815;8;99;2.0
17;114;815;820;5;99;2.0
17;115;820;825;5;99;2.0
17;116;825;826;1;99;2.0
17;117;826;828;2;99;2.0
17;118;828;834;6;99;2.0
17;119;834;837;3;99;2.0
17;120;837;839;2;99;2.0
17;121;839;848;9;99;2.0
17;122;848;851;3;99;2.0
17;123;851;852;1;99;2.0
17;124;852;857;5;99;2.0
17;125;857;858;1;99;2.0
17;126;858;870;12;99;2.0
17;127;870;871;1;99;2.0
17;128;871;873;2;99;2.0
17;129;873;878;5;99;2.0
17;130;878;880;2;99;2.0
17;131;880;886;6;99;2.0
17;132;886;887;1;99;2.0
17;133;887;892;5;99;2.0
17;134;892;894;2;99;2.0
17;135;894;897;3;99;2.0
17;136;897;898;1;99;2.0
17;137;898;906;8;99;2.0
17;138;906;907;1;99;2.0
17;139;907;909;2;99;2.0
17;140;909;913;4;99;2.0
17;141;913;914;1;99;2.0
17;142;914;921;7;99;2.0
17;143;921;927;6;99;2.0
17;144;927;928;1;99;2.0
17;145;928;932;4;99;2.0
17;146;932;938;6;99;2.0
17;147;938;942;4;99;2.0
17;148;942;944;2;99;2.0
17;149;944;946;2;99;2.0
17;150;946;947;1;99;2.0
17;151;947;948;1;99;2.0
17;152;948;957;9;99;2.0
17;153;957;961;4;99;2.0
17;154;961;964;3;99;2.0
17;155;964;967;3;99;2.0
17;156;967;968;1;99;2.0
17;157;968;972;4;99;2.0
17;158;972;977;5;99;2.0
17;159;977;981;4;99;2.0
17;160;981;984;3;99;2.0
17;161;984;987;3;99;2.0
17;162;987;988;1;99;2.0
17;163;988;999;11;99;2.0
17;164;999;1001;2;99;2.0
17;165;1001;1002;1;99;2.0
17;166;1002;1008;6;99;2.0
17;167;1008;1012;4;99;2.0
17;168;1012;1020;8;99;2.0
17;169;1020;1022;2;99;2.0
17;170;1022;1025;3;99;2.0
17;171;1025;1028;3;99;2.0
17;172;1028;1031;3;99;2.0
17;173;1031;1032;1;99;2.0
17;174;1032;1042;10;99;2.0
17;175;1042;1046;4;99;2.0
17;176;1046;1049;3;99;2.0
17;177;1049;1051;2;99;2.0
17;178;1051;1052;1;99;2.0
17;179;1052;1055;3;99;2.0
17;180;1055;1067;12;99;2.0
17;181;1067;1068;1;99;2.0
17;182;1068;1071;3;99;2.0
17;183;1071;1083;12;99;2.0
17;184;1083;1085;2;99;2.0
17;185;1085;1088;3;99;2.0
17;186;1088;1089;1;99;2.0
17;187;1089;1091;2;99;2.0
17;188;1091;1092;1;99;2.0
17;189;1092;1096;4;99;2.0
17;190;1096;1104;8;99;2.0
17;191;1104;1107;3;99;2.0
17;192;1107;1110;3;99;2.0
17;193;1110;1111;1;99;2.0
17;194;1111;1117;6;99;2.0
17;195;1117;1123;6;99;2.0
17;196;1123;1141;18;99;2.0
17;197;1141;1144;3;99;2.0
17;198;1144;1146;2;99;2.0
17;199;1146;1150;4;99;2.0
17;200;1150;1158;8;99;2.0
17;201;1158;1171;13;99;2.0
17;202;1171;1177;6;99;2.0
17;203;1177;1183;6;99;2.0
17;204;1183;1184;1;99;2.0
17;205;1184;1207;23;99;2.0
17;206;1207;1210;3;99;2.0
17;207;1210;1212;2;99;2.0
17;208;1212;1219;7;99;2.0
17;209;1219;1227;8;99;2.0
17;210;1227;1231;4;99;2.0
17;211;1231;1258;27;99;2.0
17;212;1258;1270;12;99;2.0
17;213;1270;1271;1;99;2.0
17;214;1271;1279;8;99;2.0
17;215;1279;1287;8;99;2.0
17;216;1287;1291;4;99;2.0
17;217;1291;1298;7;99;2.0
17;218;1298;1320;22;99;2.0
17;219;1320;1331;11;99;2.0
17;220;1331;1333;2;99;2.0
17;221;1333;1342;9;99;2.0
17;222;1342;1344;2;99;2.0
17;223;1344;1357;13;99;2.0
17;224;1357;1362;5;99;2.0
17;225;1362;1369;7;99;2.0
17;226;1369;1372;3;99;2.0
17;227;1372;1384;12;99;2.0
17;228;1384;1386;2;99;2.0
17;229;1386;1392;6;99;2.0
17;230;1392;1407;15;99;2.0
17;231;1407;1422;15;99;2.0
17;232;1422;1437;15;99;2.0
17;233;1437;1452;15;99;2.0
17;234;1452;1467;15;99;2.0
17;235;1467;1482;15;99;2.0
17;236;1482;1497;15;99;2.0
17;237;1497;1512;15;99;2.0
17;238;1512;1527;15;99;2.0
17;239;1527;1542;15;99;2.0
17;240;1542;1557;15;99;2.0
17;241;1557;1572;15;99;2.0
17;242;1572;1587;15;99;2.0
17;243;1587;1602;15;99;2.0
17;244;1602;1617;15;99;2.0
17;245;1617;1632;15;99;2.0
17;246;1632;1647;15;99;2.0
17;247;1647;1662;15;99;2.0
17;248;1662;1680;18;99;2.0
18;0;246;334;88;501;2.0
18;1;334;335;1;501;2.0
18;2;335;336;1;501;2.0
18;3;336;339;3;501;2.0
18;4;339;340;1;501;2.0
18;5;340;342;2;501;2.0
18;6;342;349;7;501;2.0
18;7;349;350;1;501;2.0
18;8;350;351;1;501;2.0
18;9;351;360;9;501;2.0
18;10;360;362;2;501;2.0
18;11;362;364;2;501;2.0
18;12;364;365;1;501;2.0
18;13;365;366;1;501;2.0
18;14;366;369;3;501;2.0
18;15;369;371;2;501;2.0
18;16;371;377;6;501;2.0
18;17;377;385;8;501;2.0
18;18;385;390;5;501;2.0
18;19;390;391;1;501;2.0
18;20;391;394;3;501;2.0
18;21;394;397;3;501;2.0
18;22;397;400;3;501;2.0
18;23;400;402;2;501;2.0
18;24;402;405;3;501;2.0
18;25;405;409;4;501;2.0
18;26;409;410;1;501;2.0
18;27;410;412;2;501;2.0
18;28;412;414;2;501;2.0
18;29;414;420;6;501;2.0
18;30;420;421;1;501;2.0
18;31;421;424;3;501;2.0
18;32;424;430;6;501;2.0
18;33;430;431;1;501;2.0
18;34;431;432;1;501;2.0
18;35;432;439;7;501;2.0
18;36;439;441;2;501;2.0
18;37;441;447;6;501;2.0
18;38;447;449;2;501;2.0
18;39;449;454;5;501;2.0
18;40;454;455;1;501;2.0
18;41;455;456;1;501;2.0
18;42;456;457;1;501;2.0
18;43;457;466;9;501;2.0
18;44;466;467;1;501;2.0
18;45;467;469;2;501;2.0
18;46;469;470;1;501;2.0
18;47;470;471;1;501;2.0
18;48;471;476;5;501;2.0
18;49;476;480;4;501;2.0
18;50;480;484;4;501;2.0
18;51;484;485;1;501;2.0
18;52;485;486;1;501;2.0
18;53;486;497;11;501;2.0
18;54;497;499;2;501;2.0
18;55;499;502;3;501;2.0
18;56;502;507;5;501;2.0
18;57;507;511;4;501;2.0
18;58;511;516;5;501;2.0
18;59;516;519;3;501;2.0
18;60;519;520;1;501;2.0
18;61;520;529;9;501;2.0
18;62;529;532;3;501;2.0
18;63;532;535;3;501;2.0
18;64;535;540;5;501;2.0
18;65;540;546;6;501;2.0
18;66;546;551;5;501;2.0
18;67;551;552;1;501;2.0
18;68;552;556;4;501;2.0
18;69;556;559;3;501;2.0
18;70;559;587;28;501;2.0
18;71;587;590;3;501;2.0
18;72;590;591;1;501;2.0
18;73;591;594;3;501;2.0
18;74;594;596;2;501;2.0
18;75;596;625;29;501;2.0
18;76;625;631;6;501;2.0
18;77;631;637;6;501;2.0
18;78;637;639;2;501;2.0
18;79;639;660;21;501;2.0
18;80;660;661;1;501;2.0
18;81;661;674;13;501;2.0
18;82;674;679;5;501;2.0
18;83;679;695;16;501;2.0
18;84;695;701;6;501;2.0
18;85;701;707;6;501;2.0
18;86;707;721;14;501;2.0
18;87;721;724;3;501;2.0
18;88;724;730;6;501;2.0
18;89;730;731;1;501;2.0
18;90;731;750;19;501;2.0
18;91;750;752;2;501;2.0
18;92;752;767;15;501;2.0
18;93;767;769;2;501;2.0
18;94;769;770;1;501;2.0
18;95;770;781;11;501;2.0
18;96;781;787;6;501;2.0
18;97;787;790;3;501;2.0
18;98;790;802;12;501;2.0
18;99;802;809;7;501;2.0
18;100;809;811;2;501;2.0
18;101;811;817;6;501;2.0
18;102;817;820;3;501;2.0
18;103;820;822;2;501;2.0
18;104;822;825;3;501;2.0
18;105;825;827;2;501;2.0
18;106;827;836;9;501;2.0
18;107;836;838;2;501;2.0
18;108;838;840;2;501;2.0
18;109;840;843;3;501;2.0
18;110;843;850;7;501;2.0
18;111;850;852;2;501;2.0
18;112;852;858;6;501;2.0
18;113;858;861;3;501;2.0
18;114;861;864;3;501;2.0
18;115;864;865;1;501;2.0
18;116;865;872;7;501;2.0
18;117;872;874;2;501;2.0
18;118;874;875;1;501;2.0
18;119;875;886;11;501;2.0
18;120;886;887;1;501;2.0
18;121;887;890;3;501;2.0
18;122;890;891;1;501;2.0
18;123;891;893;2;501;2.0
18;124;893;901;8;501;2.0
18;125;901;905;4;501;2.0
18;126;905;906;1;501;2.0
18;127;906;907;1;501;2.0
18;128;907;913;6;501;2.0
18;129;913;918;5;501;2.0
18;130;918;920;2;501;2.0
18;131;920;921;1;501;2.0
18;132;921;922;1;501;2.0
18;133;922;929;7;501;2.0
18;134;929;931;2;501;2.0
18;135;931;935;4;501;2.0
18;136;935;940;5;501;2.0
18;137;940;941;1;501;2.0
18;138;941;946;5;501;2.0
18;139;946;947;1;501;2.0
18;140;947;953;6;501;2.0
18;141;953;960;7;501;2.0
18;142;960;961;1;501;2.0
18;143;961;962;1;501;2.0
18;144;962;969;7;501;2.0
18;145;969;973;4;501;2.0
18;146;973;980;7;501;2.0
18;147;980;981;1;501;2.0
18;148;981;982;1;501;2.0
18;149;982;984;2;501;2.0
18;150;984;996;12;501;2.0
18;151;996;1000;4;501;2.0
18;152;1000;1002;2;501;2.0
18;153;1002;1006;4;501;2.0
18;154;1006;1017;11;501;2.0
18;155;1017;1019;2;501;2.0
18;156;1019;1020;1;501;2.0
18;157;1020;1025;5;501;2.0
18;158;1025;1029;4;501;2.0
18;159;1029;1032;3;501;2.0
18;160;1032;1036;4;501;2.0
18;161;1036;1038;2;501;2.0
18;162;1038;1046;8;501;2.0
18;163;1046;1049;3;501;2.0
18;164;1049;1050;1;501;2.0
18;165;1050;1052;2;501;2.0
18;166;1052;1060;8;501;2.0
18;167;1060;1061;1;501;2.0
18;168;1061;1072;11;501;2.0
18;169;1072;1080;8;501;2.0
18;170;1080;1086;6;501;2.0
18;171;1086;1091;5;501;2.0
18;172;1091;1092;1;501;2.0
18;173;1092;1100;8;501;2.0
18;174;1100;1101;1;501;2.0
18;175;1101;1104;3;501;2.0
18;176;1104;1107;3;501;2.0
18;177;1107;1112;5;501;2.0
18;178;1112;1117;5;501;2.0
18;179;1117;1127;10;501;2.0
18;180;1127;1136;9;501;2.0
18;181;1136;1140;4;501;2.0
18;182;1140;1147;7;501;2.0
18;183;1147;1151;4;501;2.0
18;184;1151;1155;4;501;2.0
18;185;1155;1174;19;501;2.0
18;186;1174;1176;2;501;2.0
18;187;1176;1177;1;501;2.0
18;188;1177;1187;10;501;2.0
18;189;1187;1202;15;501;2.0
18;190;1202;1209;7;501;2.0
18;191;1209;1211;2;501;2.0
18;192;1211;1224;13;501;2.0
18;193;1224;1237;13;501;2.0
18;194;1237;1262;25;501;2.0
18;195;1262;1265;3;501;2.0
18;196;1265;1267;2;501;2.0
18;197;1267;1271;4;501;2.0
18;198;1271;1284;13;501;2.0
18;199;1284;1297;13;501;2.0
18;200;1297;1302;5;501;2.0
18;201;1302;1321;19;501;2.0
18;202;1321;1325;4;501;2.0
18;203;1325;1341;16;501;2.0
18;204;1341;1346;5;501;2.0
18;205;1346;1363;17;501;2.0
18;206;1363;1366;3;501;2.0
18;207;1366;1369;3;501;2.0
18;208;1369;1376;7;501;2.0
18;209;1376;1383;7;501;2.0
18;210;1383;1385;2;501;2.0
18;211;1385;1389;4;501;2.0
18;212;1389;1404;15;501;2.0
18;213;1404;1419;15;501;2.0
18;214;1419;1434;15;501;2.0
18;215;1434;1449;15;501;2.0
18;216;1449;1464;15;501;2.0
18;217;1464;1479;15;501;2.0
18;218;1479;1494;15;501;2.0
18;219;1494;1509;15;501;2.0
18;220;1509;1524;15;501;2.0
18;221;1524;1539;15;501;2.0
18;222;1539;1554;15;501;2.0
18;223;1554;1569;15;501;2.0
18;224;1569;1584;15;501;2.0
18;225;1584;1599;15;501;2.0
18;226;1599;1614;15;501;2.0
18;227;1614;1629;15;501;2.0
18;228;1629;1644;15;501;2.0
18;229;1644;1659;15;501;2.0
18;230;1659;1680;21;501;2.0
19;0;250;342;92;66;2.0
19;1;342;345;3;66;2.0
19;2;345;346;1;66;2.0
19;3;346;357;11;66;2.0
19;4;357;359;2;66;2.0
19;5;359;365;6;66;2.0
19;6;365;369;4;66;2.0
19;7;369;372;3;66;2.0
19;8;372;377;5;66;2.0
19;9;377;378;1;66;2.0
19;10;378;380;2;66;2.0
19;11;380;392;12;66;2.0
19;12;392;397;5;66;2.0
19;13;397;399;2;66;2.0
19;14;399;400;1;66;2.0
19;15;400;402;2;66;2.0
19;16;402;403;1;66;2.0
19;17;403;407;4;66;2.0
19;18;407;408;1;66;2.0
19;19;408;414;6;66;2.0
19;20;414;415;1;66;2.0
19;21;415;416;1;66;2.0
19;22;416;417;1;66;2.0
19;23;417;420;3;66;2.0
19;24;420;427;7;66;2.0
19;25;427;428;1;66;2.0
19;26;428;429;1;66;2.0
19;27;429;430;1;66;2.0
19;28;430;432;2;66;2.0
19;29;432;435;3;66;2.0
19;30;435;437;2;66;2.0
19;31;437;439;2;66;2.0
19;32;439;447;8;66;2.0
19;33;447;450;3;66;2.0
19;34;450;458;8;66;2.0
19;35;458;460;2;66;2.0
19;36;460;462;2;66;2.0
19;37;462;463;1;66;2.0
19;38;463;470;7;66;2.0
19;39;470;473;3;66;2.0
19;40;473;477;4;66;2.0
19;41;477;479;2;66;2.0
19;42;479;483;4;66;2.0
19;43;483;489;6;66;2.0
19;44;489;492;3;66;2.0
19;45;492;494;2;66;2.0
19;46;494;504;10;66;2.0
19;47;504;505;1;66;2.0
19;48;505;507;2;66;2.0
19;49;507;514;7;66;2.0
19;50;514;517;3;66;2.0
19;51;517;523;6;66;2.0
19;52;523;525;2;66;2.0
19;53;525;529;4;66;2.0
19;54;529;535;6;66;2.0
19;55;535;542;7;66;2.0
19;56;542;547;5;66;2.0
19;57;547;553;6;66;2.0
19;58;553;559;6;66;2.0
19;59;559;560;1;66;2.0
19;60;560;562;2;66;2.0
19;61;562;565;3;66;2.0
19;62;565;590;25;66;2.0
19;63;590;597;7;66;2.0
19;64;597;599;2;66;2.0
19;65;599;600;1;66;2.0
19;66;600;602;2;66;2.0
19;67;602;603;1;66;2.0
19;68;603;634;31;66;2.0
19;69;634;637;3;66;2.0
19;70;637;640;3;66;2.0
19;71;640;645;5;66;2.0
19;72;645;667;22;66;2.0
19;73;667;669;2;66;2.0
19;74;669;682;13;66;2.0
19;75;682;685;3;66;2.0
19;76;685;704;19;66;2.0
19;77;704;707;3;66;2.0
19;78;707;710;3;66;2.0
19;79;710;728;18;66;2.0
19;80;728;730;2;66;2.0
19;81;730;732;2;66;2.0
19;82;732;737;5;66;2.0
19;83;737;739;2;66;2.0
19;84;739;757;18;66;2.0
19;85;757;758;1;66;2.0
19;86;758;770;12;66;2.0
19;87;770;775;5;66;2.0
19;88;775;777;2;66;2.0
19;89;777;779;2;66;2.0
19;90;779;787;8;66;2.0
19;91;787;788;1;66;2.0
19;92;788;794;6;66;2.0
19;93;794;799;5;66;2.0
19;94;799;805;6;66;2.0
19;95;805;808;3;66;2.0
19;96;808;817;9;66;2.0
19;97;817;824;7;66;2.0
19;98;824;828;4;66;2.0
19;99;828;829;1;66;2.0
19;100;829;830;1;66;2.0
19;101;830;832;2;66;2.0
19;102;832;843;11;66;2.0
19;103;843;844;1;66;2.0
19;104;844;849;5;66;2.0
19;105;849;855;6;66;2.0
19;106;855;859;4;66;2.0
19;107;859;864;5;66;2.0
19;108;864;867;3;66;2.0
19;109;867;872;5;66;2.0
19;110;872;874;2;66;2.0
19;111;874;875;1;66;2.0
19;112;875;881;6;66;2.0
19;113;881;882;1;66;2.0
19;114;882;890;8;66;2.0
19;115;890;894;4;66;2.0
19;116;894;897;3;66;2.0
19;117;897;898;1;66;2.0
19;118;898;899;1;66;2.0
19;119;899;907;8;66;2.0
19;120;907;910;3;66;2.0
19;121;910;913;3;66;2.0
19;122;913;914;1;66;2.0
19;123;914;919;5;66;2.0
19;124;919;924;5;66;2.0
19;125;924;925;1;66;2.0
19;126;925;929;4;66;2.0
19;127;929;935;6;66;2.0
19;128;935;937;2;66;2.0
19;129;937;942;5;66;2.0
19;130;942;948;6;66;2.0
19;131;948;949;1;66;2.0
19;132;949;950;1;66;2.0
19;133;950;952;2;66;2.0
19;134;952;959;7;66;2.0
19;135;959;965;6;66;2.0
19;136;965;967;2;66;2.0
19;137;967;968;1;66;2.0
19;138;968;969;1;66;2.0
19;139;969;976;7;66;2.0
19;140;976;979;3;66;2.0
19;141;979;985;6;66;2.0
19;142;985;987;2;66;2.0
19;143;987;988;1;66;2.0
19;144;988;989;1;66;2.0
19;145;989;991;2;66;2.0
19;146;991;1003;12;66;2.0
19;147;1003;1005;2;66;2.0
19;148;1005;1009;4;66;2.0
19;149;1009;1012;3;66;2.0
19;150;1012;1014;2;66;2.0
19;151;1014;1024;10;66;2.0
19;152;1024;1025;1;66;2.0
19;153;1025;1029;4;66;2.0
19;154;1029;1032;3;66;2.0
19;155;1032;1035;3;66;2.0
19;156;1035;1044;9;66;2.0
19;157;1044;1053;9;66;2.0
19;158;1053;1055;2;66;2.0
19;159;1055;1056;1;66;2.0
19;160;1056;1067;11;66;2.0
19;161;1067;1069;2;66;2.0
19;162;1069;1075;6;66;2.0
19;163;1075;1086;11;66;2.0
19;164;1086;1087;1;66;2.0
19;165;1087;1089;2;66;2.0
19;166;1089;1093;4;66;2.0
19;167;1093;1094;1;66;2.0
19;168;1094;1095;1;66;2.0
19;169;1095;1097;2;66;2.0
19;170;1097;1106;9;66;2.0
19;171;1106;1108;2;66;2.0
19;172;1108;1111;3;66;2.0
19;173;1111;1113;2;66;2.0
19;174;1113;1121;8;66;2.0
19;175;1121;1123;2;66;2.0
19;176;1123;1133;10;66;2.0
19;177;1133;1145;12;66;2.0
19;178;1145;1148;3;66;2.0
19;179;1148;1153;5;66;2.0
19;180;1153;1154;1;66;2.0
19;181;1154;1162;8;66;2.0
19;182;1162;1181;19;66;2.0
19;183;1181;1183;2;66;2.0
19;184;1183;1185;2;66;2.0
19;185;1185;1193;8;66;2.0
19;186;1193;1211;18;66;2.0
19;187;1211;1214;3;66;2.0
19;188;1214;1215;1;66;2.0
19;189;1215;1220;5;66;2.0
19;190;1220;1231;11;66;2.0
19;191;1231;1243;12;66;2.0
19;192;1243;1268;25;66;2.0
19;193;1268;1273;5;66;2.0
19;194;1273;1274;1;66;2.0
19;195;1274;1280;6;66;2.0
19;196;1280;1291;11;66;2.0
19;197;1291;1303;12;66;2.0
19;198;1303;1308;5;66;2.0
19;199;1308;1324;16;66;2.0
19;200;1324;1333;9;66;2.0
19;201;1333;1334;1;66;2.0
19;202;1334;1348;14;66;2.0
19;203;1348;1352;4;66;2.0
19;204;1352;1369;17;66;2.0
19;205;1369;1372;3;66;2.0
19;206;1372;1373;1;66;2.0
19;207;1373;1375;2;66;2.0
19;208;1375;1385;10;66;2.0
19;209;1385;1388;3;66;2.0
19;210;1388;1389;1;66;2.0
19;211;1389;1396;7;66;2.0
19;212;1396;1411;15;66;2.0
19;213;1411;1426;15;66;2.0
19;214;1426;1441;15;66;2.0
19;215;1441;1456;15;66;2.0
19;216;1456;1471;15;66;2.0
19;217;1471;1486;15;66;2.0
19;218;1486;1501;15;66;2.0
19;219;1501;1516;15;66;2.0
19;220;1516;1531;15;66;2.0
19;221;1531;1546;15;66;2.0
19;222;1546;1561;15;66;2.0
19;223;1561;1576;15;66;2.0
19;224;1576;1591;15;66;2.0
19;225;1591;1606;15;66;2.0
19;226;1606;1621;15;66;2.0
19;227;1621;1636;15;66;2.0
19;228;1636;1651;15;66;2.0
19;229;1651;1666;15;66;2.0
19;230;1666;1680;14;66;2.0
20;0;252;344;92;63;2.0
20;1;344;347;3;63;2.0
20;2;347;348;1;63;2.0
20;3;348;359;11;63;2.0
20;4;359;361;2;63;2.0
20;5;361;367;6;63;2.0
20;6;367;371;4;63;2.0
20;7;371;374;3;63;2.0
20;8;374;379;5;63;2.0
20;9;379;380;1;63;2.0
20;10;380;382;2;63;2.0
20;11;382;394;12;63;2.0
20;12;394;399;5;63;2.0
20;13;399;401;2;63;2.0
20;14;401;402;1;63;2.0
20;15;402;404;2;63;2.0
20;16;404;405;1;63;2.0
20;17;405;409;4;63;2.0
20;18;409;410;1;63;2.0
20;19;410;416;6;63;2.0
20;20;416;417;1;63;2.0
20;21;417;418;1;63;2.0
20;22;418;419;1;63;2.0
20;23;419;422;3;63;2.0
20;24;422;429;7;63;2.0
20;25;429;430;1;63;2.0
20;26;430;431;1;63;2.0
20;27;431;432;1;63;2.0
20;28;432;434;2;63;2.0
20;29;434;437;3;63;2.0
20;30;437;439;2;63;2.0
20;31;439;441;2;63;2.0
20;32;441;449;8;63;2.0
20;33;449;452;3;63;2.0
20;34;452;460;8;63;2.0
20;35;460;462;2;63;2.0
20;36;462;464;2;63;2.0
20;37;464;465;1;63;2.0
20;38;465;472;7;63;2.0
20;39;472;475;3;63;2.0
20;40;475;479;4;63;2.0
20;41;479;481;2;63;2.0
20;42;481;485;4;63;2.0
20;43;485;491;6;63;2.0
20;44;491;494;3;63;2.0
20;45;494;496;2;63;2.0
20;46;496;506;10;63;2.0
20;47;506;507;1;63;2.0
20;48;507;509;2;63;2.0
20;49;509;516;7;63;2.0
20;50;516;519;3;63;2.0
20;51;519;525;6;63;2.0
20;52;525;527;2;63;2.0
20;53;527;531;4;63;2.0
20;54;531;537;6;63;2.0
20;55;537;544;7;63;2.0
20;56;544;549;5;63;2.0
20;57;549;555;6;63;2.0
20;58;555;561;6;63;2.0
20;59;561;562;1;63;2.0
20;60;562;564;2;63;2.0
20;61;564;567;3;63;2.0
20;62;567;592;25;63;2.0
20;63;592;599;7;63;2.0
20;64;599;601;2;63;2.0
20;65;601;602;1;63;2.0
20;66;602;604;2;63;2.0
20;67;604;605;1;63;2.0
20;68;605;636;31;63;2.0
20;69;636;639;3;63;2.0
20;70;639;642;3;63;2.0
20;71;642;647;5;63;2.0
20;72;647;669;22;63;2.0
20;73;669;671;2;63;2.0
20;74;671;684;13;63;2.0
20;75;684;687;3;63;2.0
20;76;687;706;19;63;2.0
20;77;706;709;3;63;2.0
20;78;709;712;3;63;2.0
20;79;712;730;18;63;2.0
20;80;730;732;2;63;2.0
20;81;732;734;2;63;2.0
20;82;734;739;5;63;2.0
20;83;739;741;2;63;2.0
20;84;741;759;18;63;2.0
20;85;759;760;1;63;2.0
20;86;760;772;12;63;2.0
20;87;772;777;5;63;2.0
20;88;777;779;2;63;2.0
20;89;779;781;2;63;2.0
20;90;781;789;8;63;2.0
20;91;789;790;1;63;2.0
20;92;790;796;6;63;2.0
20;93;796;801;5;63;2.0
20;94;801;807;6;63;2.0
20;95;807;810;3;63;2.0
20;96;810;819;9;63;2.0
20;97;819;826;7;63;2.0
20;98;826;830;4;63;2.0
20;99;830;831;1;63;2.0
20;100;831;832;1;63;2.0
20;101;832;834;2;63;2.0
20;102;834;845;11;63;2.0
20;103;845;846;1;63;2.0
20;104;846;851;5;63;2.0
20;105;851;857;6;63;2.0
20;106;857;861;4;63;2.0
20;107;861;866;5;63;2.0
20;108;866;869;3;63;2.0
20;109;869;874;5;63;2.0
20;110;874;876;2;63;2.0
20;111;876;877;1;63;2.0
20;112;877;883;6;63;2.0
20;113;883;884;1;63;2.0
20;114;884;892;8;63;2.0
20;115;892;896;4;63;2.0
20;116;896;899;3;63;2.0
20;117;899;900;1;63;2.0
20;118;900;901;1;63;2.0
20;119;901;909;8;63;2.0
20;120;909;912;3;63;2.0
20;121;912;915;3;63;2.0
20;122;915;916;1;63;2.0
20;123;916;921;5;63;2.0
20;124;921;926;5;63;2.0
20;125;926;927;1;63;2.0
20;126;927;931;4;63;2.0
20;127;931;937;6;63;2.0
20;128;937;939;2;63;2.0
20;129;939;944;5;63;2.0
20;130;944;950;6;63;2.0
20;131;950;951;1;63;2.0
20;132;951;952;1;63;2.0
20;133;952;954;2;63;2.0
20;134;954;961;7;63;2.0
20;135;961;967;6;63;2.0
20;136;967;969;2;63;2.0
20;137;969;970;1;63;2.0
20;138;970;971;1;63;2.0
20;139;971;978;7;63;2.0
20;140;978;981;3;63;2.0
20;141;981;987;6;63;2.0
20;142;987;989;2;63;2.0
20;143;989;990;1;63;2.0
20;144;990;991;1;63;2.0
20;145;991;993;2;63;2.0
20;146;993;1005;12;63;2.0
20;147;1005;1007;2;63;2.0
20;148;1007;1011;4;63;2.0
20;149;1011;1014;3;63;2.0
20;150;1014;1016;2;63;2.0
20;151;1016;1026;10;63;2.0
20;152;1026;1027;1;63;2.0
20;153;1027;1031;4;63;2.0
20;154;1031;1034;3;63;2.0
20;155;1034;1037;3;63;2.0
20;156;1037;1046;9;63;2.0
20;157;1046;1055;9;63;2.0
20;158;1055;1057;2;63;2.0
20;159;1057;1058;1;63;2.0
20;160;1058;1069;11;63;2.0
20;161;1069;1071;2;63;2.0
20;162;1071;1077;6;63;2.0
20;163;1077;1088;11;63;2.0
20;164;1088;1089;1;63;2.0
20;165;1089;1091;2;63;2.0
20;166;1091;1095;4;63;2.0
20;167;1095;1096;1;63;2.0
20;168;1096;1097;1;63;2.0
20;169;1097;1099;2;63;2.0
20;170;1099;1108;9;63;2.0
20;171;1108;1110;2;63;2.0
20;172;1110;1113;3;63;2.0
20;173;1113;1115;2;63;2.0
20;174;1115;1123;8;63;2.0
20;175;1123;1125;2;63;2.0
20;176;1125;1135;10;63;2.0
20;177;1135;1147;12;63;2.0
20;178;1147;1150;3;63;2.0
20;179;1150;1155;5;63;2.0
20;180;1155;1156;1;63;2.0
20;181;1156;1164;8;63;2.0
20;182;1164;1183;19;63;2.0
20;183;1183;1185;2;63;2.0
20;184;1185;1187;2;63;2.0
20;185;1187;1195;8;63;2.0
20;186;1195;1213;18;63;2.0
20;187;1213;1216;3;63;2.0
20;188;1216;1217;1;63;2.0
20;189;1217;1222;5;63;2.0
20;190;1222;1233;11;63;2.0
20;191;1233;1245;12;63;2.0
20;192;1245;1270;25;63;2.0
20;193;1270;1275;5;63;2.0
20;194;1275;1276;1;63;2.0
20;195;1276;1282;6;63;2.0
20;196;1282;1293;11;63;2.0
20;197;1293;1305;12;63;2.0
20;198;1305;1310;5;63;2.0
20;199;1310;1326;16;63;2.0
20;200;1326;1335;9;63;2.0
20;201;1335;1336;1;63;2.0
20;202;1336;1350;14;63;2.0
20;203;1350;1354;4;63;2.0
20;204;1354;1371;17;63;2.0
20;205;1371;1374;3;63;2.0
20;206;1374;1375;1;63;2.0
20;207;1375;1377;2;63;2.0
20;208;1377;1387;10;63;2.0
20;209;1387;1390;3;63;2.0
20;210;1390;1391;1;63;2.0
20;211;1391;1398;7;63;2.0
20;212;1398;1413;15;63;2.0
20;213;1413;1428;15;63;2.0
20;214;1428;1443;15;63;2.0
20;215;1443;1458;15;63;2.0
20;216;1458;1473;15;63;2.0
20;217;1473;1488;15;63;2.0
20;218;1488;1503;15;63;2.0
20;219;1503;1518;15;63;2.0
20;220;1518;1533;15;63;2.0
20;221;1533;1548;15;63;2.0
20;222;1548;1563;15;63;2.0
20;223;1563;1578;15;63;2.0
20;224;1578;1593;15;63;2.0
20;225;1593;1608;15;63;2.0
20;226;1608;1623;15;63;2.0
20;227;1623;1638;15;63;2.0
20;228;1638;1653;15;63;2.0
20;229;1653;1680;27;63;2.0
21;0;249;329;80;114;2.0
21;1;329;332;3;114;2.0
21;2;332;336;4;114;2.0
21;3;336;337;1;114;2.0
21;4;337;338;1;114;2.0
21;5;338;342;4;114;2.0
21;6;342;344;2;114;2.0
21;7;344;347;3;114;2.0
21;8;347;348;1;114;2.0
21;9;348;352;4;114;2.0
21;10;352;359;7;114;2.0
21;11;359;362;3;114;2.0
21;12;362;363;1;114;2.0
21;13;363;368;5;114;2.0
21;14;368;371;3;114;2.0
21;15;371;377;6;114;2.0
21;16;377;379;2;114;2.0
21;17;379;388;9;114;2.0
21;18;388;392;4;114;2.0
21;19;392;394;2;114;2.0
21;20;394;397;3;114;2.0
21;21;397;399;2;114;2.0
21;22;399;407;8;114;2.0
21;23;407;411;4;114;2.0
21;24;411;412;1;114;2.0
21;25;412;414;2;114;2.0
21;26;414;421;7;114;2.0
21;27;421;422;1;114;2.0
21;28;422;428;6;114;2.0
21;29;428;432;4;114;2.0
21;30;432;437;5;114;2.0
21;31;437;438;1;114;2.0
21;32;438;447;9;114;2.0
21;33;447;449;2;114;2.0
21;34;449;451;2;114;2.0
21;35;451;452;1;114;2.0
21;36;452;453;1;114;2.0
21;37;453;456;3;114;2.0
21;38;456;457;1;114;2.0
21;39;457;466;9;114;2.0
21;40;466;467;1;114;2.0
21;41;467;468;1;114;2.0
21;42;468;472;4;114;2.0
21;43;472;476;4;114;2.0
21;44;476;482;6;114;2.0
21;45;482;483;1;114;2.0
21;46;483;485;2;114;2.0
21;47;485;487;2;114;2.0
21;48;487;497;10;114;2.0
21;49;497;502;5;114;2.0
21;50;502;507;5;114;2.0
21;51;507;508;1;114;2.0
21;52;508;516;8;114;2.0
21;53;516;522;6;114;2.0
21;54;522;529;7;114;2.0
21;55;529;530;1;114;2.0
21;56;530;532;2;114;2.0
21;57;532;540;8;114;2.0
21;58;540;546;6;114;2.0
21;59;546;548;2;114;2.0
21;60;548;552;4;114;2.0
21;61;552;553;1;114;2.0
21;62;553;556;3;114;2.0
21;63;556;587;31;114;2.0
21;64;587;588;1;114;2.0
21;65;588;591;3;114;2.0
21;66;591;592;1;114;2.0
21;67;592;596;4;114;2.0
21;68;596;627;31;114;2.0
21;69;627;628;1;114;2.0
21;70;628;636;8;114;2.0
21;71;636;637;1;114;2.0
21;72;637;654;17;114;2.0
21;73;654;658;4;114;2.0
21;74;658;662;4;114;2.0
21;75;662;672;10;114;2.0
21;76;672;676;4;114;2.0
21;77;676;697;21;114;2.0
21;78;697;698;1;114;2.0
21;79;698;707;9;114;2.0
21;80;707;721;14;114;2.0
21;81;721;722;1;114;2.0
21;82;722;728;6;114;2.0
21;83;728;732;4;114;2.0
21;84;732;744;12;114;2.0
21;85;744;753;9;114;2.0
21;86;753;766;13;114;2.0
21;87;766;767;1;114;2.0
21;88;767;772;5;114;2.0
21;89;772;778;6;114;2.0
21;90;778;781;3;114;2.0
21;91;781;787;6;114;2.0
21;92;787;792;5;114;2.0
21;93;792;802;10;114;2.0
21;94;802;803;1;114;2.0
21;95;803;807;4;114;2.0
21;96;807;808;1;114;2.0
21;97;808;817;9;114;2.0
21;98;817;819;2;114;2.0
21;99;819;822;3;114;2.0
21;100;822;823;1;114;2.0
21;101;823;827;4;114;2.0
21;102;827;835;8;114;2.0
21;103;835;836;1;114;2.0
21;104;836;840;4;114;2.0
21;105;840;842;2;114;2.0
21;106;842;852;10;114;2.0
21;107;852;855;3;114;2.0
21;108;855;858;3;114;2.0
21;109;858;862;4;114;2.0
21;110;862;867;5;114;2.0
21;111;867;869;2;114;2.0
21;112;869;872;3;114;2.0
21;113;872;884;12;114;2.0
21;114;884;887;3;114;2.0
21;115;887;888;1;114;2.0
21;116;888;890;2;114;2.0
21;117;890;891;1;114;2.0
21;118;891;892;1;114;2.0
21;119;892;898;6;114;2.0
21;120;898;906;8;114;2.0
21;121;906;907;1;114;2.0
21;122;907;910;3;114;2.0
21;123;910;915;5;114;2.0
21;124;915;919;4;114;2.0
21;125;919;922;3;114;2.0
21;126;922;928;6;114;2.0
21;127;928;929;1;114;2.0
21;128;929;930;1;114;2.0
21;129;930;939;9;114;2.0
21;130;939;941;2;114;2.0
21;131;941;942;1;114;2.0
21;132;942;943;1;114;2.0
21;133;943;947;4;114;2.0
21;134;947;950;3;114;2.0
21;135;950;958;8;114;2.0
21;136;958;961;3;114;2.0
21;137;961;962;1;114;2.0
21;138;962;969;7;114;2.0
21;139;969;970;1;114;2.0
21;140;970;978;8;114;2.0
21;141;978;981;3;114;2.0
21;142;981;982;1;114;2.0
21;143;982;984;2;114;2.0
21;144;984;996;12;114;2.0
21;145;996;1002;6;114;2.0
21;146;1002;1003;1;114;2.0
21;147;1003;1004;1;114;2.0
21;148;1004;1017;13;114;2.0
21;149;1017;1019;2;114;2.0
21;150;1019;1020;1;114;2.0
21;151;1020;1022;2;114;2.0
21;152;1022;1026;4;114;2.0
21;153;1026;1032;6;114;2.0
21;154;1032;1034;2;114;2.0
21;155;1034;1035;1;114;2.0
21;156;1035;1046;11;114;2.0
21;157;1046;1047;1;114;2.0
21;158;1047;1050;3;114;2.0
21;159;1050;1052;2;114;2.0
21;160;1052;1058;6;114;2.0
21;161;1058;1059;1;114;2.0
21;162;1059;1062;3;114;2.0
21;163;1062;1072;10;114;2.0
21;164;1072;1074;2;114;2.0
21;165;1074;1081;7;114;2.0
21;166;1081;1082;1;114;2.0
21;167;1082;1084;2;114;2.0
21;168;1084;1086;2;114;2.0
21;169;1086;1088;2;114;2.0
21;170;1088;1092;4;114;2.0
21;171;1092;1097;5;114;2.0
21;172;1097;1101;4;114;2.0
21;173;1101;1104;3;114;2.0
21;174;1104;1108;4;114;2.0
21;175;1108;1109;1;114;2.0
21;176;1109;1114;5;114;2.0
21;177;1114;1124;10;114;2.0
21;178;1124;1138;14;114;2.0
21;179;1138;1144;6;114;2.0
21;180;1144;1151;7;114;2.0
21;181;1151;1155;4;114;2.0
21;182;1155;1174;19;114;2.0
21;183;1174;1178;4;114;2.0
21;184;1178;1184;6;114;2.0
21;185;1184;1199;15;114;2.0
21;186;1199;1210;11;114;2.0
21;187;1210;1211;1;114;2.0
21;188;1211;1213;2;114;2.0
21;189;1213;1224;11;114;2.0
21;190;1224;1234;10;114;2.0
21;191;1234;1259;25;114;2.0
21;192;1259;1263;4;114;2.0
21;193;1263;1268;5;114;2.0
21;194;1268;1271;3;114;2.0
21;195;1271;1273;2;114;2.0
21;196;1273;1284;11;114;2.0
21;197;1284;1294;10;114;2.0
21;198;1294;1299;5;114;2.0
21;199;1299;1321;22;114;2.0
21;200;1321;1323;2;114;2.0
21;201;1323;1327;4;114;2.0
21;202;1327;1335;8;114;2.0
21;203;1335;1343;8;114;2.0
21;204;1343;1360;17;114;2.0
21;205;1360;1363;3;114;2.0
21;206;1363;1366;3;114;2.0
21;207;1366;1370;4;114;2.0
21;208;1370;1378;8;114;2.0
21;209;1378;1384;6;114;2.0
21;210;1384;1385;1;114;2.0
21;211;1385;1389;4;114;2.0
21;212;1389;1404;15;114;2.0
21;213;1404;1419;15;114;2.0
21;214;1419;1434;15;114;2.0
21;215;1434;1449;15;114;2.0
21;216;1449;1464;15;114;2.0
21;217;1464;1479;15;114;2.0
21;218;1479;1494;15;114;2.0
21;219;1494;1509;15;114;2.0
21;220;1509;1524;15;114;2.0
21;221;1524;1539;15;114;2.0
21;222;1539;1554;15;114;2.0
21;223;1554;1569;15;114;2.0
21;224;1569;1584;15;114;2.0
21;225;1584;1599;15;114;2.0
21;226;1599;1614;15;114;2.0
21;227;1614;1629;15;114;2.0
21;228;1629;1644;15;114;2.0
21;229;1644;1659;15;114;2.0
21;230;1659;1680;21;114;2.0
22;0;243;333;90;42;2.0
22;1;333;334;1;42;2.0
22;2;334;337;3;42;2.0
22;3;337;339;2;42;2.0
22;4;339;345;6;42;2.0
22;5;345;348;3;42;2.0
22;6;348;349;1;42;2.0
22;7;349;351;2;42;2.0
22;8;351;359;8;42;2.0
22;9;359;360;1;42;2.0
22;10;360;361;1;42;2.0
22;11;361;363;2;42;2.0
22;12;363;364;1;42;2.0
22;13;364;365;1;42;2.0
22;14;365;370;5;42;2.0
22;15;370;374;4;42;2.0
22;16;374;383;9;42;2.0
22;17;383;385;2;42;2.0
22;18;385;391;6;42;2.0
22;19;391;394;3;42;2.0
22;20;394;396;2;42;2.0
22;21;396;398;2;42;2.0
22;22;398;404;6;42;2.0
22;23;404;406;2;42;2.0
22;24;406;408;2;42;2.0
22;25;408;409;1;42;2.0
22;26;409;417;8;42;2.0
22;27;417;418;1;42;2.0
22;28;418;421;3;42;2.0
22;29;421;424;3;42;2.0
22;30;424;425;1;42;2.0
22;31;425;429;4;42;2.0
22;32;429;431;2;42;2.0
22;33;431;435;4;42;2.0
22;34;435;439;4;42;2.0
22;35;439;444;5;42;2.0
22;36;444;450;6;42;2.0
22;37;450;452;2;42;2.0
22;38;452;453;1;42;2.0
22;39;453;454;1;42;2.0
22;40;454;462;8;42;2.0
22;41;462;464;2;42;2.0
22;42;464;465;1;42;2.0
22;43;465;466;1;42;2.0
22;44;466;469;3;42;2.0
22;45;469;471;2;42;2.0
22;46;471;472;1;42;2.0
22;47;472;480;8;42;2.0
22;48;480;481;1;42;2.0
22;49;481;484;3;42;2.0
22;50;484;486;2;42;2.0
22;51;486;493;7;42;2.0
22;52;493;499;6;42;2.0
22;53;499;503;4;42;2.0
22;54;503;505;2;42;2.0
22;55;505;512;7;42;2.0
22;56;512;514;2;42;2.0
22;57;514;521;7;42;2.0
22;58;521;524;3;42;2.0
22;59;524;529;5;42;2.0
22;60;529;533;4;42;2.0
22;61;533;536;3;42;2.0
22;62;536;542;6;42;2.0
22;63;542;548;6;42;2.0
22;64;548;550;2;42;2.0
22;65;550;554;4;42;2.0
22;66;554;584;30;42;2.0
22;67;584;585;1;42;2.0
22;68;585;589;4;42;2.0
22;69;589;591;2;42;2.0
22;70;591;592;1;42;2.0
22;71;592;594;2;42;2.0
22;72;594;625;31;42;2.0
22;73;625;626;1;42;2.0
22;74;626;630;4;42;2.0
22;75;630;634;4;42;2.0
22;76;634;655;21;42;2.0
22;77;655;658;3;42;2.0
22;78;658;661;3;42;2.0
22;79;661;674;13;42;2.0
22;80;674;695;21;42;2.0
22;81;695;696;1;42;2.0
22;82;696;704;8;42;2.0
22;83;704;717;13;42;2.0
22;84;717;719;2;42;2.0
22;85;719;724;5;42;2.0
22;86;724;725;1;42;2.0
22;87;725;731;6;42;2.0
22;88;731;747;16;42;2.0
22;89;747;748;1;42;2.0
22;90;748;764;16;42;2.0
22;91;764;769;5;42;2.0
22;92;769;771;2;42;2.0
22;93;771;775;4;42;2.0
22;94;775;777;2;42;2.0
22;95;777;783;6;42;2.0
22;96;783;791;8;42;2.0
22;97;791;797;6;42;2.0
22;98;797;799;2;42;2.0
22;99;799;805;6;42;2.0
22;100;805;809;4;42;2.0
22;101;809;813;4;42;2.0
22;102;813;817;4;42;2.0
22;103;817;821;4;42;2.0
22;104;821;823;2;42;2.0
22;105;823;824;1;42;2.0
22;106;824;832;8;42;2.0
22;107;832;837;5;42;2.0
22;108;837;841;4;42;2.0
22;109;841;849;8;42;2.0
22;110;849;851;2;42;2.0
22;111;851;852;1;42;2.0
22;112;852;855;3;42;2.0
22;113;855;864;9;42;2.0
22;114;864;866;2;42;2.0
22;115;866;869;3;42;2.0
22;116;869;873;4;42;2.0
22;117;873;874;1;42;2.0
22;118;874;884;10;42;2.0
22;119;884;885;1;42;2.0
22;120;885;886;1;42;2.0
22;121;886;887;1;42;2.0
22;122;887;891;4;42;2.0
22;123;891;895;4;42;2.0
22;124;895;902;7;42;2.0
22;125;902;904;2;42;2.0
22;126;904;906;2;42;2.0
22;127;906;907;1;42;2.0
22;128;907;912;5;42;2.0
22;129;912;919;7;42;2.0
22;130;919;921;2;42;2.0
22;131;921;924;3;42;2.0
22;132;924;925;1;42;2.0
22;133;925;933;8;42;2.0
22;134;933;937;4;42;2.0
22;135;937;940;3;42;2.0
22;136;940;941;1;42;2.0
22;137;941;944;3;42;2.0
22;138;944;947;3;42;2.0
22;139;947;955;8;42;2.0
22;140;955;957;2;42;2.0
22;141;957;959;2;42;2.0
22;142;959;961;2;42;2.0
22;143;961;965;4;42;2.0
22;144;965;967;2;42;2.0
22;145;967;975;8;42;2.0
22;146;975;977;2;42;2.0
22;147;977;979;2;42;2.0
22;148;979;980;1;42;2.0
22;149;980;981;1;42;2.0
22;150;981;992;11;42;2.0
22;151;992;999;7;42;2.0
22;152;999;1000;1;42;2.0
22;153;1000;1001;1;42;2.0
22;154;1001;1006;5;42;2.0
22;155;1006;1013;7;42;2.0
22;156;1013;1014;1;42;2.0
22;157;1014;1021;7;42;2.0
22;158;1021;1023;2;42;2.0
22;159;1023;1029;6;42;2.0
22;160;1029;1032;3;42;2.0
22;161;1032;1036;4;42;2.0
22;162;1036;1042;6;42;2.0
22;163;1042;1044;2;42;2.0
22;164;1044;1049;5;42;2.0
22;165;1049;1056;7;42;2.0
22;166;1056;1061;5;42;2.0
22;167;1061;1069;8;42;2.0
22;168;1069;1075;6;42;2.0
22;169;1075;1078;3;42;2.0
22;170;1078;1081;3;42;2.0
22;171;1081;1082;1;42;2.0
22;172;1082;1086;4;42;2.0
22;173;1086;1089;3;42;2.0
22;174;1089;1094;5;42;2.0
22;175;1094;1097;3;42;2.0
22;176;1097;1100;3;42;2.0
22;177;1100;1102;2;42;2.0
22;178;1102;1111;9;42;2.0
22;179;1111;1112;1;42;2.0
22;180;1112;1121;9;42;2.0
22;181;1121;1137;16;42;2.0
22;182;1137;1140;3;42;2.0
22;183;1140;1142;2;42;2.0
22;184;1142;1148;6;42;2.0
22;185;1148;1151;3;42;2.0
22;186;1151;1170;19;42;2.0
22;187;1170;1172;2;42;2.0
22;188;1172;1177;5;42;2.0
22;189;1177;1181;4;42;2.0
22;190;1181;1201;20;42;2.0
22;191;1201;1204;3;42;2.0
22;192;1204;1208;4;42;2.0
22;193;1208;1212;4;42;2.0
22;194;1212;1220;8;42;2.0
22;195;1220;1232;12;42;2.0
22;196;1232;1256;24;42;2.0
22;197;1256;1262;6;42;2.0
22;198;1262;1265;3;42;2.0
22;199;1265;1268;3;42;2.0
22;200;1268;1272;4;42;2.0
22;201;1272;1280;8;42;2.0
22;202;1280;1292;12;42;2.0
22;203;1292;1296;4;42;2.0
22;204;1296;1318;22;42;2.0
22;205;1318;1325;7;42;2.0
22;206;1325;1326;1;42;2.0
22;207;1326;1339;13;42;2.0
22;208;1339;1340;1;42;2.0
22;209;1340;1358;18;42;2.0
22;210;1358;1360;2;42;2.0
22;211;1360;1362;2;42;2.0
22;212;1362;1364;2;42;2.0
22;213;1364;1377;13;42;2.0
22;214;1377;1378;1;42;2.0
22;215;1378;1382;4;42;2.0
22;216;1382;1385;3;42;2.0
22;217;1385;1400;15;42;2.0
22;218;1400;1415;15;42;2.0
22;219;1415;1430;15;42;2.0
22;220;1430;1445;15;42;2.0
22;221;1445;1460;15;42;2.0
22;222;1460;1475;15;42;2.0
22;223;1475;1490;15;42;2.0
22;224;1490;1505;15;42;2.0
22;225;1505;1520;15;42;2.0
22;226;1520;1535;15;42;2.0
22;227;1535;1550;15;42;2.0
22;228;1550;1565;15;42;2.0
22;229;1565;1580;15;42;2.0
22;230;1580;1595;15;42;2.0
22;231;1595;1610;15;42;2.0
22;232;1610;1625;15;42;2.0
22;233;1625;1640;15;42;2.0
22;234;1640;1655;15;42;2.0
22;235;1655;1670;15;42;2.0
22;236;1670;1680;10;42;2.0
23;0;245;332;87;25;2.0
23;1;332;333;1;25;2.0
23;2;333;334;1;25;2.0
23;3;334;337;3;25;2.0
23;4;337;339;2;25;2.0
23;5;339;345;6;25;2.0
23;6;345;347;2;25;2.0
23;7;347;348;1;25;2.0
23;8;348;351;3;25;2.0
23;9;351;359;8;25;2.0
23;10;359;360;1;25;2.0
23;11;360;361;1;25;2.0
23;12;361;362;1;25;2.0
23;13;362;363;1;25;2.0
23;14;363;365;2;25;2.0
23;15;365;370;5;25;2.0
23;16;370;374;4;25;2.0
23;17;374;382;8;25;2.0
23;18;382;385;3;25;2.0
23;19;385;391;6;25;2.0
23;20;391;393;2;25;2.0
23;21;393;394;1;25;2.0
23;22;394;396;2;25;2.0
23;23;396;397;1;25;2.0
23;24;397;404;7;25;2.0
23;25;404;406;2;25;2.0
23;26;406;408;2;25;2.0
23;27;408;409;1;25;2.0
23;28;409;416;7;25;2.0
23;29;416;417;1;25;2.0
23;30;417;418;1;25;2.0
23;31;418;421;3;25;2.0
23;32;421;423;2;25;2.0
23;33;423;425;2;25;2.0
23;34;425;429;4;25;2.0
23;35;429;431;2;25;2.0
23;36;431;435;4;25;2.0
23;37;435;438;3;25;2.0
23;38;438;444;6;25;2.0
23;39;444;450;6;25;2.0
23;40;450;451;1;25;2.0
23;41;451;452;1;25;2.0
23;42;452;453;1;25;2.0
23;43;453;454;1;25;2.0
23;44;454;461;7;25;2.0
23;45;461;464;3;25;2.0
23;46;464;465;1;25;2.0
23;47;465;467;2;25;2.0
23;48;467;468;1;25;2.0
23;49;468;471;3;25;2.0
23;50;471;480;9;25;2.0
23;51;480;481;1;25;2.0
23;52;481;483;2;25;2.0
23;53;483;486;3;25;2.0
23;54;486;492;6;25;2.0
23;55;492;498;6;25;2.0
23;56;498;499;1;25;2.0
23;57;499;502;3;25;2.0
23;58;502;505;3;25;2.0
23;59;505;511;6;25;2.0
23;60;511;513;2;25;2.0
23;61;513;521;8;25;2.0
23;62;521;525;4;25;2.0
23;63;525;529;4;25;2.0
23;64;529;532;3;25;2.0
23;65;532;535;3;25;2.0
23;66;535;541;6;25;2.0
23;67;541;547;6;25;2.0
23;68;547;549;2;25;2.0
23;69;549;550;1;25;2.0
23;70;550;553;3;25;2.0
23;71;553;584;31;25;2.0
23;72;584;585;1;25;2.0
23;73;585;588;3;25;2.0
23;74;588;591;3;25;2.0
23;75;591;593;2;25;2.0
23;76;593;625;32;25;2.0
23;77;625;626;1;25;2.0
23;78;626;629;3;25;2.0
23;79;629;633;4;25;2.0
23;80;633;634;1;25;2.0
23;81;634;655;21;25;2.0
23;82;655;657;2;25;2.0
23;83;657;661;4;25;2.0
23;84;661;673;12;25;2.0
23;85;673;695;22;25;2.0
23;86;695;696;1;25;2.0
23;87;696;704;8;25;2.0
23;88;704;716;12;25;2.0
23;89;716;718;2;25;2.0
23;90;718;723;5;25;2.0
23;91;723;725;2;25;2.0
23;92;725;731;6;25;2.0
23;93;731;747;16;25;2.0
23;94;747;748;1;25;2.0
23;95;748;763;15;25;2.0
23;96;763;764;1;25;2.0
23;97;764;768;4;25;2.0
23;98;768;771;3;25;2.0
23;99;771;775;4;25;2.0
23;100;775;776;1;25;2.0
23;101;776;782;6;25;2.0
23;102;782;791;9;25;2.0
23;103;791;798;7;25;2.0
23;104;798;799;1;25;2.0
23;105;799;805;6;25;2.0
23;106;805;808;3;25;2.0
23;107;808;812;4;25;2.0
23;108;812;818;6;25;2.0
23;109;818;821;3;25;2.0
23;110;821;822;1;25;2.0
23;111;822;824;2;25;2.0
23;112;824;831;7;25;2.0
23;113;831;832;1;25;2.0
23;114;832;837;5;25;2.0
23;115;837;841;4;25;2.0
23;116;841;849;8;25;2.0
23;117;849;851;2;25;2.0
23;118;851;852;1;25;2.0
23;119;852;855;3;25;2.0
23;120;855;863;8;25;2.0
23;121;863;866;3;25;2.0
23;122;866;869;3;25;2.0
23;123;869;872;3;25;2.0
23;124;872;873;1;25;2.0
23;125;873;884;11;25;2.0
23;126;884;885;1;25;2.0
23;127;885;886;1;25;2.0
23;128;886;887;1;25;2.0
23;129;887;891;4;25;2.0
23;130;891;895;4;25;2.0
23;131;895;901;6;25;2.0
23;132;901;904;3;25;2.0
23;133;904;906;2;25;2.0
23;134;906;907;1;25;2.0
23;135;907;912;5;25;2.0
23;136;912;919;7;25;2.0
23;137;919;920;1;25;2.0
23;138;920;921;1;25;2.0
23;139;921;925;4;25;2.0
23;140;925;932;7;25;2.0
23;141;932;936;4;25;2.0
23;142;936;940;4;25;2.0
23;143;940;941;1;25;2.0
23;144;941;944;3;25;2.0
23;145;944;947;3;25;2.0
23;146;947;955;8;25;2.0
23;147;955;956;1;25;2.0
23;148;956;959;3;25;2.0
23;149;959;961;2;25;2.0
23;150;961;964;3;25;2.0
23;151;964;967;3;25;2.0
23;152;967;975;8;25;2.0
23;153;975;976;1;25;2.0
23;154;976;979;3;25;2.0
23;155;979;981;2;25;2.0
23;156;981;991;10;25;2.0
23;157;991;999;8;25;2.0
23;158;999;1000;1;25;2.0
23;159;1000;1001;1;25;2.0
23;160;1001;1005;4;25;2.0
23;161;1005;1012;7;25;2.0
23;162;1012;1015;3;25;2.0
23;163;1015;1021;6;25;2.0
23;164;1021;1022;1;25;2.0
23;165;1022;1023;1;25;2.0
23;166;1023;1029;6;25;2.0
23;167;1029;1032;3;25;2.0
23;168;1032;1035;3;25;2.0
23;169;1035;1041;6;25;2.0
23;170;1041;1044;3;25;2.0
23;171;1044;1045;1;25;2.0
23;172;1045;1049;4;25;2.0
23;173;1049;1055;6;25;2.0
23;174;1055;1060;5;25;2.0
23;175;1060;1061;1;25;2.0
23;176;1061;1069;8;25;2.0
23;177;1069;1076;7;25;2.0
23;178;1076;1077;1;25;2.0
23;179;1077;1081;4;25;2.0
23;180;1081;1085;4;25;2.0
23;181;1085;1089;4;25;2.0
23;182;1089;1094;5;25;2.0
23;183;1094;1096;2;25;2.0
23;184;1096;1099;3;25;2.0
23;185;1099;1103;4;25;2.0
23;186;1103;1110;7;25;2.0
23;187;1110;1111;1;25;2.0
23;188;1111;1121;10;25;2.0
23;189;1121;1137;16;25;2.0
23;190;1137;1139;2;25;2.0
23;191;1139;1141;2;25;2.0
23;192;1141;1148;7;25;2.0
23;193;1148;1150;2;25;2.0
23;194;1150;1169;19;25;2.0
23;195;1169;1171;2;25;2.0
23;196;1171;1177;6;25;2.0
23;197;1177;1181;4;25;2.0
23;198;1181;1200;19;25;2.0
23;199;1200;1205;5;25;2.0
23;200;1205;1208;3;25;2.0
23;201;1208;1212;4;25;2.0
23;202;1212;1219;7;25;2.0
23;203;1219;1231;12;25;2.0
23;204;1231;1256;25;25;2.0
23;205;1256;1263;7;25;2.0
23;206;1263;1264;1;25;2.0
23;207;1264;1268;4;25;2.0
23;208;1268;1272;4;25;2.0
23;209;1272;1279;7;25;2.0
23;210;1279;1291;12;25;2.0
23;211;1291;1296;5;25;2.0
23;212;1296;1318;22;25;2.0
23;213;1318;1324;6;25;2.0
23;214;1324;1326;2;25;2.0
23;215;1326;1338;12;25;2.0
23;216;1338;1340;2;25;2.0
23;217;1340;1357;17;25;2.0
23;218;1357;1360;3;25;2.0
23;219;1360;1361;1;25;2.0
23;220;1361;1365;4;25;2.0
23;221;1365;1377;12;25;2.0
23;222;1377;1379;2;25;2.0
23;223;1379;1382;3;25;2.0
23;224;1382;1384;2;25;2.0
23;225;1384;1399;15;25;2.0
23;226;1399;1414;15;25;2.0
23;227;1414;1429;15;25;2.0
23;228;1429;1444;15;25;2.0
23;229;1444;1459;15;25;2.0
23;230;1459;1474;15;25;2.0
23;231;1474;1489;15;25;2.0
23;232;1489;1504;15;25;2.0
23;233;1504;1519;15;25;2.0
23;234;1519;1534;15;25;2.0
23;235;1534;1549;15;25;2.0
23;236;1549;1564;15;25;2.0
23;237;1564;1579;15;25;2.0
23;238;1579;1594;15;25;2.0
23;239;1594;1609;15;25;2.0
23;240;1609;1624;15;25;2.0
23;241;1624;1639;15;25;2.0
23;242;1639;1654;15;25;2.0
23;243;1654;1669;15;25;2.0
23;244;1669;1680;11;25;2.0
24;0;240;334;94;0;0.83
24;1;334;336;2;0;0.83
24;2;336;337;1;0;0.83
24;3;337;338;1;0;0.83
24;4;338;342;4;0;0.83
24;5;342;349;7;0;0.83
24;6;349;351;2;0;0.83
24;7;351;352;1;0;0.83
24;8;352;362;10;0;0.83
24;9;362;364;2;0;0.83
24;10;364;366;2;0;0.83
24;11;366;369;3;0;0.83
24;12;369;371;2;0;0.83
24;13;371;377;6;0;0.83
24;14;377;386;9;0;0.83
24;15;386;389;3;0;0.83
24;16;389;392;3;0;0.83
24;17;392;394;2;0;0.83
24;18;394;395;1;0;0.83
24;19;395;397;2;0;0.83
24;20;397;400;3;0;0.83
24;21;400;401;1;0;0.83
24;22;401;407;6;0;0.83
24;23;407;408;1;0;0.83
24;24;408;409;1;0;0.83
24;25;409;412;3;0;0.83
24;26;412;420;8;0;0.83
24;27;420;421;1;0;0.83
24;28;421;422;1;0;0.83
24;29;422;424;2;0;0.83
24;30;424;429;5;0;0.83
24;31;429;432;3;0;0.83
24;32;432;439;7;0;0.83
24;33;439;447;8;0;0.83
24;34;447;451;4;0;0.83
24;35;451;454;3;0;0.83
24;36;454;455;1;0;0.83
24;37;455;456;1;0;0.83
24;38;456;457;1;0;0.83
24;39;457;465;8;0;0.83
24;40;465;467;2;0;0.83
24;41;467;469;2;0;0.83
24;42;469;472;3;0;0.83
24;43;472;475;3;0;0.83
24;44;475;482;7;0;0.83
24;45;482;484;2;0;0.83
24;46;484;487;3;0;0.83
24;47;487;496;9;0;0.83
24;48;496;499;3;0;0.83
24;49;499;502;3;0;0.83
24;50;502;506;4;0;0.83
24;51;506;509;3;0;0.83
24;52;509;515;6;0;0.83
24;53;515;517;2;0;0.83
24;54;517;522;5;0;0.83
24;55;522;527;5;0;0.83
24;56;527;532;5;0;0.83
24;57;532;536;4;0;0.83
24;58;536;539;3;0;0.83
24;59;539;545;6;0;0.83
24;60;545;551;6;0;0.83
24;61;551;554;3;0;0.83
24;62;554;557;3;0;0.83
24;63;557;587;30;0;0.83
24;64;587;589;2;0;0.83
24;65;589;592;3;0;0.83
24;66;592;594;2;0;0.83
24;67;594;595;1;0;0.83
24;68;595;627;32;0;0.83
24;69;627;629;2;0;0.83
24;70;629;631;2;0;0.83
24;71;631;637;6;0;0.83
24;72;637;659;22;0;0.83
24;73;659;661;2;0;0.83
24;74;661;662;1;0;0.83
24;75;662;674;12;0;0.83
24;76;674;677;3;0;0.83
24;77;677;697;20;0;0.83
24;78;697;699;2;0;0.83
24;79;699;707;8;0;0.83
24;80;707;720;13;0;0.83
24;81;720;722;2;0;0.83
24;82;722;724;2;0;0.83
24;83;724;729;5;0;0.83
24;84;729;732;3;0;0.83
24;85;732;750;18;0;0.83
24;86;750;751;1;0;0.83
24;87;751;767;16;0;0.83
24;88;767;769;2;0;0.83
24;89;769;772;3;0;0.83
24;90;772;779;7;0;0.83
24;91;779;780;1;0;0.83
24;92;780;786;6;0;0.83
24;93;786;792;6;0;0.83
24;94;792;800;8;0;0.83
24;95;800;802;2;0;0.83
24;96;802;809;7;0;0.83
24;97;809;816;7;0;0.83
24;98;816;820;4;0;0.83
24;99;820;822;2;0;0.83
24;100;822;826;4;0;0.83
24;101;826;827;1;0;0.83
24;102;827;835;8;0;0.83
24;103;835;836;1;0;0.83
24;104;836;841;5;0;0.83
24;105;841;842;1;0;0.83
24;106;842;852;10;0;0.83
24;107;852;856;4;0;0.83
24;108;856;859;3;0;0.83
24;109;859;864;5;0;0.83
24;110;864;867;3;0;0.83
24;111;867;872;5;0;0.83
24;112;872;873;1;0;0.83
24;113;873;874;1;0;0.83
24;114;874;876;2;0;0.83
24;115;876;886;10;0;0.83
24;116;886;887;1;0;0.83
24;117;887;889;2;0;0.83
24;118;889;890;1;0;0.83
24;119;890;891;1;0;0.83
24;120;891;892;1;0;0.83
24;121;892;899;7;0;0.83
24;122;899;905;6;0;0.83
24;123;905;907;2;0;0.83
24;124;907;911;4;0;0.83
24;125;911;916;5;0;0.83
24;126;916;921;5;0;0.83
24;127;921;922;1;0;0.83
24;128;922;927;5;0;0.83
24;129;927;929;2;0;0.83
24;130;929;936;7;0;0.83
24;131;936;940;4;0;0.83
24;132;940;941;1;0;0.83
24;133;941;942;1;0;0.83
24;134;942;944;2;0;0.83
24;135;944;947;3;0;0.83
24;136;947;951;4;0;0.83
24;137;951;959;8;0;0.83
24;138;959;960;1;0;0.83
24;139;960;962;2;0;0.83
24;140;962;968;6;0;0.83
24;141;968;971;3;0;0.83
24;142;971;979;8;0;0.83
24;143;979;980;1;0;0.83
24;144;980;982;2;0;0.83
24;145;982;983;1;0;0.83
24;146;983;995;12;0;0.83
24;147;995;1002;7;0;0.83
24;148;1002;1004;2;0;0.83
24;149;1004;1006;2;0;0.83
24;150;1006;1016;10;0;0.83
24;151;1016;1017;1;0;0.83
24;152;1017;1022;5;0;0.83
24;153;1022;1026;4;0;0.83
24;154;1026;1027;1;0;0.83
24;155;1027;1032;5;0;0.83
24;156;1032;1036;4;0;0.83
24;157;1036;1045;9;0;0.83
24;158;1045;1047;2;0;0.83
24;159;1047;1048;1;0;0.83
24;160;1048;1052;4;0;0.83
24;161;1052;1059;7;0;0.83
24;162;1059;1061;2;0;0.83
24;163;1061;1062;1;0;0.83
24;164;1062;1072;10;0;0.83
24;165;1072;1078;6;0;0.83
24;166;1078;1081;3;0;0.83
24;167;1081;1082;1;0;0.83
24;168;1082;1085;3;0;0.83
24;169;1085;1086;1;0;0.83
24;170;1086;1089;3;0;0.83
24;171;1089;1092;3;0;0.83
24;172;1092;1098;6;0;0.83
24;173;1098;1100;2;0;0.83
24;174;1100;1103;3;0;0.83
24;175;1103;1105;2;0;0.83
24;176;1105;1112;7;0;0.83
24;177;1112;1115;3;0;0.83
24;178;1115;1125;10;0;0.83
24;179;1125;1138;13;0;0.83
24;180;1138;1140;2;0;0.83
24;181;1140;1145;5;0;0.83
24;182;1145;1151;6;0;0.83
24;183;1151;1154;3;0;0.83
24;184;1154;1173;19;0;0.83
24;185;1173;1175;2;0;0.83
24;186;1175;1178;3;0;0.83
24;187;1178;1185;7;0;0.83
24;188;1185;1202;17;0;0.83
24;189;1202;1207;5;0;0.83
24;190;1207;1211;4;0;0.83
24;191;1211;1213;2;0;0.83
24;192;1213;1223;10;0;0.83
24;193;1223;1235;12;0;0.83
24;194;1235;1260;25;0;0.83
24;195;1260;1265;5;0;0.83
24;196;1265;1271;6;0;0.83
24;197;1271;1273;2;0;0.83
24;198;1273;1283;10;0;0.83
24;199;1283;1295;12;0;0.83
24;200;1295;1300;5;0;0.83
24;201;1300;1321;21;0;0.83
24;202;1321;1325;4;0;0.83
24;203;1325;1327;2;0;0.83
24;204;1327;1342;15;0;0.83
24;205;1342;1344;2;0;0.83
24;206;1344;1361;17;0;0.83
24;207;1361;1364;3;0;0.83
24;208;1364;1365;1;0;0.83
24;209;1365;1367;2;0;0.83
24;210;1367;1378;11;0;0.83
24;211;1378;1381;3;0;0.83
24;212;1381;1385;4;0;0.83
24;213;1385;1388;3;0;0.83
24;214;1388;1403;15;0;0.83
24;215;1403;1418;15;0;0.83
24;216;1418;1433;15;0;0.83
24;217;1433;1448;15;0;0.83
24;218;1448;1463;15;0;0.83
24;219;1463;1478;15;0;0.83
24;220;1478;1493;15;0;0.83
24;221;1493;1508;15;0;0.83
24;222;1508;1523;15;0;0.83
24;223;1523;1538;15;0;0.83
24;224;1538;1553;15;0;0.83
24;225;1553;1568;15;0;0.83
24;226;1568;1583;15;0;0.83
24;227;1583;1598;15;0;0.83
24;228;1598;1613;15;0;0.83
24;229;1613;1628;15;0;0.83
24;230;1628;1643;15;0;0.83
24;231;1643;1658;15;0;0.83
24;232;1658;1673;15;0;0.83
24;233;1673;1680;7;0;0.83
25;0;240;334;94;0;0.83
25;1;334;336;2;0;0.83
25;2;336;337;1;0;0.83
25;3;337;338;1;0;0.83
25;4;338;342;4;0;0.83
25;5;342;349;7;0;0.83
25;6;349;351;2;0;0.83
25;7;351;352;1;0;0.83
25;8;352;362;10;0;0.83
25;9;362;364;2;0;0.83
25;10;364;366;2;0;0.83
25;11;366;369;3;0;0.83
25;12;369;371;2;0;0.83
25;13;371;377;6;0;0.83
25;14;377;386;9;0;0.83
25;15;386;389;3;0;0.83
25;16;389;392;3;0;0.83
25;17;392;394;2;0;0.83
25;18;394;395;1;0;0.83
25;19;395;397;2;0;0.83
25;20;397;400;3;0;0.83
25;21;400;401;1;0;0.83
25;22;401;407;6;0;0.83
25;23;407;408;1;0;0.83
25;24;408;409;1;0;0.83
25;25;409;412;3;0;0.83
25;26;412;420;8;0;0.83
25;27;420;421;1;0;0.83
25;28;421;422;1;0;0.83
25;29;422;424;2;0;0.83
25;30;424;429;5;0;0.83
25;31;429;432;3;0;0.83
25;32;432;439;7;0;0.83
25;33;439;447;8;0;0.83
25;34;447;451;4;0;0.83
25;35;451;454;3;0;0.83
25;36;454;455;1;0;0.83
25;37;455;456;1;0;0.83
25;38;456;457;1;0;0.83
25;39;457;465;8;0;0.83
25;40;465;467;2;0;0.83
25;41;467;469;2;0;0.83
25;42;469;472;3;0;0.83
25;43;472;475;3;0;0.83
25;44;475;482;7;0;0.83
25;45;482;484;2;0;0.83
25;46;484;487;3;0;0.83
25;47;487;496;9;0;0.83
25;48;496;499;3;0;0.83
25;49;499;502;3;0;0.83
25;50;502;506;4;0;0.83
25;51;506;509;3;0;0.83
25;52;509;515;6;0;0.83
25;53;515;517;2;0;0.83
25;54;517;522;5;0;0.83
25;55;522;527;5;0;0.83
25;56;527;532;5;0;0.83
25;57;532;536;4;0;0.83
25;58;536;539;3;0;0.83
25;59;539;545;6;0;0.83
25;60;545;551;6;0;0.83
25;61;551;554;3;0;0.83
25;62;554;557;3;0;0.83
25;63;557;587;30;0;0.83
25;64;587;589;2;0;0.83
25;65;589;592;3;0;0.83
25;66;592;594;2;0;0.83
25;67;594;595;1;0;0.83
25;68;595;627;32;0;0.83
25;69;627;629;2;0;0.83
25;70;629;631;2;0;0.83
25;71;631;637;6;0;0.83
25;72;637;659;22;0;0.83
25;73;659;661;2;0;0.83
25;74;661;662;1;0;0.83
25;75;662;674;12;0;0.83
25;76;674;677;3;0;0.83
25;77;677;697;20;0;0.83
25;78;697;699;2;0;0.83
25;79;699;707;8;0;0.83
25;80;707;720;13;0;0.83
25;81;720;722;2;0;0.83
25;82;722;724;2;0;0.83
25;83;724;729;5;0;0.83
25;84;729;732;3;0;0.83
25;85;732;750;18;0;0.83
25;86;750;751;1;0;0.83
25;87;751;767;16;0;0.83
25;88;767;769;2;0;0.83
25;89;769;772;3;0;0.83
25;90;772;779;7;0;0.83
25;91;779;780;1;0;0.83
25;92;780;786;6;0;0.83
25;93;786;792;6;0;0.83
25;94;792;800;8;0;0.83
25;95;800;802;2;0;0.83
25;96;802;809;7;0;0.83
25;97;809;816;7;0;0.83
25;98;816;820;4;0;0.83
25;99;820;822;2;0;0.83
25;100;822;826;4;0;0.83
25;101;826;827;1;0;0.83
25;102;827;835;8;0;0.83
25;103;835;836;1;0;0.83
25;104;836;841;5;0;0.83
25;105;841;842;1;0;0.83
25;106;842;852;10;0;0.83
25;107;852;856;4;0;0.83
25;108;856;859;3;0;0.83
25;109;859;864;5;0;0.83
25;110;864;867;3;0;0.83
25;111;867;872;5;0;0.83
25;112;872;873;1;0;0.83
25;113;873;874;1;0;0.83
25;114;874;876;2;0;0.83
25;115;876;886;10;0;0.83
25;116;886;887;1;0;0.83
25;117;887;889;2;0;0.83
25;118;889;890;1;0;0.83
25;119;890;891;1;0;0.83
25;120;891;892;1;0;0.83
25;121;892;899;7;0;0.83
25;122;899;905;6;0;0.83
25;123;905;907;2;0;0.83
25;124;907;911;4;0;0.83
25;125;911;916;5;0;0.83
25;126;916;921;5;0;0.83
25;127;921;922;1;0;0.83
25;128;922;927;5;0;0.83
25;129;927;929;2;0;0.83
25;130;929;936;7;0;0.83
25;131;936;940;4;0;0.83
25;132;940;941;1;0;0.83
25;133;941;942;1;0;0.83
25;134;942;944;2;0;0.83
25;135;944;947;3;0;0.83
25;136;947;951;4;0;0.83
25;137;951;959;8;0;0.83
25;138;959;960;1;0;0.83
25;139;960;962;2;0;0.83
25;140;962;968;6;0;0.83
25;141;968;971;3;0;0.83
25;142;971;979;8;0;0.83
25;143;979;980;1;0;0.83
25;144;980;982;2;0;0.83
25;145;982;983;1;0;0.83
25;146;983;995;12;0;0.83
25;147;995;1002;7;0;0.83
25;148;1002;1004;2;0;0.83
25;149;1004;1006;2;0;0.83
25;150;1006;1016;10;0;0.83
25;151;1016;1017;1;0;0.83
25;152;1017;1022;5;0;0.83
25;153;1022;1026;4;0;0.83
25;154;1026;1027;1;0;0.83
25;155;1027;1032;5;0;0.83
25;156;1032;1036;4;0;0.83
25;157;1036;1045;9;0;0.83
25;158;1045;1047;2;0;0.83
25;159;1047;1048;1;0;0.83
25;160;1048;1052;4;0;0.83
25;161;1052;1059;7;0;0.83
25;162;1059;1061;2;0;0.83
25;163;1061;1062;1;0;0.83
25;164;1062;1072;10;0;0.83
25;165;1072;1078;6;0;0.83
25;166;1078;1081;3;0;0.83
25;167;1081;1082;1;0;0.83
25;168;1082;1085;3;0;0.83
25;169;1085;1086;1;0;0.83
25;170;1086;1089;3;0;0.83
25;171;1089;1092;3;0;0.83
25;172;1092;1098;6;0;0.83
25;173;1098;1100;2;0;0.83
25;174;1100;1103;3;0;0.83
25;175;1103;1105;2;0;0.83
25;176;1105;1112;7;0;0.83
25;177;1112;1115;3;0;0.83
25;178;1115;1125;10;0;0.83
25;179;1125;1138;13;0;0.83
25;180;1138;1140;2;0;0.83
25;181;1140;1145;5;0;0.83
25;182;1145;1151;6;0;0.83
25;183;1151;1154;3;0;0.83
25;184;1154;1173;19;0;0.83
25;185;1173;1175;2;0;0.83
25;186;1175;1178;3;0;0.83
25;187;1178;1185;7;0;0.83
25;188;1185;1202;17;0;0.83
25;189;1202;1207;5;0;0.83
25;190;1207;1211;4;0;0.83
25;191;1211;1213;2;0;0.83
25;192;1213;1223;10;0;0.83
25;193;1223;1235;12;0;0.83
25;194;1235;1260;25;0;0.83
25;195;1260;1265;5;0;0.83
25;196;1265;1271;6;0;0.83
25;197;1271;1273;2;0;0.83
25;198;1273;1283;10;0;0.83
25;199;1283;1295;12;0;0.83
25;200;1295;1300;5;0;0.83
25;201;1300;1321;21;0;0.83
25;202;1321;1325;4;0;0.83
25;203;1325;1327;2;0;0.83
25;204;1327;1342;15;0;0.83
25;205;1342;1344;2;0;0.83
25;206;1344;1361;17;0;0.83
25;207;1361;1364;3;0;0.83
25;208;1364;1365;1;0;0.83
25;209;1365;1367;2;0;0.83
25;210;1367;1378;11;0;0.83
25;211;1378;1381;3;0;0.83
25;212;1381;1385;4;0;0.83
25;213;1385;1388;3;0;0.83
25;214;1388;1403;15;0;0.83
25;215;1403;1418;15;0;0.83
25;216;1418;1433;15;0;0.83
25;217;1433;1448;15;0;0.83
25;218;1448;1463;15;0;0.83
25;219;1463;1478;15;0;0.83
25;220;1478;1493;15;0;0.83
25;221;1493;1508;15;0;0.83
25;222;1508;1523;15;0;0.83
25;223;1523;1538;15;0;0.83
25;224;1538;1553;15;0;0.83
25;225;1553;1568;15;0;0.83
25;226;1568;1583;15;0;0.83
25;227;1583;1598;15;0;0.83
25;228;1598;1613;15;0;0.83
25;229;1613;1628;15;0;0.83
25;230;1628;1643;15;0;0.83
25;231;1643;1658;15;0;0.83
25;232;1658;1673;15;0;0.83
25;233;1673;1680;7;0;0.83
26;0;240;334;94;0;0.83
26;1;334;336;2;0;0.83
26;2;336;337;1;0;0.83
26;3;337;338;1;0;0.83
26;4;338;342;4;0;0.83
26;5;342;349;7;0;0.83
26;6;349;351;2;0;0.83
26;7;351;352;1;0;0.83
26;8;352;362;10;0;0.83
26;9;362;364;2;0;0.83
26;10;364;366;2;0;0.83
26;11;366;369;3;0;0.83
26;12;369;371;2;0;0.83
26;13;371;377;6;0;0.83
26;14;377;386;9;0;0.83
26;15;386;389;3;0;0.83
26;16;389;392;3;0;0.83
26;17;392;394;2;0;0.83
26;18;394;395;1;0;0.83
26;19;395;397;2;0;0.83
26;20;397;400;3;0;0.83
26;21;400;401;1;0;0.83
26;22;401;407;6;0;0.83
26;23;407;408;1;0;0.83
26;24;408;409;1;0;0.83
26;25;409;412;3;0;0.83
26;26;412;420;8;0;0.83
26;27;420;421;1;0;0.83
26;28;421;422;1;0;0.83
26;29;422;424;2;0;0.83
26;30;424;429;5;0;0.83
26;31;429;432;3;0;0.83
26;32;432;439;7;0;0.83
26;33;439;447;8;0;0.83
26;34;447;451;4;0;0.83
26;35;451;454;3;0;0.83
26;36;454;455;1;0;0.83
26;37;455;456;1;0;0.83
26;38;456;457;1;0;0.83
26;39;457;465;8;0;0.83
26;40;465;467;2;0;0.83
26;41;467;469;2;0;0.83
26;42;469;472;3;0;0.83
26;43;472;475;3;0;0.83
26;44;475;482;7;0;0.83
26;45;482;484;2;0;0.83
26;46;484;487;3;0;0.83
26;47;487;496;9;0;0.83
26;48;496;499;3;0;0.83
26;49;499;502;3;0;0.83
26;50;502;506;4;0;0.83
26;51;506;509;3;0;0.83
26;52;509;515;6;0;0.83
26;53;515;517;2;0;0.83
26;54;517;522;5;0;0.83
26;55;522;527;5;0;0.83
26;56;527;532;5;0;0.83
26;57;532;536;4;0;0.83
26;58;536;539;3;0;0.83
26;59;539;545;6;0;0.83
26;60;545;551;6;0;0.83
26;61;551;554;3;0;0.83
26;62;554;557;3;0;0.83
26;63;557;587;30;0;0.83
26;64;587;589;2;0;0.83
26;65;589;592;3;0;0.83
26;66;592;594;2;0;0.83
26;67;594;595;1;0;0.83
26;68;595;627;32;0;0.83
26;69;627;629;2;0;0.83
26;70;629;631;2;0;0.83
26;71;631;637;6;0;0.83
26;72;637;659;22;0;0.83
26;73;659;661;2;0;0.83
26;74;661;662;1;0;0.83
26;75;662;674;12;0;0.83
26;76;674;677;3;0;0.83
26;77;677;697;20;0;0.83
26;78;697;699;2;0;0.83
26;79;699;707;8;0;0.83
26;80;707;720;13;0;0.83
26;81;720;722;2;0;0.83
26;82;722;724;2;0;0.83
26;83;724;729;5;0;0.83
26;84;729;732;3;0;0.83
26;85;732;750;18;0;0.83
26;86;750;751;1;0;0.83
26;87;751;767;16;0;0.83
26;88;767;769;2;0;0.83
26;89;769;772;3;0;0.83
26;90;772;779;7;0;0.83
26;91;779;780;1;0;0.83
26;92;780;786;6;0;0.83
26;93;786;792;6;0;0.83
26;94;792;800;8;0;0.83
26;95;800;802;2;0;0.83
26;96;802;809;7;0;0.83
26;97;809;816;7;0;0.83
26;98;816;820;4;0;0.83
26;99;820;822;2;0;0.83
26;100;822;826;4;0;0.83
26;101;826;827;1;0;0.83
26;102;827;835;8;0;0.83
26;103;835;836;1;0;0.83
26;104;836;841;5;0;0.83
26;105;841;842;1;0;0.83
26;106;842;852;10;0;0.83
26;107;852;856;4;0;0.83
26;108;856;859;3;0;0.83
26;109;859;864;5;0;0.83
26;110;864;867;3;0;0.83
26;111;867;872;5;0;0.83
26;112;872;873;1;0;0.83
26;113;873;874;1;0;0.83
26;114;874;876;2;0;0.83
26;115;876;886;10;0;0.83
26;116;886;887;1;0;0.83
26;117;887;889;2;0;0.83
26;118;889;890;1;0;0.83
26;119;890;891;1;0;0.83
26;120;891;892;1;0;0.83
26;121;892;899;7;0;0.83
26;122;899;905;6;0;0.83
26;123;905;907;2;0;0.83
26;124;907;911;4;0;0.83
26;125;911;916;5;0;0.83
26;126;916;921;5;0;0.83
26;127;921;922;1;0;0.83
26;128;922;927;5;0;0.83
26;129;927;929;2;0;0.83
26;130;929;936;7;0;0.83
26;131;936;940;4;0;0.83
26;132;940;941;1;0;0.83
26;133;941;942;1;0;0.83
26;134;942;944;2;0;0.83
26;135;944;947;3;0;0.83
26;136;947;951;4;0;0.83
26;137;951;959;8;0;0.83
26;138;959;960;1;0;0.83
26;139;960;962;2;0;0.83
26;140;962;968;6;0;0.83
26;141;968;971;3;0;0.83
26;142;971;979;8;0;0.83
26;143;979;980;1;0;0.83
26;144;980;982;2;0;0.83
26;145;982;983;1;0;0.83
26;146;983;995;12;0;0.83
26;147;995;1002;7;0;0.83
26;148;1002;1004;2;0;0.83
26;149;1004;1006;2;0;0.83
26;150;1006;1016;10;0;0.83
26;151;1016;1017;1;0;0.83
26;152;1017;1022;5;0;0.83
26;153;1022;1026;4;0;0.83
26;154;1026;1027;1;0;0.83
26;155;1027;1032;5;0;0.83
26;156;1032;1036;4;0;0.83
26;157;1036;1045;9;0;0.83
26;158;1045;1047;2;0;0.83
26;159;1047;1048;1;0;0.83
26;160;1048;1052;4;0;0.83
26;161;1052;1059;7;0;0.83
26;162;1059;1061;2;0;0.83
26;163;1061;1062;1;0;0.83
26;164;1062;1072;10;0;0.83
26;165;1072;1078;6;0;0.83
26;166;1078;1081;3;0;0.83
26;167;1081;1082;1;0;0.83
26;168;1082;1085;3;0;0.83
26;169;1085;1086;1;0;0.83
26;170;1086;1089;3;0;0.83
26;171;1089;1092;3;0;0.83
26;172;1092;1098;6;0;0.83
26;173;1098;1100;2;0;0.83
26;174;1100;1103;3;0;0.83
26;175;1103;1105;2;0;0.83
26;176;1105;1112;7;0;0.83
26;177;1112;1115;3;0;0.83
26;178;1115;1125;10;0;0.83
26;179;1125;1138;13;0;0.83
26;180;1138;1140;2;0;0.83
26;181;1140;1145;5;0;0.83
26;182;1145;1151;6;0;0.83
26;183;1151;1154;3;0;0.83
26;184;1154;1173;19;0;0.83
26;185;1173;1175;2;0;0.83
26;186;1175;1178;3;0;0.83
26;187;1178;1185;7;0;0.83
26;188;1185;1202;17;0;0.83
26;189;1202;1207;5;0;0.83
26;190;1207;1211;4;0;0.83
26;191;1211;1213;2;0;0.83
26;192;1213;1223;10;0;0.83
26;193;1223;1235;12;0;0.83
26;194;1235;1260;25;0;0.83
26;195;1260;1265;5;0;0.83
26;196;1265;1271;6;0;0.83
26;197;1271;1273;2;0;0.83
26;198;1273;1283;10;0;0.83
26;199;1283;1295;12;0;0.83
26;200;1295;1300;5;0;0.83
26;201;1300;1321;21;0;0.83
26;202;1321;1325;4;0;0.83
26;203;1325;1327;2;0;0.83
26;204;1327;1342;15;0;0.83
26;205;1342;1344;2;0;0.83
26;206;1344;1361;17;0;0.83
26;207;1361;1364;3;0;0.83
26;208;1364;1365;1;0;0.83
26;209;1365;1367;2;0;0.83
26;210;1367;1378;11;0;0.83
26;211;1378;1381;3;0;0.83
26;212;1381;1385;4;0;0.83
26;213;1385;1388;3;0;0.83
26;214;1388;1403;15;0;0.83
26;215;1403;1418;15;0;0.83
26;216;1418;1433;15;0;0.83
26;217;1433;1448;15;0;0.83
26;218;1448;1463;15;0;0.83
26;219;1463;1478;15;0;0.83
26;220;1478;1493;15;0;0.83
26;221;1493;1508;15;0;0.83
26;222;1508;1523;15;0;0.83
26;223;1523;1538;15;0;0.83
26;224;1538;1553;15;0;0.83
26;225;1553;1568;15;0;0.83
26;226;1568;1583;15;0;0.83
26;227;1583;1598;15;0;0.83
26;228;1598;1613;15;0;0.83
26;229;1613;1628;15;0;0.83
26;230;1628;1643;15;0;0.83
26;231;1643;1658;15;0;0.83
26;232;1658;1673;15;0;0.83
26;233;1673;1680;7;0;0.83
27;0;240;334;94;0;0.83
27;1;334;336;2;0;0.83
27;2;336;337;1;0;0.83
27;3;337;338;1;0;0.83
27;4;338;342;4;0;0.83
27;5;342;349;7;0;0.83
27;6;349;351;2;0;0.83
27;7;351;352;1;0;0.83
27;8;352;362;10;0;0.83
27;9;362;364;2;0;0.83
27;10;364;366;2;0;0.83
27;11;366;369;3;0;0.83
27;12;369;371;2;0;0.83
27;13;371;377;6;0;0.83
27;14;377;386;9;0;0.83
27;15;386;389;3;0;0.83
27;16;389;392;3;0;0.83
27;17;392;394;2;0;0.83
27;18;394;395;1;0;0.83
27;19;395;397;2;0;0.83
27;20;397;400;3;0;0.83
27;21;400;401;1;0;0.83
27;22;401;407;6;0;0.83
27;23;407;408;1;0;0.83
27;24;408;409;1;0;0.83
27;25;409;412;3;0;0.83
27;26;412;420;8;0;0.83
27;27;420;421;1;0;0.83
27;28;421;422;1;0;0.83
27;29;422;424;2;0;0.83
27;30;424;429;5;0;0.83
27;31;429;432;3;0;0.83
27;32;432;439;7;0;0.83
27;33;439;447;8;0;0.83
27;34;447;451;4;0;0.83
27;35;451;454;3;0;0.83
27;36;454;455;1;0;0.83
27;37;455;456;1;0;0.83
27;38;456;457;1;0;0.83
27;39;457;465;8;0;0.83
27;40;465;467;2;0;0.83
27;41;467;469;2;0;0.83
27;42;469;472;3;0;0.83
27;43;472;475;3;0;0.83
27;44;475;482;7;0;0.83
27;45;482;484;2;0;0.83
27;46;484;487;3;0;0.83
27;47;487;496;9;0;0.83
27;48;496;499;3;0;0.83
27;49;499;502;3;0;0.83
27;50;502;506;4;0;0.83
27;51;506;509;3;0;0.83
27;52;509;515;6;0;0.83
27;53;515;517;2;0;0.83
27;54;517;522;5;0;0.83
27;55;522;527;5;0;0.83
27;56;527;532;5;0;0.83
27;57;532;536;4;0;0.83
27;58;536;539;3;0;0.83
27;59;539;545;6;0;0.83
27;60;545;551;6;0;0.83
27;61;551;554;3;0;0.83
27;62;554;557;3;0;0.83
27;63;557;587;30;0;0.83
27;64;587;589;2;0;0.83
27;65;589;592;3;0;0.83
27;66;592;594;2;0;0.83
27;67;594;595;1;0;0.83
27;68;595;627;32;0;0.83
27;69;627;629;2;0;0.83
27;70;629;631;2;0;0.83
27;71;631;637;6;0;0.83
27;72;637;659;22;0;0.83
27;73;659;661;2;0;0.83
27;74;661;662;1;0;0.83
27;75;662;674;12;0;0.83
27;76;674;677;3;0;0.83
27;77;677;697;20;0;0.83
27;78;697;699;2;0;0.83
27;79;699;707;8;0;0.83
27;80;707;720;13;0;0.83
27;81;720;722;2;0;0.83
27;82;722;724;2;0;0.83
27;83;724;729;5;0;0.83
27;84;729;732;3;0;0.83
27;85;732;750;18;0;0.83
27;86;750;751;1;0;0.83
27;87;751;767;16;0;0.83
27;88;767;769;2;0;0.83
27;89;769;772;3;0;0.83
27;90;772;779;7;0;0.83
27;91;779;780;1;0;0.83
27;92;780;786;6;0;0.83
27;93;786;792;6;0;0.83
27;94;792;800;8;0;0.83
27;95;800;802;2;0;0.83
27;96;802;809;7;0;0.83
27;97;809;816;7;0;0.83
27;98;816;820;4;0;0.83
27;99;820;822;2;0;0.83
27;100;822;826;4;0;0.83
27;101;826;827;1;0;0.83
27;102;827;835;8;0;0.83
27;103;835;836;1;0;0.83
27;104;836;841;5;0;0.83
27;105;841;842;1;0;0.83
27;106;842;852;10;0;0.83
27;107;852;856;4;0;0.83
27;108;856;859;3;0;0.83
27;109;859;864;5;0;0.83
27;110;864;867;3;0;0.83
27;111;867;872;5;0;0.83
27;112;872;873;1;0;0.83
27;113;873;874;1;0;0.83
27;114;874;876;2;0;0.83
27;115;876;886;10;0;0.83
27;116;886;887;1;0;0.83
27;117;887;889;2;0;0.83
27;118;889;890;1;0;0.83
27;119;890;891;1;0;0.83
27;120;891;892;1;0;0.83
27;121;892;899;7;0;0.83
27;122;899;905;6;0;0.83
27;123;905;907;2;0;0.83
27;124;907;911;4;0;0.83
27;125;911;916;5;0;0.83
27;126;916;921;5;0;0.83
27;127;921;922;1;0;0.83
27;128;922;927;5;0;0.83
27;129;927;929;2;0;0.83
27;130;929;936;7;0;0.83
27;131;936;940;4;0;0.83
27;132;940;941;1;0;0.83
27;133;941;942;1;0;0.83
27;134;942;944;2;0;0.83
27;135;944;947;3;0;0.83
27;136;947;951;4;0;0.83
27;137;951;959;8;0;0.83
27;138;959;960;1;0;0.83
27;139;960;962;2;0;0.83
27;140;962;968;6;0;0.83
27;141;968;971;3;0;0.83
27;142;971;979;8;0;0.83
27;143;979;980;1;0;0.83
27;144;980;982;2;0;0.83
27;145;982;983;1;0;0.83
27;146;983;995;12;0;0.83
27;147;995;1002;7;0;0.83
27;148;1002;1004;2;0;0.83
27;149;1004;1006;2;0;0.83
27;150;1006;1016;10;0;0.83
27;151;1016;1017;1;0;0.83
27;152;1017;1022;5;0;0.83
27;153;1022;1026;4;0;0.83
27;154;1026;1027;1;0;0.83
27;155;1027;1032;5;0;0.83
27;156;1032;1036;4;0;0.83
27;157;1036;1045;9;0;0.83
27;158;1045;1047;2;0;0.83
27;159;1047;1048;1;0;0.83
27;160;1048;1052;4;0;0.83
27;161;1052;1059;7;0;0.83
27;162;1059;1061;2;0;0.83
27;163;1061;1062;1;0;0.83
27;164;1062;1072;10;0;0.83
27;165;1072;1078;6;0;0.83
27;166;1078;1081;3;0;0.83
27;167;1081;1082;1;0;0.83
27;168;1082;1085;3;0;0.83
27;169;1085;1086;1;0;0.83
27;170;1086;1089;3;0;0.83
27;171;1089;1092;3;0;0.83
27;172;1092;1098;6;0;0.83
27;173;1098;1100;2;0;0.83
27;174;1100;1103;3;0;0.83
27;175;1103;1105;2;0;0.83
27;176;1105;1112;7;0;0.83
27;177;1112;1115;3;0;0.83
27;178;1115;1125;10;0;0.83
27;179;1125;1138;13;0;0.83
27;180;1138;1140;2;0;0.83
27;181;1140;1145;5;0;0.83
27;182;1145;1151;6;0;0.83
27;183;1151;1154;3;0;0.83
27;184;1154;1173;19;0;0.83
27;185;1173;1175;2;0;0.83
27;186;1175;1178;3;0;0.83
27;187;1178;1185;7;0;0.83
27;188;1185;1202;17;0;0.83
27;189;1202;1207;5;0;0.83
27;190;1207;1211;4;0;0.83
27;191;1211;1213;2;0;0.83
27;192;1213;1223;10;0;0.83
27;193;1223;1235;12;0;0.83
27;194;1235;1260;25;0;0.83
27;195;1260;1265;5;0;0.83
27;196;1265;1271;6;0;0.83
27;197;1271;1273;2;0;0.83
27;198;1273;1283;10;0;0.83
27;199;1283;1295;12;0;0.83
27;200;1295;1300;5;0;0.83
27;201;1300;1321;21;0;0.83
27;202;1321;1325;4;0;0.83
27;203;1325;1327;2;0;0.83
27;204;1327;1342;15;0;0.83
27;205;1342;1344;2;0;0.83
27;206;1344;1361;17;0;0.83
27;207;1361;1364;3;0;0.83
27;208;1364;1365;1;0;0.83
27;209;1365;1367;2;0;0.83
27;210;1367;1378;11;0;0.83
27;211;1378;1381;3;0;0.83
27;212;1381;1385;4;0;0.83
27;213;1385;1388;3;0;0.83
27;214;1388;1403;15;0;0.83
27;215;1403;1418;15;0;0.83
27;216;1418;1433;15;0;0.83
27;217;1433;1448;15;0;0.83
27;218;1448;1463;15;0;0.83
27;219;1463;1478;15;0;0.83
27;220;1478;1493;15;0;0.83
27;221;1493;1508;15;0;0.83
27;222;1508;1523;15;0;0.83
27;223;1523;1538;15;0;0.83
27;224;1538;1553;15;0;0.83
27;225;1553;1568;15;0;0.83
27;226;1568;1583;15;0;0.83
27;227;1583;1598;15;0;0.83
27;228;1598;1613;15;0;0.83
27;229;1613;1628;15;0;0.83
27;230;1628;1643;15;0;0.83
27;231;1643;1658;15;0;0.83
27;232;1658;1673;15;0;0.83
27;233;1673;1680;7;0;0.83
28;0;240;334;94;0;0.83
28;1;334;336;2;0;0.83
28;2;336;337;1;0;0.83
28;3;337;338;1;0;0.83
28;4;338;342;4;0;0.83
28;5;342;349;7;0;0.83
28;6;349;351;2;0;0.83
28;7;351;352;1;0;0.83
28;8;352;362;10;0;0.83
28;9;362;364;2;0;0.83
28;10;364;366;2;0;0.83
28;11;366;369;3;0;0.83
28;12;369;371;2;0;0.83
28;13;371;377;6;0;0.83
28;14;377;386;9;0;0.83
28;15;386;389;3;0;0.83
28;16;389;392;3;0;0.83
28;17;392;394;2;0;0.83
28;18;394;395;1;0;0.83
28;19;395;397;2;0;0.83
28;20;397;400;3;0;0.83
28;21;400;401;1;0;0.83
28;22;401;407;6;0;0.83
28;23;407;408;1;0;0.83
28;24;408;409;1;0;0.83
28;25;409;412;3;0;0.83
28;26;412;420;8;0;0.83
28;27;420;421;1;0;0.83
28;28;421;422;1;0;0.83
28;29;422;424;2;0;0.83
28;30;424;429;5;0;0.83
28;31;429;432;3;0;0.83
28;32;432;439;7;0;0.83
28;33;439;447;8;0;0.83
28;34;447;451;4;0;0.83
28;35;451;454;3;0;0.83
28;36;454;455;1;0;0.83
28;37;455;456;1;0;0.83
28;38;456;457;1;0;0.83
28;39;457;465;8;0;0.83
28;40;465;467;2;0;0.83
28;41;467;469;2;0;0.83
28;42;469;472;3;0;0.83
28;43;472;475;3;0;0.83
28;44;475;482;7;0;0.83
28;45;482;484;2;0;0.83
28;46;484;487;3;0;0.83
28;47;487;496;9;0;0.83
28;48;496;499;3;0;0.83
28;49;499;502;3;0;0.83
28;50;502;506;4;0;0.83
28;51;506;509;3;0;0.83
28;52;509;515;6;0;0.83
28;53;515;517;2;0;0.83
28;54;517;522;5;0;0.83
28;55;522;527;5;0;0.83
28;56;527;532;5;0;0.83
28;57;532;536;4;0;0.83
28;58;536;539;3;0;0.83
28;59;539;545;6;0;0.83
28;60;545;551;6;0;0.83
28;61;551;554;3;0;0.83
28;62;554;557;3;0;0.83
28;63;557;587;30;0;0.83
28;64;587;589;2;0;0.83
28;65;589;592;3;0;0.83
28;66;592;594;2;0;0.83
28;67;594;595;1;0;0.83
28;68;595;627;32;0;0.83
28;69;627;629;2;0;0.83
28;70;629;631;2;0;0.83
28;71;631;637;6;0;0.83
28;72;637;659;22;0;0.83
28;73;659;661;2;0;0.83
28;74;661;662;1;0;0.83
28;75;662;674;12;0;0.83
28;76;674;677;3;0;0.83
28;77;677;697;20;0;0.83
28;78;697;699;2;0;0.83
28;79;699;707;8;0;0.83
28;80;707;720;13;0;0.83
28;81;720;722;2;0;0.83
28;82;722;724;2;0;0.83
28;83;724;729;5;0;0.83
28;84;729;732;3;0;0.83
28;85;732;750;18;0;0.83
28;86;750;751;1;0;0.83
28;87;751;767;16;0;0.83
28;88;767;769;2;0;0.83
28;89;769;772;3;0;0.83
28;90;772;779;7;0;0.83
28;91;779;780;1;0;0.83
28;92;780;786;6;0;0.83
28;93;786;792;6;0;0.83
28;94;792;800;8;0;0.83
28;95;800;802;2;0;0.83
28;96;802;809;7;0;0.83
28;97;809;816;7;0;0.83
28;98;816;820;4;0;0.83
28;99;820;822;2;0;0.83
28;100;822;826;4;0;0.83
28;101;826;827;1;0;0.83
28;102;827;835;8;0;0.83
28;103;835;836;1;0;0.83
28;104;836;841;5;0;0.83
28;105;841;842;1;0;0.83
28;106;842;852;10;0;0.83
28;107;852;856;4;0;0.83
28;108;856;859;3;0;0.83
28;109;859;864;5;0;0.83
28;110;864;867;3;0;0.83
28;111;867;872;5;0;0.83
28;112;872;873;1;0;0.83
28;113;873;874;1;0;0.83
28;114;874;876;2;0;0.83
28;115;876;886;10;0;0.83
28;116;886;887;1;0;0.83
28;117;887;889;2;0;0.83
28;118;889;890;1;0;0.83
28;119;890;891;1;0;0.83
28;120;891;892;1;0;0.83
28;121;892;899;7;0;0.83
28;122;899;905;6;0;0.83
28;123;905;907;2;0;0.83
28;124;907;911;4;0;0.83
28;125;911;916;5;0;0.83
28;126;916;921;5;0;0.83
28;127;921;922;1;0;0.83
28;128;922;927;5;0;0.83
28;129;927;929;2;0;0.83
28;130;929;936;7;0;0.83
28;131;936;940;4;0;0.83
28;132;940;941;1;0;0.83
28;133;941;942;1;0;0.83
28;134;942;944;2;0;0.83
28;135;944;947;3;0;0.83
28;136;947;951;4;0;0.83
28;137;951;959;8;0;0.83
28;138;959;960;1;0;0.83
28;139;960;962;2;0;0.83
28;140;962;968;6;0;0.83
28;141;968;971;3;0;0.83
28;142;971;979;8;0;0.83
28;143;979;980;1;0;0.83
28;144;980;982;2;0;0.83
28;145;982;983;1;0;0.83
28;146;983;995;12;0;0.83
28;147;995;1002;7;0;0.83
28;148;1002;1004;2;0;0.83
28;149;1004;1006;2;0;0.83
28;150;1006;1016;10;0;0.83
28;151;1016;1017;1;0;0.83
28;152;1017;1022;5;0;0.83
28;153;1022;1026;4;0;0.83
28;154;1026;1027;1;0;0.83
28;155;1027;1032;5;0;0.83
28;156;1032;1036;4;0;0.83
28;157;1036;1045;9;0;0.83
28;158;1045;1047;2;0;0.83
28;159;1047;1048;1;0;0.83
28;160;1048;1052;4;0;0.83
28;161;1052;1059;7;0;0.83
28;162;1059;1061;2;0;0.83
28;163;1061;1062;1;0;0.83
28;164;1062;1072;10;0;0.83
28;165;1072;1078;6;0;0.83
28;166;1078;1081;3;0;0.83
28;167;1081;1082;1;0;0.83
28;168;1082;1085;3;0;0.83
28;169;1085;1086;1;0;0.83
28;170;1086;1089;3;0;0.83
28;171;1089;1092;3;0;0.83
28;172;1092;1098;6;0;0.83
28;173;1098;1100;2;0;0.83
28;174;1100;1103;3;0;0.83
28;175;1103;1105;2;0;0.83
28;176;1105;1112;7;0;0.83
28;177;1112;1115;3;0;0.83
28;178;1115;1125;10;0;0.83
28;179;1125;1138;13;0;0.83
28;180;1138;1140;2;0;0.83
28;181;1140;1145;5;0;0.83
28;182;1145;1151;6;0;0.83
28;183;1151;1154;3;0;0.83
28;184;1154;1173;19;0;0.83
28;185;1173;1175;2;0;0.83
28;186;1175;1178;3;0;0.83
28;187;1178;1185;7;0;0.83
28;188;1185;1202;17;0;0.83
28;189;1202;1207;5;0;0.83
28;190;1207;1211;4;0;0.83
28;191;1211;1213;2;0;0.83
28;192;1213;1223;10;0;0.83
28;193;1223;1235;12;0;0.83
28;194;1235;1260;25;0;0.83
28;195;1260;1265;5;0;0.83
28;196;1265;1271;6;0;0.83
28;197;1271;1273;2;0;0.83
28;198;1273;1283;10;0;0.83
28;199;1283;1295;12;0;0.83
28;200;1295;1300;5;0;0.83
28;201;1300;1321;21;0;0.83
28;202;1321;1325;4;0;0.83
28;203;1325;1327;2;0;0.83
28;204;1327;1342;15;0;0.83
28;205;1342;1344;2;0;0.83
28;206;1344;1361;17;0;0.83
28;207;1361;1364;3;0;0.83
28;208;1364;1365;1;0;0.83
28;209;1365;1367;2;0;0.83
28;210;1367;1378;11;0;0.83
28;211;1378;1381;3;0;0.83
28;212;1381;1385;4;0;0.83
28;213;1385;1388;3;0;0.83
28;214;1388;1403;15;0;0.83
28;215;1403;1418;15;0;0.83
28;216;1418;1433;15;0;0.83
28;217;1433;1448;15;0;0.83
28;218;1448;1463;15;0;0.83
28;219;1463;1478;15;0;0.83
28;220;1478;1493;15;0;0.83
28;221;1493;1508;15;0;0.83
28;222;1508;1523;15;0;0.83
28;223;1523;1538;15;0;0.83
28;224;1538;1553;15;0;0.83
28;225;1553;1568;15;0;0.83
28;226;1568;1583;15;0;0.83
28;227;1583;1598;15;0;0.83
28;228;1598;1613;15;0;0.83
28;229;1613;1628;15;0;0.83
28;230;1628;1643;15;0;0.83
28;231;1643;1658;15;0;0.83
28;232;1658;1673;15;0;0.83
28;233;1673;1680;7;0;0.83
29;0;240;334;94;0;2.0
29;1;334;336;2;0;2.0
29;2;336;337;1;0;2.0
29;3;337;338;1;0;2.0
29;4;338;342;4;0;2.0
29;5;342;349;7;0;2.0
29;6;349;351;2;0;2.0
29;7;351;352;1;0;2.0
29;8;352;362;10;0;2.0
29;9;362;364;2;0;2.0
29;10;364;366;2;0;2.0
29;11;366;369;3;0;2.0
29;12;369;371;2;0;2.0
29;13;371;377;6;0;2.0
29;14;377;386;9;0;2.0
29;15;386;389;3;0;2.0
29;16;389;392;3;0;2.0
29;17;392;394;2;0;2.0
29;18;394;395;1;0;2.0
29;19;395;397;2;0;2.0
29;20;397;400;3;0;2.0
29;21;400;401;1;0;2.0
29;22;401;407;6;0;2.0
29;23;407;408;1;0;2.0
29;24;408;409;1;0;2.0
29;25;409;412;3;0;2.0
29;26;412;420;8;0;2.0
29;27;420;421;1;0;2.0
29;28;421;422;1;0;2.0
29;29;422;424;2;0;2.0
29;30;424;429;5;0;2.0
29;31;429;432;3;0;2.0
29;32;432;439;7;0;2.0
29;33;439;447;8;0;2.0
29;34;447;451;4;0;2.0
29;35;451;454;3;0;2.0
29;36;454;455;1;0;2.0
29;37;455;456;1;0;2.0
29;38;456;457;1;0;2.0
29;39;457;465;8;0;2.0
29;40;465;467;2;0;2.0
29;41;467;469;2;0;2.0
29;42;469;472;3;0;2.0
29;43;472;475;3;0;2.0
29;44;475;482;7;0;2.0
29;45;482;484;2;0;2.0
29;46;484;487;3;0;2.0
29;47;487;496;9;0;2.0
29;48;496;499;3;0;2.0
29;49;499;502;3;0;2.0
29;50;502;506;4;0;2.0
29;51;506;509;3;0;2.0
29;52;509;515;6;0;2.0
29;53;515;517;2;0;2.0
29;54;517;522;5;0;2.0
29;55;522;527;5;0;2.0
29;56;527;532;5;0;2.0
29;57;532;536;4;0;2.0
29;58;536;539;3;0;2.0
29;59;539;545;6;0;2.0
29;60;545;551;6;0;2.0
29;61;551;554;3;0;2.0
29;62;554;557;3;0;2.0
29;63;557;587;30;0;2.0
29;64;587;589;2;0;2.0
29;65;589;592;3;0;2.0
29;66;592;594;2;0;2.0
29;67;594;595;1;0;2.0
29;68;595;627;32;0;2.0
29;69;627;629;2;0;2.0
29;70;629;631;2;0;2.0
29;71;631;637;6;0;2.0
29;72;637;659;22;0;2.0
29;73;659;661;2;0;2.0
29;74;661;662;1;0;2.0
29;75;662;674;12;0;2.0
29;76;674;677;3;0;2.0
29;77;677;697;20;0;2.0
29;78;697;699;2;0;2.0
29;79;699;707;8;0;2.0
29;80;707;720;13;0;2.0
29;81;720;722;2;0;2.0
29;82;722;724;2;0;2.0
29;83;724;729;5;0;2.0
29;84;729;732;3;0;2.0
29;85;732;750;18;0;2.0
29;86;750;751;1;0;2.0
29;87;751;767;16;0;2.0
29;88;767;769;2;0;2.0
29;89;769;772;3;0;2.0
29;90;772;779;7;0;2.0
29;91;779;780;1;0;2.0
29;92;780;786;6;0;2.0
29;93;786;792;6;0;2.0
29;94;792;800;8;0;2.0
29;95;800;802;2;0;2.0
29;96;802;809;7;0;2.0
29;97;809;816;7;0;2.0
29;98;816;820;4;0;2.0
29;99;820;822;2;0;2.0
29;100;822;826;4;0;2.0
29;101;826;827;1;0;2.0
29;102;827;835;8;0;2.0
29;103;835;836;1;0;2.0
29;104;836;841;5;0;2.0
29;105;841;842;1;0;2.0
29;106;842;852;10;0;2.0
29;107;852;856;4;0;2.0
29;108;856;859;3;0;2.0
29;109;859;864;5;0;2.0
29;110;864;867;3;0;2.0
29;111;867;872;5;0;2.0
29;112;872;873;1;0;2.0
29;113;873;874;1;0;2.0
29;114;874;876;2;0;2.0
29;115;876;886;10;0;2.0
29;116;886;887;1;0;2.0
29;117;887;889;2;0;2.0
29;118;889;890;1;0;2.0
29;119;890;891;1;0;2.0
29;120;891;892;1;0;2.0
29;121;892;899;7;0;2.0
29;122;899;905;6;0;2.0
29;123;905;907;2;0;2.0
29;124;907;911;4;0;2.0
29;125;911;916;5;0;2.0
29;126;916;921;5;0;2.0
29;127;921;922;1;0;2.0
29;128;922;927;5;0;2.0
29;129;927;929;2;0;2.0
29;130;929;936;7;0;2.0
29;131;936;940;4;0;2.0
29;132;940;941;1;0;2.0
29;133;941;942;1;0;2.0
29;134;942;944;2;0;2.0
29;135;944;947;3;0;2.0
29;136;947;951;4;0;2.0
29;137;951;959;8;0;2.0
29;138;959;960;1;0;2.0
29;139;960;962;2;0;2.0
29;140;962;968;6;0;2.0
29;141;968;971;3;0;2.0
29;142;971;979;8;0;2.0
29;143;979;980;1;0;2.0
29;144;980;982;2;0;2.0
29;145;982;983;1;0;2.0
29;146;983;995;12;0;2.0
29;147;995;1002;7;0;2.0
29;148;1002;1004;2;0;2.0
29;149;1004;1006;2;0;2.0
29;150;1006;1016;10;0;2.0
29;151;1016;1017;1;0;2.0
29;152;1017;1022;5;0;2.0
29;153;1022;1026;4;0;2.0
29;154;1026;1027;1;0;2.0
29;155;1027;1032;5;0;2.0
29;156;1032;1036;4;0;2.0
29;157;1036;1045;9;0;2.0
29;158;1045;1047;2;0;2.0
29;159;1047;1048;1;0;2.0
29;160;1048;1052;4;0;2.0
29;161;1052;1059;7;0;2.0
29;162;1059;1061;2;0;2.0
29;163;1061;1062;1;0;2.0
29;164;1062;1072;10;0;2.0
29;165;1072;1078;6;0;2.0
29;166;1078;1081;3;0;2.0
29;167;1081;1082;1;0;2.0
29;168;1082;1085;3;0;2.0
29;169;1085;1086;1;0;2.0
29;170;1086;1089;3;0;2.0
29;171;1089;1092;3;0;2.0
29;172;1092;1098;6;0;2.0
29;173;1098;1100;2;0;2.0
29;174;1100;1103;3;0;2.0
29;175;1103;1105;2;0;2.0
29;176;1105;1112;7;0;2.0
29;177;1112;1115;3;0;2.0
29;178;1115;1125;10;0;2.0
29;179;1125;1138;13;0;2.0
29;180;1138;1140;2;0;2.0
29;181;1140;1145;5;0;2.0
29;182;1145;1151;6;0;2.0
29;183;1151;1154;3;0;2.0
29;184;1154;1173;19;0;2.0
29;185;1173;1175;2;0;2.0
29;186;1175;1178;3;0;2.0
29;187;1178;1185;7;0;2.0
29;188;1185;1202;17;0;2.0
29;189;1202;1207;5;0;2.0
29;190;1207;1211;4;0;2.0
29;191;1211;1213;2;0;2.0
29;192;1213;1223;10;0;2.0
29;193;1223;1235;12;0;2.0
29;194;1235;1260;25;0;2.0
29;195;1260;1265;5;0;2.0
29;196;1265;1271;6;0;2.0
29;197;1271;1273;2;0;2.0
29;198;1273;1283;10;0;2.0
29;199;1283;1295;12;0;2.0
29;200;1295;1300;5;0;2.0
29;201;1300;1321;21;0;2.0
29;202;1321;1325;4;0;2.0
29;203;1325;1327;2;0;2.0
29;204;1327;1342;15;0;2.0
29;205;1342;1344;2;0;2.0
29;206;1344;1361;17;0;2.0
29;207;1361;1364;3;0;2.0
29;208;1364;1365;1;0;2.0
29;209;1365;1367;2;0;2.0
29;210;1367;1378;11;0;2.0
29;211;1378;1381;3;0;2.0
29;212;1381;1385;4;0;2.0
29;213;1385;1388;3;0;2.0
29;214;1388;1403;15;0;2.0
29;215;1403;1418;15;0;2.0
29;216;1418;1433;15;0;2.0
29;217;1433;1448;15;0;2.0
29;218;1448;1463;15;0;2.0
29;219;1463;1478;15;0;2.0
29;220;1478;1493;15;0;2.0
29;221;1493;1508;15;0;2.0
29;222;1508;1523;15;0;2.0
29;223;1523;1538;15;0;2.0
29;224;1538;1553;15;0;2.0
29;225;1553;1568;15;0;2.0
29;226;1568;1583;15;0;2.0
29;227;1583;1598;15;0;2.0
29;228;1598;1613;15;0;2.0
29;229;1613;1628;15;0;2.0
29;230;1628;1643;15;0;2.0
29;231;1643;1658;15;0;2.0
29;232;1658;1673;15;0;2.0
29;233;1673;1680;7;0;2.0
30;0;240;334;94;0;2.0
30;1;334;336;2;0;2.0
30;2;336;337;1;0;2.0
30;3;337;338;1;0;2.0
30;4;338;342;4;0;2.0
30;5;342;349;7;0;2.0
30;6;349;351;2;0;2.0
30;7;351;352;1;0;2.0
30;8;352;362;10;0;2.0
30;9;362;364;2;0;2.0
30;10;364;366;2;0;2.0
30;11;366;369;3;0;2.0
30;12;369;371;2;0;2.0
30;13;371;377;6;0;2.0
30;14;377;386;9;0;2.0
30;15;386;389;3;0;2.0
30;16;389;392;3;0;2.0
30;17;392;394;2;0;2.0
30;18;394;395;1;0;2.0
30;19;395;397;2;0;2.0
30;20;397;400;3;0;2.0
30;21;400;401;1;0;2.0
30;22;401;407;6;0;2.0
30;23;407;408;1;0;2.0
30;24;408;409;1;0;2.0
30;25;409;412;3;0;2.0
30;26;412;420;8;0;2.0
30;27;420;421;1;0;2.0
30;28;421;422;1;0;2.0
30;29;422;424;2;0;2.0
30;30;424;429;5;0;2.0
30;31;429;432;3;0;2.0
30;32;432;439;7;0;2.0
30;33;439;447;8;0;2.0
30;34;447;451;4;0;2.0
30;35;451;454;3;0;2.0
30;36;454;455;1;0;2.0
30;37;455;456;1;0;2.0
30;38;456;457;1;0;2.0
30;39;457;465;8;0;2.0
30;40;465;467;2;0;2.0
30;41;467;469;2;0;2.0
30;42;469;472;3;0;2.0
30;43;472;475;3;0;2.0
30;44;475;482;7;0;2.0
30;45;482;484;2;0;2.0
30;46;484;487;3;0;2.0
30;47;487;496;9;0;2.0
30;48;496;499;3;0;2.0
30;49;499;502;3;0;2.0
30;50;502;506;4;0;2.0
30;51;506;509;3;0;2.0
30;52;509;515;6;0;2.0
30;53;515;517;2;0;2.0
30;54;517;522;5;0;2.0
30;55;522;527;5;0;2.0
30;56;527;532;5;0;2.0
30;57;532;536;4;0;2.0
30;58;536;539;3;0;2.0
30;59;539;545;6;0;2.0
30;60;545;551;6;0;2.0
30;61;551;554;3;0;2.0
30;62;554;557;3;0;2.0
30;63;557;587;30;0;2.0
30;64;587;589;2;0;2.0
30;65;589;592;3;0;2.0
30;66;592;594;2;0;2.0
30;67;594;595;1;0;2.0
30;68;595;627;32;0;2.0
30;69;627;629;2;0;2.0
30;70;629;631;2;0;2.0
30;71;631;637;6;0;2.0
30;72;637;659;22;0;2.0
30;73;659;661;2;0;2.0
30;74;661;662;1;0;2.0
30;75;662;674;12;0;2.0
30;76;674;677;3;0;2.0
30;77;677;697;20;0;2.0
30;78;697;699;2;0;2.0
30;79;699;707;8;0;2.0
30;80;707;720;13;0;2.0
30;81;720;722;2;0;2.0
30;82;722;724;2;0;2.0
30;83;724;729;5;0;2.0
30;84;729;732;3;0;2.0
30;85;732;750;18;0;2.0
30;86;750;751;1;0;2.0
30;87;751;767;16;0;2.0
30;88;767;769;2;0;2.0
30;89;769;772;3;0;2.0
30;90;772;779;7;0;2.0
30;91;779;780;1;0;2.0
30;92;780;786;6;0;2.0
30;93;786;792;6;0;2.0
30;94;792;800;8;0;2.0
30;95;800;802;2;0;2.0
30;96;802;809;7;0;2.0
30;97;809;816;7;0;2.0
30;98;816;820;4;0;2.0
30;99;820;822;2;0;2.0
30;100;822;826;4;0;2.0
30;101;826;827;1;0;2.0
30;102;827;835;8;0;2.0
30;103;835;836;1;0;2.0
30;104;836;841;5;0;2.0
30;105;841;842;1;0;2.0
30;106;842;852;10;0;2.0
30;107;852;856;4;0;2.0
30;108;856;859;3;0;2.0
30;109;859;864;5;0;2.0
30;110;864;867;3;0;2.0
30;111;867;872;5;0;2.0
30;112;872;873;1;0;2.0
30;113;873;874;1;0;2.0
30;114;874;876;2;0;2.0
30;115;876;886;10;0;2.0
30;116;886;887;1;0;2.0
30;117;887;889;2;0;2.0
30;118;889;890;1;0;2.0
30;119;890;891;1;0;2.0
30;120;891;892;1;0;2.0
30;121;892;899;7;0;2.0
30;122;899;905;6;0;2.0
30;123;905;907;2;0;2.0
30;124;907;911;4;0;2.0
30;125;911;916;5;0;2.0
30;126;916;921;5;0;2.0
30;127;921;922;1;0;2.0
30;128;922;927;5;0;2.0
30;129;927;929;2;0;2.0
30;130;929;936;7;0;2.0
30;131;936;940;4;0;2.0
30;132;940;941;1;0;2.0
30;133;941;942;1;0;2.0
30;134;942;944;2;0;2.0
30;135;944;947;3;0;2.0
30;136;947;951;4;0;2.0
30;137;951;959;8;0;2.0
30;138;959;960;1;0;2.0
30;139;960;962;2;0;2.0
30;140;962;968;6;0;2.0
30;141;968;971;3;0;2.0
30;142;971;979;8;0;2.0
30;143;979;980;1;0;2.0
30;144;980;982;2;0;2.0
30;145;982;983;1;0;2.0
30;146;983;995;12;0;2.0
30;147;995;1002;7;0;2.0
30;148;1002;1004;2;0;2.0
30;149;1004;1006;2;0;2.0
30;150;1006;1016;10;0;2.0
30;151;1016;1017;1;0;2.0
30;152;1017;1022;5;0;2.0
30;153;1022;1026;4;0;2.0
30;154;1026;1027;1;0;2.0
30;155;1027;1032;5;0;2.0
30;156;1032;1036;4;0;2.0
30;157;1036;1045;9;0;2.0
30;158;1045;1047;2;0;2.0
30;159;1047;1048;1;0;2.0
30;160;1048;1052;4;0;2.0
30;161;1052;1059;7;0;2.0
30;162;1059;1061;2;0;2.0
30;163;1061;1062;1;0;2.0
30;164;1062;1072;10;0;2.0
30;165;1072;1078;6;0;2.0
30;166;1078;1081;3;0;2.0
30;167;1081;1082;1;0;2.0
30;168;1082;1085;3;0;2.0
30;169;1085;1086;1;0;2.0
30;170;1086;1089;3;0;2.0
30;171;1089;1092;3;0;2.0
30;172;1092;1098;6;0;2.0
30;173;1098;1100;2;0;2.0
30;174;1100;1103;3;0;2.0
30;175;1103;1105;2;0;2.0
30;176;1105;1112;7;0;2.0
30;177;1112;1115;3;0;2.0
30;178;1115;1125;10;0;2.0
30;179;1125;1138;13;0;2.0
30;180;1138;1140;2;0;2.0
30;181;1140;1145;5;0;2.0
30;182;1145;1151;6;0;2.0
30;183;1151;1154;3;0;2.0
30;184;1154;1173;19;0;2.0
30;185;1173;1175;2;0;2.0
30;186;1175;1178;3;0;2.0
30;187;1178;1185;7;0;2.0
30;188;1185;1202;17;0;2.0
30;189;1202;1207;5;0;2.0
30;190;1207;1211;4;0;2.0
30;191;1211;1213;2;0;2.0
30;192;1213;1223;10;0;2.0
30;193;1223;1235;12;0;2.0
30;194;1235;1260;25;0;2.0
30;195;1260;1265;5;0;2.0
30;196;1265;1271;6;0;2.0
30;197;1271;1273;2;0;2.0
30;198;1273;1283;10;0;2.0
30;199;1283;1295;12;0;2.0
30;200;1295;1300;5;0;2.0
30;201;1300;1321;21;0;2.0
30;202;1321;1325;4;0;2.0
30;203;1325;1327;2;0;2.0
30;204;1327;1342;15;0;2.0
30;205;1342;1344;2;0;2.0
30;206;1344;1361;17;0;2.0
30;207;1361;1364;3;0;2.0
30;208;1364;1365;1;0;2.0
30;209;1365;1367;2;0;2.0
30;210;1367;1378;11;0;2.0
30;211;1378;1381;3;0;2.0
30;212;1381;1385;4;0;2.0
30;213;1385;1388;3;0;2.0
30;214;1388;1403;15;0;2.0
30;215;1403;1418;15;0;2.0
30;216;1418;1433;15;0;2.0
30;217;1433;1448;15;0;2.0
30;218;1448;1463;15;0;2.0
30;219;1463;1478;15;0;2.0
30;220;1478;1493;15;0;2.0
30;221;1493;1508;15;0;2.0
30;222;1508;1523;15;0;2.0
30;223;1523;1538;15;0;2.0
30;224;1538;1553;15;0;2.0
30;225;1553;1568;15;0;2.0
30;226;1568;1583;15;0;2.0
30;227;1583;1598;15;0;2.0
30;228;1598;1613;15;0;2.0
30;229;1613;1628;15;0;2.0
30;230;1628;1643;15;0;2.0
30;231;1643;1658;15;0;2.0
30;232;1658;1673;15;0;2.0
30;233;1673;1680;7;0;2.0
