Index Nabijacky;Index Udalosti;Cas Zaciatku;Cas Konca;CasTrvania;Miesto;Rychlost nabijania
0;0;249;332;83;112;2.0
0;1;332;333;1;112;2.0
0;2;333;337;4;112;2.0
0;3;337;352;15;112;2.0
0;4;352;357;5;112;2.0
0;5;357;361;4;112;2.0
0;6;361;363;2;112;2.0
0;7;363;371;8;112;2.0
0;8;371;373;2;112;2.0
0;9;373;383;10;112;2.0
0;10;383;388;5;112;2.0
0;11;388;392;4;112;2.0
0;12;392;393;1;112;2.0
0;13;393;407;14;112;2.0
0;14;407;423;16;112;2.0
0;15;423;424;1;112;2.0
0;16;424;428;4;112;2.0
0;17;428;431;3;112;2.0
0;18;431;433;2;112;2.0
0;19;433;452;19;112;2.0
0;20;452;453;1;112;2.0
0;21;453;455;2;112;2.0
0;22;455;465;10;112;2.0
0;23;465;467;2;112;2.0
0;24;467;476;9;112;2.0
0;25;476;482;6;112;2.0
0;26;482;483;1;112;2.0
0;27;483;488;5;112;2.0
0;28;488;498;10;112;2.0
0;29;498;505;7;112;2.0
0;30;505;518;13;112;2.0
0;31;518;538;20;112;2.0
0;32;538;543;5;112;2.0
0;33;543;551;8;112;2.0
0;34;551;553;2;112;2.0
0;35;553;574;21;112;2.0
0;36;574;577;3;112;2.0
0;37;577;591;14;112;2.0
0;38;591;593;2;112;2.0
0;39;593;598;5;112;2.0
0;40;598;619;21;112;2.0
0;41;619;620;1;112;2.0
0;42;620;628;8;112;2.0
0;43;628;633;5;112;2.0
0;44;633;658;25;112;2.0
0;45;658;661;3;112;2.0
0;46;661;685;24;112;2.0
0;47;685;694;9;112;2.0
0;48;694;703;9;112;2.0
0;49;703;713;10;112;2.0
0;50;713;718;5;112;2.0
0;51;718;726;8;112;2.0
0;52;726;739;13;112;2.0
0;53;739;740;1;112;2.0
0;54;740;753;13;112;2.0
0;55;753;763;10;112;2.0
0;56;763;766;3;112;2.0
0;57;766;778;12;112;2.0
0;58;778;794;16;112;2.0
0;59;794;796;2;112;2.0
0;60;796;799;3;112;2.0
0;61;799;804;5;112;2.0
0;62;804;818;14;112;2.0
0;63;818;823;5;112;2.0
0;64;823;836;13;112;2.0
0;65;836;838;2;112;2.0
0;66;838;851;13;112;2.0
0;67;851;857;6;112;2.0
0;68;857;859;2;112;2.0
0;69;859;866;7;112;2.0
0;70;866;881;15;112;2.0
0;71;881;883;2;112;2.0
0;72;883;891;8;112;2.0
0;73;891;898;7;112;2.0
0;74;898;903;5;112;2.0
0;75;903;904;1;112;2.0
0;76;904;911;7;112;2.0
0;77;911;913;2;112;2.0
0;78;913;914;1;112;2.0
0;79;914;916;2;112;2.0
0;80;916;919;3;112;2.0
0;81;919;925;6;112;2.0
0;82;925;933;8;112;2.0
0;83;933;943;10;112;2.0
0;84;943;946;3;112;2.0
0;85;946;963;17;112;2.0
0;86;963;964;1;112;2.0
0;87;964;971;7;112;2.0
0;88;971;973;2;112;2.0
0;89;973;974;1;112;2.0
0;90;974;976;2;112;2.0
0;91;976;979;3;112;2.0
0;92;979;984;5;112;2.0
0;93;984;1003;19;112;2.0
0;94;1003;1006;3;112;2.0
0;95;1006;1011;5;112;2.0
0;96;1011;1014;3;112;2.0
0;97;1014;1023;9;112;2.0
0;98;1023;1024;1;112;2.0
0;99;1024;1031;7;112;2.0
0;100;1031;1036;5;112;2.0
0;101;1036;1041;5;112;2.0
0;102;1041;1063;22;112;2.0
0;103;1063;1066;3;112;2.0
0;104;1066;1090;24;112;2.0
0;105;1090;1097;7;112;2.0
0;106;1097;1104;7;112;2.0
0;107;1104;1126;22;112;2.0
0;108;1126;1143;17;112;2.0
0;109;1143;1147;4;112;2.0
0;110;1147;1154;7;112;2.0
0;111;1154;1180;26;112;2.0
0;112;1180;1220;40;112;2.0
0;113;1220;1227;7;112;2.0
0;114;1227;1267;40;112;2.0
0;115;1267;1285;18;112;2.0
0;116;1285;1322;37;112;2.0
0;117;1322;1348;26;112;2.0
0;118;1348;1387;39;112;2.0
0;119;1387;1398;11;112;2.0
0;120;1398;1413;15;112;2.0
0;121;1413;1428;15;112;2.0
0;122;1428;1443;15;112;2.0
0;123;1443;1458;15;112;2.0
0;124;1458;1473;15;112;2.0
0;125;1473;1488;15;112;2.0
0;126;1488;1503;15;112;2.0
0;127;1503;1518;15;112;2.0
0;128;1518;1533;15;112;2.0
0;129;1533;1548;15;112;2.0
0;130;1548;1563;15;112;2.0
0;131;1563;1578;15;112;2.0
0;132;1578;1593;15;112;2.0
0;133;1593;1608;15;112;2.0
0;134;1608;1623;15;112;2.0
0;135;1623;1638;15;112;2.0
0;136;1638;1653;15;112;2.0
0;137;1653;1668;15;112;2.0
0;138;1668;1680;12;112;2.0
1;0;245;332;87;93;2.0
1;1;332;336;4;93;2.0
1;2;336;340;4;93;2.0
1;3;340;355;15;93;2.0
1;4;355;356;1;93;2.0
1;5;356;360;4;93;2.0
1;6;360;361;1;93;2.0
1;7;361;366;5;93;2.0
1;8;366;376;10;93;2.0
1;9;376;379;3;93;2.0
1;10;379;383;4;93;2.0
1;11;383;386;3;93;2.0
1;12;386;389;3;93;2.0
1;13;389;395;6;93;2.0
1;14;395;410;15;93;2.0
1;15;410;416;6;93;2.0
1;16;416;423;7;93;2.0
1;17;423;426;3;93;2.0
1;18;426;427;1;93;2.0
1;19;427;436;9;93;2.0
1;20;436;446;10;93;2.0
1;21;446;453;7;93;2.0
1;22;453;455;2;93;2.0
1;23;455;458;3;93;2.0
1;24;458;470;12;93;2.0
1;25;470;475;5;93;2.0
1;26;475;477;2;93;2.0
1;27;477;481;4;93;2.0
1;28;481;483;2;93;2.0
1;29;483;485;2;93;2.0
1;30;485;506;21;93;2.0
1;31;506;519;13;93;2.0
1;32;519;533;14;93;2.0
1;33;533;543;10;93;2.0
1;34;543;546;3;93;2.0
1;35;546;550;4;93;2.0
1;36;550;577;27;93;2.0
1;37;577;579;2;93;2.0
1;38;579;593;14;93;2.0
1;39;593;594;1;93;2.0
1;40;594;601;7;93;2.0
1;41;601;620;19;93;2.0
1;42;620;623;3;93;2.0
1;43;623;626;3;93;2.0
1;44;626;628;2;93;2.0
1;45;628;634;6;93;2.0
1;46;634;653;19;93;2.0
1;47;653;664;11;93;2.0
1;48;664;686;22;93;2.0
1;49;686;699;13;93;2.0
1;50;699;703;4;93;2.0
1;51;703;713;10;93;2.0
1;52;713;721;8;93;2.0
1;53;721;729;8;93;2.0
1;54;729;740;11;93;2.0
1;55;740;743;3;93;2.0
1;56;743;754;11;93;2.0
1;57;754;759;5;93;2.0
1;58;759;763;4;93;2.0
1;59;763;773;10;93;2.0
1;60;773;799;26;93;2.0
1;61;799;800;1;93;2.0
1;62;800;805;5;93;2.0
1;63;805;823;18;93;2.0
1;64;823;826;3;93;2.0
1;65;826;829;3;93;2.0
1;66;829;833;4;93;2.0
1;67;833;837;4;93;2.0
1;68;837;841;4;93;2.0
1;69;841;854;13;93;2.0
1;70;854;857;3;93;2.0
1;71;857;860;3;93;2.0
1;72;860;869;9;93;2.0
1;73;869;876;7;93;2.0
1;74;876;883;7;93;2.0
1;75;883;884;1;93;2.0
1;76;884;891;7;93;2.0
1;77;891;893;2;93;2.0
1;78;893;904;11;93;2.0
1;79;904;909;5;93;2.0
1;80;909;913;4;93;2.0
1;81;913;914;1;93;2.0
1;82;914;915;1;93;2.0
1;83;915;920;5;93;2.0
1;84;920;928;8;93;2.0
1;85;928;934;6;93;2.0
1;86;934;939;5;93;2.0
1;87;939;943;4;93;2.0
1;88;943;949;6;93;2.0
1;89;949;951;2;93;2.0
1;90;951;964;13;93;2.0
1;91;964;969;5;93;2.0
1;92;969;973;4;93;2.0
1;93;973;974;1;93;2.0
1;94;974;975;1;93;2.0
1;95;975;980;5;93;2.0
1;96;980;985;5;93;2.0
1;97;985;999;14;93;2.0
1;98;999;1003;4;93;2.0
1;99;1003;1011;8;93;2.0
1;100;1011;1019;8;93;2.0
1;101;1019;1024;5;93;2.0
1;102;1024;1025;1;93;2.0
1;103;1025;1029;4;93;2.0
1;104;1029;1033;4;93;2.0
1;105;1033;1034;1;93;2.0
1;106;1034;1059;25;93;2.0
1;107;1059;1069;10;93;2.0
1;108;1069;1071;2;93;2.0
1;109;1071;1093;22;93;2.0
1;110;1093;1098;5;93;2.0
1;111;1098;1105;7;93;2.0
1;112;1105;1119;14;93;2.0
1;113;1119;1148;29;93;2.0
1;114;1148;1155;7;93;2.0
1;115;1155;1181;26;93;2.0
1;116;1181;1223;42;93;2.0
1;117;1223;1228;5;93;2.0
1;118;1228;1275;47;93;2.0
1;119;1275;1286;11;93;2.0
1;120;1286;1325;39;93;2.0
1;121;1325;1349;24;93;2.0
1;122;1349;1395;46;93;2.0
1;123;1395;1399;4;93;2.0
1;124;1399;1414;15;93;2.0
1;125;1414;1429;15;93;2.0
1;126;1429;1444;15;93;2.0
1;127;1444;1459;15;93;2.0
1;128;1459;1474;15;93;2.0
1;129;1474;1489;15;93;2.0
1;130;1489;1504;15;93;2.0
1;131;1504;1519;15;93;2.0
1;132;1519;1534;15;93;2.0
1;133;1534;1549;15;93;2.0
1;134;1549;1564;15;93;2.0
1;135;1564;1579;15;93;2.0
1;136;1579;1594;15;93;2.0
1;137;1594;1609;15;93;2.0
1;138;1609;1624;15;93;2.0
1;139;1624;1639;15;93;2.0
1;140;1639;1654;15;93;2.0
1;141;1654;1669;15;93;2.0
1;142;1669;1680;11;93;2.0
2;0;246;331;85;92;2.0
2;1;331;336;5;92;2.0
2;2;336;339;3;92;2.0
2;3;339;354;15;92;2.0
2;4;354;355;1;92;2.0
2;5;355;359;4;92;2.0
2;6;359;360;1;92;2.0
2;7;360;365;5;92;2.0
2;8;365;375;10;92;2.0
2;9;375;379;4;92;2.0
2;10;379;382;3;92;2.0
2;11;382;385;3;92;2.0
2;12;385;388;3;92;2.0
2;13;388;394;6;92;2.0
2;14;394;409;15;92;2.0
2;15;409;415;6;92;2.0
2;16;415;422;7;92;2.0
2;17;422;425;3;92;2.0
2;18;425;426;1;92;2.0
2;19;426;435;9;92;2.0
2;20;435;436;1;92;2.0
2;21;436;445;9;92;2.0
2;22;445;452;7;92;2.0
2;23;452;454;2;92;2.0
2;24;454;457;3;92;2.0
2;25;457;458;1;92;2.0
2;26;458;469;11;92;2.0
2;27;469;476;7;92;2.0
2;28;476;480;4;92;2.0
2;29;480;482;2;92;2.0
2;30;482;484;2;92;2.0
2;31;484;505;21;92;2.0
2;32;505;506;1;92;2.0
2;33;506;518;12;92;2.0
2;34;518;532;14;92;2.0
2;35;532;542;10;92;2.0
2;36;542;545;3;92;2.0
2;37;545;549;4;92;2.0
2;38;549;576;27;92;2.0
2;39;576;578;2;92;2.0
2;40;578;592;14;92;2.0
2;41;592;593;1;92;2.0
2;42;593;601;8;92;2.0
2;43;601;619;18;92;2.0
2;44;619;623;4;92;2.0
2;45;623;625;2;92;2.0
2;46;625;627;2;92;2.0
2;47;627;633;6;92;2.0
2;48;633;652;19;92;2.0
2;49;652;663;11;92;2.0
2;50;663;685;22;92;2.0
2;51;685;698;13;92;2.0
2;52;698;702;4;92;2.0
2;53;702;712;10;92;2.0
2;54;712;721;9;92;2.0
2;55;721;728;7;92;2.0
2;56;728;739;11;92;2.0
2;57;739;743;4;92;2.0
2;58;743;753;10;92;2.0
2;59;753;758;5;92;2.0
2;60;758;762;4;92;2.0
2;61;762;772;10;92;2.0
2;62;772;798;26;92;2.0
2;63;798;799;1;92;2.0
2;64;799;804;5;92;2.0
2;65;804;822;18;92;2.0
2;66;822;826;4;92;2.0
2;67;826;828;2;92;2.0
2;68;828;832;4;92;2.0
2;69;832;836;4;92;2.0
2;70;836;840;4;92;2.0
2;71;840;853;13;92;2.0
2;72;853;856;3;92;2.0
2;73;856;859;3;92;2.0
2;74;859;868;9;92;2.0
2;75;868;875;7;92;2.0
2;76;875;882;7;92;2.0
2;77;882;883;1;92;2.0
2;78;883;891;8;92;2.0
2;79;891;892;1;92;2.0
2;80;892;903;11;92;2.0
2;81;903;908;5;92;2.0
2;82;908;912;4;92;2.0
2;83;912;913;1;92;2.0
2;84;913;914;1;92;2.0
2;85;914;919;5;92;2.0
2;86;919;928;9;92;2.0
2;87;928;933;5;92;2.0
2;88;933;938;5;92;2.0
2;89;938;942;4;92;2.0
2;90;942;948;6;92;2.0
2;91;948;951;3;92;2.0
2;92;951;963;12;92;2.0
2;93;963;968;5;92;2.0
2;94;968;972;4;92;2.0
2;95;972;973;1;92;2.0
2;96;973;974;1;92;2.0
2;97;974;979;5;92;2.0
2;98;979;984;5;92;2.0
2;99;984;998;14;92;2.0
2;100;998;1002;4;92;2.0
2;101;1002;1004;2;92;2.0
2;102;1004;1011;7;92;2.0
2;103;1011;1018;7;92;2.0
2;104;1018;1023;5;92;2.0
2;105;1023;1024;1;92;2.0
2;106;1024;1028;4;92;2.0
2;107;1028;1033;5;92;2.0
2;108;1033;1034;1;92;2.0
2;109;1034;1058;24;92;2.0
2;110;1058;1068;10;92;2.0
2;111;1068;1071;3;92;2.0
2;112;1071;1093;22;92;2.0
2;113;1093;1097;4;92;2.0
2;114;1097;1104;7;92;2.0
2;115;1104;1118;14;92;2.0
2;116;1118;1147;29;92;2.0
2;117;1147;1154;7;92;2.0
2;118;1154;1155;1;92;2.0
2;119;1155;1180;25;92;2.0
2;120;1180;1223;43;92;2.0
2;121;1223;1227;4;92;2.0
2;122;1227;1275;48;92;2.0
2;123;1275;1285;10;92;2.0
2;124;1285;1324;39;92;2.0
2;125;1324;1348;24;92;2.0
2;126;1348;1395;47;92;2.0
2;127;1395;1398;3;92;2.0
2;128;1398;1413;15;92;2.0
2;129;1413;1428;15;92;2.0
2;130;1428;1443;15;92;2.0
2;131;1443;1458;15;92;2.0
2;132;1458;1473;15;92;2.0
2;133;1473;1488;15;92;2.0
2;134;1488;1503;15;92;2.0
2;135;1503;1518;15;92;2.0
2;136;1518;1533;15;92;2.0
2;137;1533;1548;15;92;2.0
2;138;1548;1563;15;92;2.0
2;139;1563;1578;15;92;2.0
2;140;1578;1593;15;92;2.0
2;141;1593;1608;15;92;2.0
2;142;1608;1623;15;92;2.0
2;143;1623;1638;15;92;2.0
2;144;1638;1653;15;92;2.0
2;145;1653;1668;15;92;2.0
2;146;1668;1680;12;92;2.0
3;0;248;327;79;77;2.0
3;1;327;336;9;77;2.0
3;2;336;338;2;77;2.0
3;3;338;351;13;77;2.0
3;4;351;356;5;77;2.0
3;5;356;358;2;77;2.0
3;6;358;368;10;77;2.0
3;7;368;375;7;77;2.0
3;8;375;378;3;77;2.0
3;9;378;388;10;77;2.0
3;10;388;391;3;77;2.0
3;11;391;406;15;77;2.0
3;12;406;418;12;77;2.0
3;13;418;423;5;77;2.0
3;14;423;428;5;77;2.0
3;15;428;435;7;77;2.0
3;16;435;448;13;77;2.0
3;17;448;451;3;77;2.0
3;18;451;460;9;77;2.0
3;19;460;466;6;77;2.0
3;20;466;476;10;77;2.0
3;21;476;478;2;77;2.0
3;22;478;480;2;77;2.0
3;23;480;481;1;77;2.0
3;24;481;483;2;77;2.0
3;25;483;505;22;77;2.0
3;26;505;518;13;77;2.0
3;27;518;532;14;77;2.0
3;28;532;538;6;77;2.0
3;29;538;548;10;77;2.0
3;30;548;549;1;77;2.0
3;31;549;572;23;77;2.0
3;32;572;578;6;77;2.0
3;33;578;590;12;77;2.0
3;34;590;592;2;77;2.0
3;35;592;600;8;77;2.0
3;36;600;619;19;77;2.0
3;37;619;623;4;77;2.0
3;38;623;625;2;77;2.0
3;39;625;628;3;77;2.0
3;40;628;633;5;77;2.0
3;41;633;652;19;77;2.0
3;42;652;660;8;77;2.0
3;43;660;685;25;77;2.0
3;44;685;698;13;77;2.0
3;45;698;712;14;77;2.0
3;46;712;720;8;77;2.0
3;47;720;725;5;77;2.0
3;48;725;739;14;77;2.0
3;49;739;745;6;77;2.0
3;50;745;753;8;77;2.0
3;51;753;758;5;77;2.0
3;52;758;761;3;77;2.0
3;53;761;772;11;77;2.0
3;54;772;795;23;77;2.0
3;55;795;798;3;77;2.0
3;56;798;799;1;77;2.0
3;57;799;804;5;77;2.0
3;58;804;818;14;77;2.0
3;59;818;825;7;77;2.0
3;60;825;831;6;77;2.0
3;61;831;832;1;77;2.0
3;62;832;836;4;77;2.0
3;63;836;837;1;77;2.0
3;64;837;850;13;77;2.0
3;65;850;852;2;77;2.0
3;66;852;859;7;77;2.0
3;67;859;865;6;77;2.0
3;68;865;878;13;77;2.0
3;69;878;880;2;77;2.0
3;70;880;886;6;77;2.0
3;71;886;890;4;77;2.0
3;72;890;892;2;77;2.0
3;73;892;903;11;77;2.0
3;74;903;908;5;77;2.0
3;75;908;910;2;77;2.0
3;76;910;911;1;77;2.0
3;77;911;914;3;77;2.0
3;78;914;919;5;77;2.0
3;79;919;930;11;77;2.0
3;80;930;933;3;77;2.0
3;81;933;938;5;77;2.0
3;82;938;941;3;77;2.0
3;83;941;945;4;77;2.0
3;84;945;950;5;77;2.0
3;85;950;963;13;77;2.0
3;86;963;968;5;77;2.0
3;87;968;970;2;77;2.0
3;88;970;971;1;77;2.0
3;89;971;974;3;77;2.0
3;90;974;979;5;77;2.0
3;91;979;984;5;77;2.0
3;92;984;998;14;77;2.0
3;93;998;1001;3;77;2.0
3;94;1001;1008;7;77;2.0
3;95;1008;1010;2;77;2.0
3;96;1010;1018;8;77;2.0
3;97;1018;1023;5;77;2.0
3;98;1023;1024;1;77;2.0
3;99;1024;1030;6;77;2.0
3;100;1030;1031;1;77;2.0
3;101;1031;1038;7;77;2.0
3;102;1038;1061;23;77;2.0
3;103;1061;1065;4;77;2.0
3;104;1065;1070;5;77;2.0
3;105;1070;1095;25;77;2.0
3;106;1095;1097;2;77;2.0
3;107;1097;1104;7;77;2.0
3;108;1104;1121;17;77;2.0
3;109;1121;1147;26;77;2.0
3;110;1147;1154;7;77;2.0
3;111;1154;1180;26;77;2.0
3;112;1180;1225;45;77;2.0
3;113;1225;1227;2;77;2.0
3;114;1227;1274;47;77;2.0
3;115;1274;1285;11;77;2.0
3;116;1285;1321;36;77;2.0
3;117;1321;1348;27;77;2.0
3;118;1348;1394;46;77;2.0
3;119;1394;1398;4;77;2.0
3;120;1398;1413;15;77;2.0
3;121;1413;1428;15;77;2.0
3;122;1428;1443;15;77;2.0
3;123;1443;1458;15;77;2.0
3;124;1458;1473;15;77;2.0
3;125;1473;1488;15;77;2.0
3;126;1488;1503;15;77;2.0
3;127;1503;1518;15;77;2.0
3;128;1518;1533;15;77;2.0
3;129;1533;1548;15;77;2.0
3;130;1548;1563;15;77;2.0
3;131;1563;1578;15;77;2.0
3;132;1578;1593;15;77;2.0
3;133;1593;1608;15;77;2.0
3;134;1608;1623;15;77;2.0
3;135;1623;1638;15;77;2.0
3;136;1638;1653;15;77;2.0
3;137;1653;1668;15;77;2.0
3;138;1668;1680;12;77;2.0
4;0;245;331;86;119;2.0
4;1;331;336;5;119;2.0
4;2;336;337;1;119;2.0
4;3;337;352;15;119;2.0
4;4;352;357;5;119;2.0
4;5;357;360;3;119;2.0
4;6;360;367;7;119;2.0
4;7;367;373;6;119;2.0
4;8;373;377;4;119;2.0
4;9;377;382;5;119;2.0
4;10;382;386;4;119;2.0
4;11;386;387;1;119;2.0
4;12;387;392;5;119;2.0
4;13;392;407;15;119;2.0
4;14;407;417;10;119;2.0
4;15;417;422;5;119;2.0
4;16;422;424;2;119;2.0
4;17;424;427;3;119;2.0
4;18;427;433;6;119;2.0
4;19;433;434;1;119;2.0
4;20;434;447;13;119;2.0
4;21;447;452;5;119;2.0
4;22;452;458;6;119;2.0
4;23;458;459;1;119;2.0
4;24;459;467;8;119;2.0
4;25;467;474;7;119;2.0
4;26;474;477;3;119;2.0
4;27;477;482;5;119;2.0
4;28;482;503;21;119;2.0
4;29;503;504;1;119;2.0
4;30;504;516;12;119;2.0
4;31;516;532;16;119;2.0
4;32;532;542;10;119;2.0
4;33;542;547;5;119;2.0
4;34;547;576;29;119;2.0
4;35;576;591;15;119;2.0
4;36;591;592;1;119;2.0
4;37;592;599;7;119;2.0
4;38;599;617;18;119;2.0
4;39;617;623;6;119;2.0
4;40;623;627;4;119;2.0
4;41;627;631;4;119;2.0
4;42;631;652;21;119;2.0
4;43;652;661;9;119;2.0
4;44;661;683;22;119;2.0
4;45;683;696;13;119;2.0
4;46;696;702;6;119;2.0
4;47;702;712;10;119;2.0
4;48;712;719;7;119;2.0
4;49;719;726;7;119;2.0
4;50;726;737;11;119;2.0
4;51;737;743;6;119;2.0
4;52;743;751;8;119;2.0
4;53;751;760;9;119;2.0
4;54;760;762;2;119;2.0
4;55;762;772;10;119;2.0
4;56;772;796;24;119;2.0
4;57;796;797;1;119;2.0
4;58;797;802;5;119;2.0
4;59;802;822;20;119;2.0
4;60;822;824;2;119;2.0
4;61;824;830;6;119;2.0
4;62;830;832;2;119;2.0
4;63;832;834;2;119;2.0
4;64;834;838;4;119;2.0
4;65;838;851;13;119;2.0
4;66;851;856;5;119;2.0
4;67;856;857;1;119;2.0
4;68;857;866;9;119;2.0
4;69;866;877;11;119;2.0
4;70;877;881;4;119;2.0
4;71;881;882;1;119;2.0
4;72;882;885;3;119;2.0
4;73;885;889;4;119;2.0
4;74;889;892;3;119;2.0
4;75;892;901;9;119;2.0
4;76;901;906;5;119;2.0
4;77;906;910;4;119;2.0
4;78;910;911;1;119;2.0
4;79;911;912;1;119;2.0
4;80;912;917;5;119;2.0
4;81;917;928;11;119;2.0
4;82;928;931;3;119;2.0
4;83;931;940;9;119;2.0
4;84;940;942;2;119;2.0
4;85;942;946;4;119;2.0
4;86;946;949;3;119;2.0
4;87;949;961;12;119;2.0
4;88;961;966;5;119;2.0
4;89;966;970;4;119;2.0
4;90;970;971;1;119;2.0
4;91;971;972;1;119;2.0
4;92;972;977;5;119;2.0
4;93;977;982;5;119;2.0
4;94;982;1000;18;119;2.0
4;95;1000;1002;2;119;2.0
4;96;1002;1005;3;119;2.0
4;97;1005;1009;4;119;2.0
4;98;1009;1016;7;119;2.0
4;99;1016;1021;5;119;2.0
4;100;1021;1022;1;119;2.0
4;101;1022;1030;8;119;2.0
4;102;1030;1031;1;119;2.0
4;103;1031;1035;4;119;2.0
4;104;1035;1060;25;119;2.0
4;105;1060;1066;6;119;2.0
4;106;1066;1069;3;119;2.0
4;107;1069;1093;24;119;2.0
4;108;1093;1095;2;119;2.0
4;109;1095;1102;7;119;2.0
4;110;1102;1120;18;119;2.0
4;111;1120;1145;25;119;2.0
4;112;1145;1152;7;119;2.0
4;113;1152;1153;1;119;2.0
4;114;1153;1178;25;119;2.0
4;115;1178;1223;45;119;2.0
4;116;1223;1225;2;119;2.0
4;117;1225;1273;48;119;2.0
4;118;1273;1283;10;119;2.0
4;119;1283;1322;39;119;2.0
4;120;1322;1346;24;119;2.0
4;121;1346;1393;47;119;2.0
4;122;1393;1396;3;119;2.0
4;123;1396;1411;15;119;2.0
4;124;1411;1426;15;119;2.0
4;125;1426;1441;15;119;2.0
4;126;1441;1456;15;119;2.0
4;127;1456;1471;15;119;2.0
4;128;1471;1486;15;119;2.0
4;129;1486;1501;15;119;2.0
4;130;1501;1516;15;119;2.0
4;131;1516;1531;15;119;2.0
4;132;1531;1546;15;119;2.0
4;133;1546;1561;15;119;2.0
4;134;1561;1576;15;119;2.0
4;135;1576;1591;15;119;2.0
4;136;1591;1606;15;119;2.0
4;137;1606;1621;15;119;2.0
4;138;1621;1636;15;119;2.0
4;139;1636;1651;15;119;2.0
4;140;1651;1666;15;119;2.0
4;141;1666;1680;14;119;2.0
5;0;243;333;90;96;2.0
5;1;333;334;1;96;2.0
5;2;334;339;5;96;2.0
5;3;339;354;15;96;2.0
5;4;354;357;3;96;2.0
5;5;357;359;2;96;2.0
5;6;359;362;3;96;2.0
5;7;362;367;5;96;2.0
5;8;367;374;7;96;2.0
5;9;374;379;5;96;2.0
5;10;379;384;5;96;2.0
5;11;384;387;3;96;2.0
5;12;387;394;7;96;2.0
5;13;394;409;15;96;2.0
5;14;409;417;8;96;2.0
5;15;417;424;7;96;2.0
5;16;424;426;2;96;2.0
5;17;426;427;1;96;2.0
5;18;427;434;7;96;2.0
5;19;434;436;2;96;2.0
5;20;436;447;11;96;2.0
5;21;447;454;7;96;2.0
5;22;454;456;2;96;2.0
5;23;456;459;3;96;2.0
5;24;459;469;10;96;2.0
5;25;469;475;6;96;2.0
5;26;475;476;1;96;2.0
5;27;476;482;6;96;2.0
5;28;482;484;2;96;2.0
5;29;484;504;20;96;2.0
5;30;504;506;2;96;2.0
5;31;506;517;11;96;2.0
5;32;517;534;17;96;2.0
5;33;534;544;10;96;2.0
5;34;544;547;3;96;2.0
5;35;547;549;2;96;2.0
5;36;549;577;28;96;2.0
5;37;577;578;1;96;2.0
5;38;578;593;15;96;2.0
5;39;593;594;1;96;2.0
5;40;594;601;7;96;2.0
5;41;601;618;17;96;2.0
5;42;618;621;3;96;2.0
5;43;621;627;6;96;2.0
5;44;627;629;2;96;2.0
5;45;629;632;3;96;2.0
5;46;632;654;22;96;2.0
5;47;654;663;9;96;2.0
5;48;663;684;21;96;2.0
5;49;684;697;13;96;2.0
5;50;697;704;7;96;2.0
5;51;704;714;10;96;2.0
5;52;714;721;7;96;2.0
5;53;721;728;7;96;2.0
5;54;728;738;10;96;2.0
5;55;738;741;3;96;2.0
5;56;741;752;11;96;2.0
5;57;752;760;8;96;2.0
5;58;760;764;4;96;2.0
5;59;764;774;10;96;2.0
5;60;774;797;23;96;2.0
5;61;797;798;1;96;2.0
5;62;798;803;5;96;2.0
5;63;803;824;21;96;2.0
5;64;824;826;2;96;2.0
5;65;826;830;4;96;2.0
5;66;830;834;4;96;2.0
5;67;834;835;1;96;2.0
5;68;835;840;5;96;2.0
5;69;840;853;13;96;2.0
5;70;853;858;5;96;2.0
5;71;858;868;10;96;2.0
5;72;868;877;9;96;2.0
5;73;877;883;6;96;2.0
5;74;883;884;1;96;2.0
5;75;884;885;1;96;2.0
5;76;885;891;6;96;2.0
5;77;891;894;3;96;2.0
5;78;894;902;8;96;2.0
5;79;902;907;5;96;2.0
5;80;907;910;3;96;2.0
5;81;910;913;3;96;2.0
5;82;913;914;1;96;2.0
5;83;914;918;4;96;2.0
5;84;918;926;8;96;2.0
5;85;926;932;6;96;2.0
5;86;932;940;8;96;2.0
5;87;940;944;4;96;2.0
5;88;944;948;4;96;2.0
5;89;948;951;3;96;2.0
5;90;951;962;11;96;2.0
5;91;962;967;5;96;2.0
5;92;967;970;3;96;2.0
5;93;970;973;3;96;2.0
5;94;973;974;1;96;2.0
5;95;974;978;4;96;2.0
5;96;978;983;5;96;2.0
5;97;983;1000;17;96;2.0
5;98;1000;1004;4;96;2.0
5;99;1004;1011;7;96;2.0
5;100;1011;1017;6;96;2.0
5;101;1017;1022;5;96;2.0
5;102;1022;1023;1;96;2.0
5;103;1023;1030;7;96;2.0
5;104;1030;1033;3;96;2.0
5;105;1033;1034;1;96;2.0
5;106;1034;1060;26;96;2.0
5;107;1060;1068;8;96;2.0
5;108;1068;1071;3;96;2.0
5;109;1071;1091;20;96;2.0
5;110;1091;1096;5;96;2.0
5;111;1096;1103;7;96;2.0
5;112;1103;1120;17;96;2.0
5;113;1120;1146;26;96;2.0
5;114;1146;1153;7;96;2.0
5;115;1153;1155;2;96;2.0
5;116;1155;1179;24;96;2.0
5;117;1179;1221;42;96;2.0
5;118;1221;1226;5;96;2.0
5;119;1226;1275;49;96;2.0
5;120;1275;1284;9;96;2.0
5;121;1284;1324;40;96;2.0
5;122;1324;1347;23;96;2.0
5;123;1347;1395;48;96;2.0
5;124;1395;1397;2;96;2.0
5;125;1397;1412;15;96;2.0
5;126;1412;1427;15;96;2.0
5;127;1427;1442;15;96;2.0
5;128;1442;1457;15;96;2.0
5;129;1457;1472;15;96;2.0
5;130;1472;1487;15;96;2.0
5;131;1487;1502;15;96;2.0
5;132;1502;1517;15;96;2.0
5;133;1517;1532;15;96;2.0
5;134;1532;1547;15;96;2.0
5;135;1547;1562;15;96;2.0
5;136;1562;1577;15;96;2.0
5;137;1577;1592;15;96;2.0
5;138;1592;1607;15;96;2.0
5;139;1607;1622;15;96;2.0
5;140;1622;1637;15;96;2.0
5;141;1637;1652;15;96;2.0
5;142;1652;1667;15;96;2.0
5;143;1667;1680;13;96;2.0
6;0;252;321;69;160;2.0
6;1;321;334;13;160;2.0
6;2;334;341;7;160;2.0
6;3;341;349;8;160;2.0
6;4;349;350;1;160;2.0
6;5;350;354;4;160;2.0
6;6;354;363;9;160;2.0
6;7;363;372;9;160;2.0
6;8;372;373;1;160;2.0
6;9;373;378;5;160;2.0
6;10;378;381;3;160;2.0
6;11;381;389;8;160;2.0
6;12;389;393;4;160;2.0
6;13;393;394;1;160;2.0
6;14;394;404;10;160;2.0
6;15;404;412;8;160;2.0
6;16;412;421;9;160;2.0
6;17;421;423;2;160;2.0
6;18;423;433;10;160;2.0
6;19;433;438;5;160;2.0
6;20;438;442;4;160;2.0
6;21;442;449;7;160;2.0
6;22;449;453;4;160;2.0
6;23;453;463;10;160;2.0
6;24;463;464;1;160;2.0
6;25;464;465;1;160;2.0
6;26;465;472;7;160;2.0
6;27;472;479;7;160;2.0
6;28;479;482;3;160;2.0
6;29;482;485;3;160;2.0
6;30;485;488;3;160;2.0
6;31;488;508;20;160;2.0
6;32;508;511;3;160;2.0
6;33;511;524;13;160;2.0
6;34;524;532;8;160;2.0
6;35;532;537;5;160;2.0
6;36;537;553;16;160;2.0
6;37;553;554;1;160;2.0
6;38;554;566;12;160;2.0
6;39;566;581;15;160;2.0
6;40;581;588;7;160;2.0
6;41;588;597;9;160;2.0
6;42;597;603;6;160;2.0
6;43;603;617;14;160;2.0
6;44;617;625;8;160;2.0
6;45;625;628;3;160;2.0
6;46;628;633;5;160;2.0
6;47;633;639;6;160;2.0
6;48;639;657;18;160;2.0
6;49;657;658;1;160;2.0
6;50;658;691;33;160;2.0
6;51;691;692;1;160;2.0
6;52;692;701;9;160;2.0
6;53;701;717;16;160;2.0
6;54;717;723;6;160;2.0
6;55;723;745;22;160;2.0
6;56;745;748;3;160;2.0
6;57;748;752;4;160;2.0
6;58;752;759;7;160;2.0
6;59;759;766;7;160;2.0
6;60;766;777;11;160;2.0
6;61;777;793;16;160;2.0
6;62;793;801;8;160;2.0
6;63;801;805;4;160;2.0
6;64;805;810;5;160;2.0
6;65;810;812;2;160;2.0
6;66;812;828;16;160;2.0
6;67;828;835;7;160;2.0
6;68;835;836;1;160;2.0
6;69;836;837;1;160;2.0
6;70;837;842;5;160;2.0
6;71;842;846;4;160;2.0
6;72;846;848;2;160;2.0
6;73;848;863;15;160;2.0
6;74;863;865;2;160;2.0
6;75;865;872;7;160;2.0
6;76;872;878;6;160;2.0
6;77;878;883;5;160;2.0
6;78;883;891;8;160;2.0
6;79;891;893;2;160;2.0
6;80;893;897;4;160;2.0
6;81;897;902;5;160;2.0
6;82;902;908;6;160;2.0
6;83;908;909;1;160;2.0
6;84;909;911;2;160;2.0
6;85;911;916;5;160;2.0
6;86;916;920;4;160;2.0
6;87;920;925;5;160;2.0
6;88;925;932;7;160;2.0
6;89;932;933;1;160;2.0
6;90;933;939;6;160;2.0
6;91;939;943;4;160;2.0
6;92;943;946;3;160;2.0
6;93;946;953;7;160;2.0
6;94;953;962;9;160;2.0
6;95;962;968;6;160;2.0
6;96;968;969;1;160;2.0
6;97;969;971;2;160;2.0
6;98;971;976;5;160;2.0
6;99;976;980;4;160;2.0
6;100;980;985;5;160;2.0
6;101;985;990;5;160;2.0
6;102;990;992;2;160;2.0
6;103;992;1006;14;160;2.0
6;104;1006;1013;7;160;2.0
6;105;1013;1021;8;160;2.0
6;106;1021;1028;7;160;2.0
6;107;1028;1029;1;160;2.0
6;108;1029;1030;1;160;2.0
6;109;1030;1036;6;160;2.0
6;110;1036;1043;7;160;2.0
6;111;1043;1063;20;160;2.0
6;112;1063;1066;3;160;2.0
6;113;1066;1073;7;160;2.0
6;114;1073;1098;25;160;2.0
6;115;1098;1103;5;160;2.0
6;116;1103;1110;7;160;2.0
6;117;1110;1126;16;160;2.0
6;118;1126;1150;24;160;2.0
6;119;1150;1157;7;160;2.0
6;120;1157;1160;3;160;2.0
6;121;1160;1186;26;160;2.0
6;122;1186;1228;42;160;2.0
6;123;1228;1233;5;160;2.0
6;124;1233;1277;44;160;2.0
6;125;1277;1291;14;160;2.0
6;126;1291;1319;28;160;2.0
6;127;1319;1354;35;160;2.0
6;128;1354;1397;43;160;2.0
6;129;1397;1404;7;160;2.0
6;130;1404;1419;15;160;2.0
6;131;1419;1434;15;160;2.0
6;132;1434;1449;15;160;2.0
6;133;1449;1464;15;160;2.0
6;134;1464;1479;15;160;2.0
6;135;1479;1494;15;160;2.0
6;136;1494;1509;15;160;2.0
6;137;1509;1524;15;160;2.0
6;138;1524;1539;15;160;2.0
6;139;1539;1554;15;160;2.0
6;140;1554;1569;15;160;2.0
6;141;1569;1584;15;160;2.0
6;142;1584;1599;15;160;2.0
6;143;1599;1614;15;160;2.0
6;144;1614;1629;15;160;2.0
6;145;1629;1644;15;160;2.0
6;146;1644;1659;15;160;2.0
6;147;1659;1680;21;160;2.0
7;0;250;328;78;1;2.0
7;1;328;333;5;1;2.0
7;2;333;339;6;1;2.0
7;3;339;348;9;1;2.0
7;4;348;353;5;1;2.0
7;5;353;357;4;1;2.0
7;6;357;364;7;1;2.0
7;7;364;374;10;1;2.0
7;8;374;376;2;1;2.0
7;9;376;378;2;1;2.0
7;10;378;379;1;1;2.0
7;11;379;388;9;1;2.0
7;12;388;392;4;1;2.0
7;13;392;394;2;1;2.0
7;14;394;403;9;1;2.0
7;15;403;419;16;1;2.0
7;16;419;420;1;1;2.0
7;17;420;424;4;1;2.0
7;18;424;434;10;1;2.0
7;19;434;435;1;1;2.0
7;20;435;436;1;1;2.0
7;21;436;448;12;1;2.0
7;22;448;449;1;1;2.0
7;23;449;454;5;1;2.0
7;24;454;461;7;1;2.0
7;25;461;463;2;1;2.0
7;26;463;466;3;1;2.0
7;27;466;478;12;1;2.0
7;28;478;479;1;1;2.0
7;29;479;480;1;1;2.0
7;30;480;485;5;1;2.0
7;31;485;489;4;1;2.0
7;32;489;505;16;1;2.0
7;33;505;509;4;1;2.0
7;34;509;522;13;1;2.0
7;35;522;537;15;1;2.0
7;36;537;539;2;1;2.0
7;37;539;553;14;1;2.0
7;38;553;554;1;1;2.0
7;39;554;573;19;1;2.0
7;40;573;579;6;1;2.0
7;41;579;587;8;1;2.0
7;42;587;597;10;1;2.0
7;43;597;600;3;1;2.0
7;44;600;623;23;1;2.0
7;45;623;624;1;1;2.0
7;46;624;626;2;1;2.0
7;47;626;634;8;1;2.0
7;48;634;637;3;1;2.0
7;49;637;657;20;1;2.0
7;50;657;689;32;1;2.0
7;51;689;699;10;1;2.0
7;52;699;717;18;1;2.0
7;53;717;720;3;1;2.0
7;54;720;722;2;1;2.0
7;55;722;743;21;1;2.0
7;56;743;746;3;1;2.0
7;57;746;757;11;1;2.0
7;58;757;759;2;1;2.0
7;59;759;767;8;1;2.0
7;60;767;777;10;1;2.0
7;61;777;792;15;1;2.0
7;62;792;799;7;1;2.0
7;63;799;803;4;1;2.0
7;64;803;808;5;1;2.0
7;65;808;819;11;1;2.0
7;66;819;825;6;1;2.0
7;67;825;834;9;1;2.0
7;68;834;837;3;1;2.0
7;69;837;840;3;1;2.0
7;70;840;847;7;1;2.0
7;71;847;853;6;1;2.0
7;72;853;862;9;1;2.0
7;73;862;863;1;1;2.0
7;74;863;877;14;1;2.0
7;75;877;879;2;1;2.0
7;76;879;884;5;1;2.0
7;77;884;890;6;1;2.0
7;78;890;892;2;1;2.0
7;79;892;897;5;1;2.0
7;80;897;907;10;1;2.0
7;81;907;909;2;1;2.0
7;82;909;917;8;1;2.0
7;83;917;918;1;1;2.0
7;84;918;923;5;1;2.0
7;85;923;931;8;1;2.0
7;86;931;937;6;1;2.0
7;87;937;939;2;1;2.0
7;88;939;942;3;1;2.0
7;89;942;947;5;1;2.0
7;90;947;950;3;1;2.0
7;91;950;967;17;1;2.0
7;92;967;969;2;1;2.0
7;93;969;977;8;1;2.0
7;94;977;978;1;1;2.0
7;95;978;983;5;1;2.0
7;96;983;988;5;1;2.0
7;97;988;999;11;1;2.0
7;98;999;1007;8;1;2.0
7;99;1007;1010;3;1;2.0
7;100;1010;1013;3;1;2.0
7;101;1013;1019;6;1;2.0
7;102;1019;1027;8;1;2.0
7;103;1027;1028;1;1;2.0
7;104;1028;1037;9;1;2.0
7;105;1037;1043;6;1;2.0
7;106;1043;1062;19;1;2.0
7;107;1062;1067;5;1;2.0
7;108;1067;1070;3;1;2.0
7;109;1070;1096;26;1;2.0
7;110;1096;1101;5;1;2.0
7;111;1101;1108;7;1;2.0
7;112;1108;1127;19;1;2.0
7;113;1127;1148;21;1;2.0
7;114;1148;1154;6;1;2.0
7;115;1154;1158;4;1;2.0
7;116;1158;1184;26;1;2.0
7;117;1184;1226;42;1;2.0
7;118;1226;1231;5;1;2.0
7;119;1231;1274;43;1;2.0
7;120;1274;1289;15;1;2.0
7;121;1289;1318;29;1;2.0
7;122;1318;1352;34;1;2.0
7;123;1352;1394;42;1;2.0
7;124;1394;1402;8;1;2.0
7;125;1402;1417;15;1;2.0
7;126;1417;1432;15;1;2.0
7;127;1432;1447;15;1;2.0
7;128;1447;1462;15;1;2.0
7;129;1462;1477;15;1;2.0
7;130;1477;1492;15;1;2.0
7;131;1492;1507;15;1;2.0
7;132;1507;1522;15;1;2.0
7;133;1522;1537;15;1;2.0
7;134;1537;1552;15;1;2.0
7;135;1552;1567;15;1;2.0
7;136;1567;1582;15;1;2.0
7;137;1582;1597;15;1;2.0
7;138;1597;1612;15;1;2.0
7;139;1612;1627;15;1;2.0
7;140;1627;1642;15;1;2.0
7;141;1642;1657;15;1;2.0
7;142;1657;1680;23;1;2.0
8;0;250;332;82;43;2.0
8;1;332;337;5;43;2.0
8;2;337;344;7;43;2.0
8;3;344;359;15;43;2.0
8;4;359;364;5;43;2.0
8;5;364;366;2;43;2.0
8;6;366;367;1;43;2.0
8;7;367;372;5;43;2.0
8;8;372;377;5;43;2.0
8;9;377;388;11;43;2.0
8;10;388;389;1;43;2.0
8;11;389;397;8;43;2.0
8;12;397;399;2;43;2.0
8;13;399;414;15;43;2.0
8;14;414;427;13;43;2.0
8;15;427;428;1;43;2.0
8;16;428;429;1;43;2.0
8;17;429;431;2;43;2.0
8;18;431;437;6;43;2.0
8;19;437;454;17;43;2.0
8;20;454;457;3;43;2.0
8;21;457;458;1;43;2.0
8;22;458;459;1;43;2.0
8;23;459;469;10;43;2.0
8;24;469;474;5;43;2.0
8;25;474;477;3;43;2.0
8;26;477;486;9;43;2.0
8;27;486;488;2;43;2.0
8;28;488;489;1;43;2.0
8;29;489;492;3;43;2.0
8;30;492;499;7;43;2.0
8;31;499;506;7;43;2.0
8;32;506;519;13;43;2.0
8;33;519;542;23;43;2.0
8;34;542;548;6;43;2.0
8;35;548;554;6;43;2.0
8;36;554;557;3;43;2.0
8;37;557;570;13;43;2.0
8;38;570;582;12;43;2.0
8;39;582;594;12;43;2.0
8;40;594;598;4;43;2.0
8;41;598;602;4;43;2.0
8;42;602;619;17;43;2.0
8;43;619;620;1;43;2.0
8;44;620;633;13;43;2.0
8;45;633;634;1;43;2.0
8;46;634;637;3;43;2.0
8;47;637;662;25;43;2.0
8;48;662;668;6;43;2.0
8;49;668;686;18;43;2.0
8;50;686;690;4;43;2.0
8;51;690;708;18;43;2.0
8;52;708;714;6;43;2.0
8;53;714;722;8;43;2.0
8;54;722;733;11;43;2.0
8;55;733;739;6;43;2.0
8;56;739;740;1;43;2.0
8;57;740;754;14;43;2.0
8;58;754;768;14;43;2.0
8;59;768;770;2;43;2.0
8;60;770;782;12;43;2.0
8;61;782;790;8;43;2.0
8;62;790;800;10;43;2.0
8;63;800;803;3;43;2.0
8;64;803;805;2;43;2.0
8;65;805;819;14;43;2.0
8;66;819;828;9;43;2.0
8;67;828;837;9;43;2.0
8;68;837;840;3;43;2.0
8;69;840;842;2;43;2.0
8;70;842;845;3;43;2.0
8;71;845;858;13;43;2.0
8;72;858;860;2;43;2.0
8;73;860;862;2;43;2.0
8;74;862;873;11;43;2.0
8;75;873;884;11;43;2.0
8;76;884;887;3;43;2.0
8;77;887;888;1;43;2.0
8;78;888;895;7;43;2.0
8;79;895;900;5;43;2.0
8;80;900;902;2;43;2.0
8;81;902;904;2;43;2.0
8;82;904;915;11;43;2.0
8;83;915;918;3;43;2.0
8;84;918;920;2;43;2.0
8;85;920;924;4;43;2.0
8;86;924;934;10;43;2.0
8;87;934;944;10;43;2.0
8;88;944;948;4;43;2.0
8;89;948;950;2;43;2.0
8;90;950;953;3;43;2.0
8;91;953;960;7;43;2.0
8;92;960;964;4;43;2.0
8;93;964;975;11;43;2.0
8;94;975;978;3;43;2.0
8;95;978;980;2;43;2.0
8;96;980;985;5;43;2.0
8;97;985;1004;19;43;2.0
8;98;1004;1008;4;43;2.0
8;99;1008;1010;2;43;2.0
8;100;1010;1014;4;43;2.0
8;101;1014;1024;10;43;2.0
8;102;1024;1025;1;43;2.0
8;103;1025;1038;13;43;2.0
8;104;1038;1040;2;43;2.0
8;105;1040;1044;4;43;2.0
8;106;1044;1064;20;43;2.0
8;107;1064;1070;6;43;2.0
8;108;1070;1073;3;43;2.0
8;109;1073;1089;16;43;2.0
8;110;1089;1098;9;43;2.0
8;111;1098;1105;7;43;2.0
8;112;1105;1130;25;43;2.0
8;113;1130;1139;9;43;2.0
8;114;1139;1148;9;43;2.0
8;115;1148;1155;7;43;2.0
8;116;1155;1181;26;43;2.0
8;117;1181;1219;38;43;2.0
8;118;1219;1228;9;43;2.0
8;119;1228;1268;40;43;2.0
8;120;1268;1286;18;43;2.0
8;121;1286;1329;43;43;2.0
8;122;1329;1349;20;43;2.0
8;123;1349;1388;39;43;2.0
8;124;1388;1399;11;43;2.0
8;125;1399;1414;15;43;2.0
8;126;1414;1429;15;43;2.0
8;127;1429;1444;15;43;2.0
8;128;1444;1459;15;43;2.0
8;129;1459;1474;15;43;2.0
8;130;1474;1489;15;43;2.0
8;131;1489;1504;15;43;2.0
8;132;1504;1519;15;43;2.0
8;133;1519;1534;15;43;2.0
8;134;1534;1549;15;43;2.0
8;135;1549;1564;15;43;2.0
8;136;1564;1579;15;43;2.0
8;137;1579;1594;15;43;2.0
8;138;1594;1609;15;43;2.0
8;139;1609;1624;15;43;2.0
8;140;1624;1639;15;43;2.0
8;141;1639;1654;15;43;2.0
8;142;1654;1669;15;43;2.0
8;143;1669;1680;11;43;2.0
9;0;250;328;78;4;2.0
9;1;328;333;5;4;2.0
9;2;333;337;4;4;2.0
9;3;337;348;11;4;2.0
9;4;348;353;5;4;2.0
9;5;353;357;4;4;2.0
9;6;357;364;7;4;2.0
9;7;364;374;10;4;2.0
9;8;374;375;1;4;2.0
9;9;375;376;1;4;2.0
9;10;376;379;3;4;2.0
9;11;379;388;9;4;2.0
9;12;388;390;2;4;2.0
9;13;390;394;4;4;2.0
9;14;394;403;9;4;2.0
9;15;403;419;16;4;2.0
9;16;419;420;1;4;2.0
9;17;420;424;4;4;2.0
9;18;424;433;9;4;2.0
9;19;433;434;1;4;2.0
9;20;434;435;1;4;2.0
9;21;435;448;13;4;2.0
9;22;448;449;1;4;2.0
9;23;449;454;5;4;2.0
9;24;454;459;5;4;2.0
9;25;459;463;4;4;2.0
9;26;463;466;3;4;2.0
9;27;466;478;12;4;2.0
9;28;478;479;1;4;2.0
9;29;479;485;6;4;2.0
9;30;485;489;4;4;2.0
9;31;489;503;14;4;2.0
9;32;503;507;4;4;2.0
9;33;507;520;13;4;2.0
9;34;520;537;17;4;2.0
9;35;537;539;2;4;2.0
9;36;539;552;13;4;2.0
9;37;552;554;2;4;2.0
9;38;554;573;19;4;2.0
9;39;573;578;5;4;2.0
9;40;578;587;9;4;2.0
9;41;587;597;10;4;2.0
9;42;597;598;1;4;2.0
9;43;598;621;23;4;2.0
9;44;621;624;3;4;2.0
9;45;624;634;10;4;2.0
9;46;634;635;1;4;2.0
9;47;635;657;22;4;2.0
9;48;657;687;30;4;2.0
9;49;687;698;11;4;2.0
9;50;698;699;1;4;2.0
9;51;699;717;18;4;2.0
9;52;717;718;1;4;2.0
9;53;718;722;4;4;2.0
9;54;722;741;19;4;2.0
9;55;741;744;3;4;2.0
9;56;744;755;11;4;2.0
9;57;755;759;4;4;2.0
9;58;759;767;8;4;2.0
9;59;767;777;10;4;2.0
9;60;777;792;15;4;2.0
9;61;792;798;6;4;2.0
9;62;798;801;3;4;2.0
9;63;801;806;5;4;2.0
9;64;806;819;13;4;2.0
9;65;819;823;4;4;2.0
9;66;823;834;11;4;2.0
9;67;834;837;3;4;2.0
9;68;837;838;1;4;2.0
9;69;838;847;9;4;2.0
9;70;847;853;6;4;2.0
9;71;853;861;8;4;2.0
9;72;861;862;1;4;2.0
9;73;862;877;15;4;2.0
9;74;877;879;2;4;2.0
9;75;879;884;5;4;2.0
9;76;884;888;4;4;2.0
9;77;888;892;4;4;2.0
9;78;892;897;5;4;2.0
9;79;897;905;8;4;2.0
9;80;905;907;2;4;2.0
9;81;907;908;1;4;2.0
9;82;908;909;1;4;2.0
9;83;909;916;7;4;2.0
9;84;916;917;1;4;2.0
9;85;917;921;4;4;2.0
9;86;921;929;8;4;2.0
9;87;929;935;6;4;2.0
9;88;935;939;4;4;2.0
9;89;939;942;3;4;2.0
9;90;942;947;5;4;2.0
9;91;947;948;1;4;2.0
9;92;948;965;17;4;2.0
9;93;965;967;2;4;2.0
9;94;967;968;1;4;2.0
9;95;968;969;1;4;2.0
9;96;969;976;7;4;2.0
9;97;976;977;1;4;2.0
9;98;977;981;4;4;2.0
9;99;981;986;5;4;2.0
9;100;986;999;13;4;2.0
9;101;999;1007;8;4;2.0
9;102;1007;1008;1;4;2.0
9;103;1008;1013;5;4;2.0
9;104;1013;1018;5;4;2.0
9;105;1018;1025;7;4;2.0
9;106;1025;1026;1;4;2.0
9;107;1026;1027;1;4;2.0
9;108;1027;1037;10;4;2.0
9;109;1037;1043;6;4;2.0
9;110;1043;1062;19;4;2.0
9;111;1062;1067;5;4;2.0
9;112;1067;1068;1;4;2.0
9;113;1068;1094;26;4;2.0
9;114;1094;1099;5;4;2.0
9;115;1099;1106;7;4;2.0
9;116;1106;1127;21;4;2.0
9;117;1127;1147;20;4;2.0
9;118;1147;1152;5;4;2.0
9;119;1152;1156;4;4;2.0
9;120;1156;1182;26;4;2.0
9;121;1182;1224;42;4;2.0
9;122;1224;1229;5;4;2.0
9;123;1229;1272;43;4;2.0
9;124;1272;1287;15;4;2.0
9;125;1287;1318;31;4;2.0
9;126;1318;1350;32;4;2.0
9;127;1350;1392;42;4;2.0
9;128;1392;1400;8;4;2.0
9;129;1400;1415;15;4;2.0
9;130;1415;1430;15;4;2.0
9;131;1430;1445;15;4;2.0
9;132;1445;1460;15;4;2.0
9;133;1460;1475;15;4;2.0
9;134;1475;1490;15;4;2.0
9;135;1490;1505;15;4;2.0
9;136;1505;1520;15;4;2.0
9;137;1520;1535;15;4;2.0
9;138;1535;1550;15;4;2.0
9;139;1550;1565;15;4;2.0
9;140;1565;1580;15;4;2.0
9;141;1580;1595;15;4;2.0
9;142;1595;1610;15;4;2.0
9;143;1610;1625;15;4;2.0
9;144;1625;1640;15;4;2.0
9;145;1640;1655;15;4;2.0
9;146;1655;1670;15;4;2.0
9;147;1670;1680;10;4;2.0
10;0;252;332;80;11;2.0
10;1;332;338;6;11;2.0
10;2;338;344;6;11;2.0
10;3;344;359;15;11;2.0
10;4;359;364;5;11;2.0
10;5;364;367;3;11;2.0
10;6;367;368;1;11;2.0
10;7;368;371;3;11;2.0
10;8;371;378;7;11;2.0
10;9;378;389;11;11;2.0
10;10;389;390;1;11;2.0
10;11;390;398;8;11;2.0
10;12;398;399;1;11;2.0
10;13;399;414;15;11;2.0
10;14;414;428;14;11;2.0
10;15;428;429;1;11;2.0
10;16;429;431;2;11;2.0
10;17;431;435;4;11;2.0
10;18;435;438;3;11;2.0
10;19;438;454;16;11;2.0
10;20;454;458;4;11;2.0
10;21;458;459;1;11;2.0
10;22;459;470;11;11;2.0
10;23;470;474;4;11;2.0
10;24;474;478;4;11;2.0
10;25;478;486;8;11;2.0
10;26;486;489;3;11;2.0
10;27;489;493;4;11;2.0
10;28;493;505;12;11;2.0
10;29;505;507;2;11;2.0
10;30;507;520;13;11;2.0
10;31;520;543;23;11;2.0
10;32;543;549;6;11;2.0
10;33;549;555;6;11;2.0
10;34;555;558;3;11;2.0
10;35;558;574;16;11;2.0
10;36;574;583;9;11;2.0
10;37;583;598;15;11;2.0
10;38;598;600;2;11;2.0
10;39;600;603;3;11;2.0
10;40;603;619;16;11;2.0
10;41;619;621;2;11;2.0
10;42;621;634;13;11;2.0
10;43;634;635;1;11;2.0
10;44;635;638;3;11;2.0
10;45;638;663;25;11;2.0
10;46;663;668;5;11;2.0
10;47;668;687;19;11;2.0
10;48;687;694;7;11;2.0
10;49;694;709;15;11;2.0
10;50;709;720;11;11;2.0
10;51;720;723;3;11;2.0
10;52;723;733;10;11;2.0
10;53;733;739;6;11;2.0
10;54;739;741;2;11;2.0
10;55;741;755;14;11;2.0
10;56;755;769;14;11;2.0
10;57;769;771;2;11;2.0
10;58;771;783;12;11;2.0
10;59;783;794;11;11;2.0
10;60;794;801;7;11;2.0
10;61;801;803;2;11;2.0
10;62;803;806;3;11;2.0
10;63;806;825;19;11;2.0
10;64;825;829;4;11;2.0
10;65;829;838;9;11;2.0
10;66;838;841;3;11;2.0
10;67;841;843;2;11;2.0
10;68;843;845;2;11;2.0
10;69;845;858;13;11;2.0
10;70;858;861;3;11;2.0
10;71;861;863;2;11;2.0
10;72;863;873;10;11;2.0
10;73;873;888;15;11;2.0
10;74;888;889;1;11;2.0
10;75;889;890;1;11;2.0
10;76;890;896;6;11;2.0
10;77;896;903;7;11;2.0
10;78;903;904;1;11;2.0
10;79;904;905;1;11;2.0
10;80;905;916;11;11;2.0
10;81;916;918;2;11;2.0
10;82;918;919;1;11;2.0
10;83;919;921;2;11;2.0
10;84;921;924;3;11;2.0
10;85;924;935;11;11;2.0
10;86;935;949;14;11;2.0
10;87;949;950;1;11;2.0
10;88;950;951;1;11;2.0
10;89;951;953;2;11;2.0
10;90;953;964;11;11;2.0
10;91;964;965;1;11;2.0
10;92;965;976;11;11;2.0
10;93;976;978;2;11;2.0
10;94;978;979;1;11;2.0
10;95;979;981;2;11;2.0
10;96;981;986;5;11;2.0
10;97;986;1009;23;11;2.0
10;98;1009;1010;1;11;2.0
10;99;1010;1011;1;11;2.0
10;100;1011;1014;3;11;2.0
10;101;1014;1025;11;11;2.0
10;102;1025;1026;1;11;2.0
10;103;1026;1038;12;11;2.0
10;104;1038;1041;3;11;2.0
10;105;1041;1044;3;11;2.0
10;106;1044;1070;26;11;2.0
10;107;1070;1071;1;11;2.0
10;108;1071;1073;2;11;2.0
10;109;1073;1089;16;11;2.0
10;110;1089;1099;10;11;2.0
10;111;1099;1106;7;11;2.0
10;112;1106;1131;25;11;2.0
10;113;1131;1143;12;11;2.0
10;114;1143;1154;11;11;2.0
10;115;1154;1156;2;11;2.0
10;116;1156;1182;26;11;2.0
10;117;1182;1219;37;11;2.0
10;118;1219;1229;10;11;2.0
10;119;1229;1274;45;11;2.0
10;120;1274;1287;13;11;2.0
10;121;1287;1329;42;11;2.0
10;122;1329;1350;21;11;2.0
10;123;1350;1394;44;11;2.0
10;124;1394;1400;6;11;2.0
10;125;1400;1415;15;11;2.0
10;126;1415;1430;15;11;2.0
10;127;1430;1445;15;11;2.0
10;128;1445;1460;15;11;2.0
10;129;1460;1475;15;11;2.0
10;130;1475;1490;15;11;2.0
10;131;1490;1505;15;11;2.0
10;132;1505;1520;15;11;2.0
10;133;1520;1535;15;11;2.0
10;134;1535;1550;15;11;2.0
10;135;1550;1565;15;11;2.0
10;136;1565;1580;15;11;2.0
10;137;1580;1595;15;11;2.0
10;138;1595;1610;15;11;2.0
10;139;1610;1625;15;11;2.0
10;140;1625;1640;15;11;2.0
10;141;1640;1655;15;11;2.0
10;142;1655;1680;25;11;2.0
11;0;250;335;85;87;2.0
11;1;335;341;6;87;2.0
11;2;341;344;3;87;2.0
11;3;344;359;15;87;2.0
11;4;359;361;2;87;2.0
11;5;361;364;3;87;2.0
11;6;364;371;7;87;2.0
11;7;371;381;10;87;2.0
11;8;381;386;5;87;2.0
11;9;386;391;5;87;2.0
11;10;391;394;3;87;2.0
11;11;394;399;5;87;2.0
11;12;399;414;15;87;2.0
11;13;414;421;7;87;2.0
11;14;421;426;5;87;2.0
11;15;426;431;5;87;2.0
11;16;431;441;10;87;2.0
11;17;441;443;2;87;2.0
11;18;443;451;8;87;2.0
11;19;451;456;5;87;2.0
11;20;456;459;3;87;2.0
11;21;459;463;4;87;2.0
11;22;463;474;11;87;2.0
11;23;474;480;6;87;2.0
11;24;480;482;2;87;2.0
11;25;482;486;4;87;2.0
11;26;486;489;3;87;2.0
11;27;489;511;22;87;2.0
11;28;511;513;2;87;2.0
11;29;513;524;11;87;2.0
11;30;524;540;16;87;2.0
11;31;540;546;6;87;2.0
11;32;546;551;5;87;2.0
11;33;551;557;6;87;2.0
11;34;557;580;23;87;2.0
11;35;580;584;4;87;2.0
11;36;584;598;14;87;2.0
11;37;598;600;2;87;2.0
11;38;600;608;8;87;2.0
11;39;608;625;17;87;2.0
11;40;625;628;3;87;2.0
11;41;628;631;3;87;2.0
11;42;631;639;8;87;2.0
11;43;639;660;21;87;2.0
11;44;660;668;8;87;2.0
11;45;668;691;23;87;2.0
11;46;691;704;13;87;2.0
11;47;704;706;2;87;2.0
11;48;706;720;14;87;2.0
11;49;720;728;8;87;2.0
11;50;728;733;5;87;2.0
11;51;733;745;12;87;2.0
11;52;745;748;3;87;2.0
11;53;748;759;11;87;2.0
11;54;759;764;5;87;2.0
11;55;764;766;2;87;2.0
11;56;766;780;14;87;2.0
11;57;780;803;23;87;2.0
11;58;803;804;1;87;2.0
11;59;804;805;1;87;2.0
11;60;805;810;5;87;2.0
11;61;810;826;16;87;2.0
11;62;826;833;7;87;2.0
11;63;833;834;1;87;2.0
11;64;834;840;6;87;2.0
11;65;840;842;2;87;2.0
11;66;842;845;3;87;2.0
11;67;845;858;13;87;2.0
11;68;858;860;2;87;2.0
11;69;860;865;5;87;2.0
11;70;865;873;8;87;2.0
11;71;873;881;8;87;2.0
11;72;881;886;5;87;2.0
11;73;886;888;2;87;2.0
11;74;888;889;1;87;2.0
11;75;889;898;9;87;2.0
11;76;898;900;2;87;2.0
11;77;900;909;9;87;2.0
11;78;909;914;5;87;2.0
11;79;914;916;2;87;2.0
11;80;916;918;2;87;2.0
11;81;918;920;2;87;2.0
11;82;920;925;5;87;2.0
11;83;925;933;8;87;2.0
11;84;933;939;6;87;2.0
11;85;939;944;5;87;2.0
11;86;944;946;2;87;2.0
11;87;946;953;7;87;2.0
11;88;953;958;5;87;2.0
11;89;958;969;11;87;2.0
11;90;969;974;5;87;2.0
11;91;974;976;2;87;2.0
11;92;976;978;2;87;2.0
11;93;978;980;2;87;2.0
11;94;980;985;5;87;2.0
11;95;985;990;5;87;2.0
11;96;990;1004;14;87;2.0
11;97;1004;1006;2;87;2.0
11;98;1006;1008;2;87;2.0
11;99;1008;1018;10;87;2.0
11;100;1018;1024;6;87;2.0
11;101;1024;1029;5;87;2.0
11;102;1029;1030;1;87;2.0
11;103;1030;1034;4;87;2.0
11;104;1034;1038;4;87;2.0
11;105;1038;1064;26;87;2.0
11;106;1064;1073;9;87;2.0
11;107;1073;1078;5;87;2.0
11;108;1078;1098;20;87;2.0
11;109;1098;1103;5;87;2.0
11;110;1103;1110;7;87;2.0
11;111;1110;1124;14;87;2.0
11;112;1124;1153;29;87;2.0
11;113;1153;1160;7;87;2.0
11;114;1160;1162;2;87;2.0
11;115;1162;1186;24;87;2.0
11;116;1186;1228;42;87;2.0
11;117;1228;1233;5;87;2.0
11;118;1233;1282;49;87;2.0
11;119;1282;1291;9;87;2.0
11;120;1291;1329;38;87;2.0
11;121;1329;1354;25;87;2.0
11;122;1354;1402;48;87;2.0
11;123;1402;1404;2;87;2.0
11;124;1404;1419;15;87;2.0
11;125;1419;1434;15;87;2.0
11;126;1434;1449;15;87;2.0
11;127;1449;1464;15;87;2.0
11;128;1464;1479;15;87;2.0
11;129;1479;1494;15;87;2.0
11;130;1494;1509;15;87;2.0
11;131;1509;1524;15;87;2.0
11;132;1524;1539;15;87;2.0
11;133;1539;1554;15;87;2.0
11;134;1554;1569;15;87;2.0
11;135;1569;1584;15;87;2.0
11;136;1584;1599;15;87;2.0
11;137;1599;1614;15;87;2.0
11;138;1614;1629;15;87;2.0
11;139;1629;1644;15;87;2.0
11;140;1644;1659;15;87;2.0
11;141;1659;1680;21;87;2.0
12;0;246;331;85;72;2.0
12;1;331;337;6;72;2.0
12;2;337;340;3;72;2.0
12;3;340;354;14;72;2.0
12;4;354;355;1;72;2.0
12;5;355;360;5;72;2.0
12;6;360;364;4;72;2.0
12;7;364;376;12;72;2.0
12;8;376;380;4;72;2.0
12;9;380;382;2;72;2.0
12;10;382;384;2;72;2.0
12;11;384;389;5;72;2.0
12;12;389;395;6;72;2.0
12;13;395;410;15;72;2.0
12;14;410;414;4;72;2.0
12;15;414;422;8;72;2.0
12;16;422;424;2;72;2.0
12;17;424;427;3;72;2.0
12;18;427;436;9;72;2.0
12;19;436;437;1;72;2.0
12;20;437;444;7;72;2.0
12;21;444;452;8;72;2.0
12;22;452;455;3;72;2.0
12;23;455;456;1;72;2.0
12;24;456;459;3;72;2.0
12;25;459;470;11;72;2.0
12;26;470;475;5;72;2.0
12;27;475;477;2;72;2.0
12;28;477;479;2;72;2.0
12;29;479;482;3;72;2.0
12;30;482;485;3;72;2.0
12;31;485;506;21;72;2.0
12;32;506;507;1;72;2.0
12;33;507;519;12;72;2.0
12;34;519;532;13;72;2.0
12;35;532;542;10;72;2.0
12;36;542;544;2;72;2.0
12;37;544;550;6;72;2.0
12;38;550;576;26;72;2.0
12;39;576;579;3;72;2.0
12;40;579;592;13;72;2.0
12;41;592;594;2;72;2.0
12;42;594;602;8;72;2.0
12;43;602;620;18;72;2.0
12;44;620;624;4;72;2.0
12;45;624;627;3;72;2.0
12;46;627;634;7;72;2.0
12;47;634;652;18;72;2.0
12;48;652;664;12;72;2.0
12;49;664;686;22;72;2.0
12;50;686;699;13;72;2.0
12;51;699;702;3;72;2.0
12;52;702;712;10;72;2.0
12;53;712;722;10;72;2.0
12;54;722;729;7;72;2.0
12;55;729;740;11;72;2.0
12;56;740;744;4;72;2.0
12;57;744;754;10;72;2.0
12;58;754;757;3;72;2.0
12;59;757;762;5;72;2.0
12;60;762;772;10;72;2.0
12;61;772;799;27;72;2.0
12;62;799;800;1;72;2.0
12;63;800;805;5;72;2.0
12;64;805;822;17;72;2.0
12;65;822;827;5;72;2.0
12;66;827;832;5;72;2.0
12;67;832;837;5;72;2.0
12;68;837;841;4;72;2.0
12;69;841;854;13;72;2.0
12;70;854;856;2;72;2.0
12;71;856;860;4;72;2.0
12;72;860;869;9;72;2.0
12;73;869;874;5;72;2.0
12;74;874;882;8;72;2.0
12;75;882;884;2;72;2.0
12;76;884;892;8;72;2.0
12;77;892;904;12;72;2.0
12;78;904;907;3;72;2.0
12;79;907;909;2;72;2.0
12;80;909;912;3;72;2.0
12;81;912;914;2;72;2.0
12;82;914;915;1;72;2.0
12;83;915;920;5;72;2.0
12;84;920;929;9;72;2.0
12;85;929;934;5;72;2.0
12;86;934;937;3;72;2.0
12;87;937;942;5;72;2.0
12;88;942;949;7;72;2.0
12;89;949;952;3;72;2.0
12;90;952;964;12;72;2.0
12;91;964;967;3;72;2.0
12;92;967;969;2;72;2.0
12;93;969;972;3;72;2.0
12;94;972;974;2;72;2.0
12;95;974;975;1;72;2.0
12;96;975;980;5;72;2.0
12;97;980;985;5;72;2.0
12;98;985;997;12;72;2.0
12;99;997;1002;5;72;2.0
12;100;1002;1003;1;72;2.0
12;101;1003;1012;9;72;2.0
12;102;1012;1019;7;72;2.0
12;103;1019;1024;5;72;2.0
12;104;1024;1025;1;72;2.0
12;105;1025;1027;2;72;2.0
12;106;1027;1033;6;72;2.0
12;107;1033;1034;1;72;2.0
12;108;1034;1057;23;72;2.0
12;109;1057;1069;12;72;2.0
12;110;1069;1072;3;72;2.0
12;111;1072;1094;22;72;2.0
12;112;1094;1098;4;72;2.0
12;113;1098;1105;7;72;2.0
12;114;1105;1117;12;72;2.0
12;115;1117;1148;31;72;2.0
12;116;1148;1155;7;72;2.0
12;117;1155;1156;1;72;2.0
12;118;1156;1181;25;72;2.0
12;119;1181;1224;43;72;2.0
12;120;1224;1228;4;72;2.0
12;121;1228;1276;48;72;2.0
12;122;1276;1286;10;72;2.0
12;123;1286;1325;39;72;2.0
12;124;1325;1349;24;72;2.0
12;125;1349;1396;47;72;2.0
12;126;1396;1399;3;72;2.0
12;127;1399;1414;15;72;2.0
12;128;1414;1429;15;72;2.0
12;129;1429;1444;15;72;2.0
12;130;1444;1459;15;72;2.0
12;131;1459;1474;15;72;2.0
12;132;1474;1489;15;72;2.0
12;133;1489;1504;15;72;2.0
12;134;1504;1519;15;72;2.0
12;135;1519;1534;15;72;2.0
12;136;1534;1549;15;72;2.0
12;137;1549;1564;15;72;2.0
12;138;1564;1579;15;72;2.0
12;139;1579;1594;15;72;2.0
12;140;1594;1609;15;72;2.0
12;141;1609;1624;15;72;2.0
12;142;1624;1639;15;72;2.0
12;143;1639;1654;15;72;2.0
12;144;1654;1669;15;72;2.0
12;145;1669;1680;11;72;2.0
13;0;249;326;77;58;2.0
13;1;326;330;4;58;2.0
13;2;330;338;8;58;2.0
13;3;338;345;7;58;2.0
13;4;345;350;5;58;2.0
13;5;350;355;5;58;2.0
13;6;355;363;8;58;2.0
13;7;363;373;10;58;2.0
13;8;373;376;3;58;2.0
13;9;376;377;1;58;2.0
13;10;377;385;8;58;2.0
13;11;385;391;6;58;2.0
13;12;391;393;2;58;2.0
13;13;393;400;7;58;2.0
13;14;400;417;17;58;2.0
13;15;417;423;6;58;2.0
13;16;423;433;10;58;2.0
13;17;433;434;1;58;2.0
13;18;434;436;2;58;2.0
13;19;436;445;9;58;2.0
13;20;445;447;2;58;2.0
13;21;447;453;6;58;2.0
13;22;453;460;7;58;2.0
13;23;460;465;5;58;2.0
13;24;465;475;10;58;2.0
13;25;475;477;2;58;2.0
13;26;477;479;2;58;2.0
13;27;479;484;5;58;2.0
13;28;484;488;4;58;2.0
13;29;488;504;16;58;2.0
13;30;504;508;4;58;2.0
13;31;508;521;13;58;2.0
13;32;521;536;15;58;2.0
13;33;536;537;1;58;2.0
13;34;537;552;15;58;2.0
13;35;552;553;1;58;2.0
13;36;553;571;18;58;2.0
13;37;571;579;8;58;2.0
13;38;579;584;5;58;2.0
13;39;584;596;12;58;2.0
13;40;596;599;3;58;2.0
13;41;599;622;23;58;2.0
13;42;622;625;3;58;2.0
13;43;625;633;8;58;2.0
13;44;633;636;3;58;2.0
13;45;636;654;18;58;2.0
13;46;654;656;2;58;2.0
13;47;656;688;32;58;2.0
13;48;688;697;9;58;2.0
13;49;697;699;2;58;2.0
13;50;699;716;17;58;2.0
13;51;716;719;3;58;2.0
13;52;719;742;23;58;2.0
13;53;742;745;3;58;2.0
13;54;745;756;11;58;2.0
13;55;756;757;1;58;2.0
13;56;757;766;9;58;2.0
13;57;766;776;10;58;2.0
13;58;776;789;13;58;2.0
13;59;789;799;10;58;2.0
13;60;799;802;3;58;2.0
13;61;802;807;5;58;2.0
13;62;807;817;10;58;2.0
13;63;817;824;7;58;2.0
13;64;824;831;7;58;2.0
13;65;831;836;5;58;2.0
13;66;836;839;3;58;2.0
13;67;839;844;5;58;2.0
13;68;844;851;7;58;2.0
13;69;851;859;8;58;2.0
13;70;859;862;3;58;2.0
13;71;862;874;12;58;2.0
13;72;874;877;3;58;2.0
13;73;877;883;6;58;2.0
13;74;883;889;6;58;2.0
13;75;889;891;2;58;2.0
13;76;891;896;5;58;2.0
13;77;896;904;8;58;2.0
13;78;904;906;2;58;2.0
13;79;906;907;1;58;2.0
13;80;907;909;2;58;2.0
13;81;909;916;7;58;2.0
13;82;916;917;1;58;2.0
13;83;917;922;5;58;2.0
13;84;922;930;8;58;2.0
13;85;930;936;6;58;2.0
13;86;936;937;1;58;2.0
13;87;937;939;2;58;2.0
13;88;939;946;7;58;2.0
13;89;946;949;3;58;2.0
13;90;949;964;15;58;2.0
13;91;964;966;2;58;2.0
13;92;966;967;1;58;2.0
13;93;967;969;2;58;2.0
13;94;969;976;7;58;2.0
13;95;976;977;1;58;2.0
13;96;977;982;5;58;2.0
13;97;982;987;5;58;2.0
13;98;987;997;10;58;2.0
13;99;997;1006;9;58;2.0
13;100;1006;1009;3;58;2.0
13;101;1009;1012;3;58;2.0
13;102;1012;1019;7;58;2.0
13;103;1019;1024;5;58;2.0
13;104;1024;1026;2;58;2.0
13;105;1026;1027;1;58;2.0
13;106;1027;1036;9;58;2.0
13;107;1036;1042;6;58;2.0
13;108;1042;1059;17;58;2.0
13;109;1059;1066;7;58;2.0
13;110;1066;1069;3;58;2.0
13;111;1069;1095;26;58;2.0
13;112;1095;1100;5;58;2.0
13;113;1100;1107;7;58;2.0
13;114;1107;1126;19;58;2.0
13;115;1126;1148;22;58;2.0
13;116;1148;1153;5;58;2.0
13;117;1153;1157;4;58;2.0
13;118;1157;1183;26;58;2.0
13;119;1183;1225;42;58;2.0
13;120;1225;1230;5;58;2.0
13;121;1230;1273;43;58;2.0
13;122;1273;1288;15;58;2.0
13;123;1288;1315;27;58;2.0
13;124;1315;1351;36;58;2.0
13;125;1351;1393;42;58;2.0
13;126;1393;1401;8;58;2.0
13;127;1401;1416;15;58;2.0
13;128;1416;1431;15;58;2.0
13;129;1431;1446;15;58;2.0
13;130;1446;1461;15;58;2.0
13;131;1461;1476;15;58;2.0
13;132;1476;1491;15;58;2.0
13;133;1491;1506;15;58;2.0
13;134;1506;1521;15;58;2.0
13;135;1521;1536;15;58;2.0
13;136;1536;1551;15;58;2.0
13;137;1551;1566;15;58;2.0
13;138;1566;1581;15;58;2.0
13;139;1581;1596;15;58;2.0
13;140;1596;1611;15;58;2.0
13;141;1611;1626;15;58;2.0
13;142;1626;1641;15;58;2.0
13;143;1641;1656;15;58;2.0
13;144;1656;1680;24;58;2.0
14;0;257;336;79;115;2.0
14;1;336;343;7;115;2.0
14;2;343;350;7;115;2.0
14;3;350;365;15;115;2.0
14;4;365;370;5;115;2.0
14;5;370;372;2;115;2.0
14;6;372;378;6;115;2.0
14;7;378;380;2;115;2.0
14;8;380;384;4;115;2.0
14;9;384;394;10;115;2.0
14;10;394;396;2;115;2.0
14;11;396;400;4;115;2.0
14;12;400;405;5;115;2.0
14;13;405;420;15;115;2.0
14;14;420;430;10;115;2.0
14;15;430;434;4;115;2.0
14;16;434;437;3;115;2.0
14;17;437;438;1;115;2.0
14;18;438;440;2;115;2.0
14;19;440;441;1;115;2.0
14;20;441;458;17;115;2.0
14;21;458;460;2;115;2.0
14;22;460;464;4;115;2.0
14;23;464;465;1;115;2.0
14;24;465;472;7;115;2.0
14;25;472;480;8;115;2.0
14;26;480;484;4;115;2.0
14;27;484;488;4;115;2.0
14;28;488;494;6;115;2.0
14;29;494;495;1;115;2.0
14;30;495;511;16;115;2.0
14;31;511;513;2;115;2.0
14;32;513;526;13;115;2.0
14;33;526;546;20;115;2.0
14;34;546;554;8;115;2.0
14;35;554;560;6;115;2.0
14;36;560;581;21;115;2.0
14;37;581;588;7;115;2.0
14;38;588;604;16;115;2.0
14;39;604;606;2;115;2.0
14;40;606;623;17;115;2.0
14;41;623;627;4;115;2.0
14;42;627;639;12;115;2.0
14;43;639;640;1;115;2.0
14;44;640;641;1;115;2.0
14;45;641;666;25;115;2.0
14;46;666;674;8;115;2.0
14;47;674;693;19;115;2.0
14;48;693;701;8;115;2.0
14;49;701;714;13;115;2.0
14;50;714;726;12;115;2.0
14;51;726;739;13;115;2.0
14;52;739;743;4;115;2.0
14;53;743;747;4;115;2.0
14;54;747;761;14;115;2.0
14;55;761;773;12;115;2.0
14;56;773;774;1;115;2.0
14;57;774;786;12;115;2.0
14;58;786;801;15;115;2.0
14;59;801;807;6;115;2.0
14;60;807;809;2;115;2.0
14;61;809;812;3;115;2.0
14;62;812;831;19;115;2.0
14;63;831;834;3;115;2.0
14;64;834;843;9;115;2.0
14;65;843;844;1;115;2.0
14;66;844;846;2;115;2.0
14;67;846;851;5;115;2.0
14;68;851;864;13;115;2.0
14;69;864;867;3;115;2.0
14;70;867;868;1;115;2.0
14;71;868;879;11;115;2.0
14;72;879;890;11;115;2.0
14;73;890;894;4;115;2.0
14;74;894;896;2;115;2.0
14;75;896;898;2;115;2.0
14;76;898;906;8;115;2.0
14;77;906;911;5;115;2.0
14;78;911;922;11;115;2.0
14;79;922;923;1;115;2.0
14;80;923;924;1;115;2.0
14;81;924;927;3;115;2.0
14;82;927;928;1;115;2.0
14;83;928;941;13;115;2.0
14;84;941;953;12;115;2.0
14;85;953;954;1;115;2.0
14;86;954;956;2;115;2.0
14;87;956;959;3;115;2.0
14;88;959;971;12;115;2.0
14;89;971;982;11;115;2.0
14;90;982;983;1;115;2.0
14;91;983;984;1;115;2.0
14;92;984;987;3;115;2.0
14;93;987;992;5;115;2.0
14;94;992;1013;21;115;2.0
14;95;1013;1014;1;115;2.0
14;96;1014;1016;2;115;2.0
14;97;1016;1021;5;115;2.0
14;98;1021;1031;10;115;2.0
14;99;1031;1032;1;115;2.0
14;100;1032;1043;11;115;2.0
14;101;1043;1044;1;115;2.0
14;102;1044;1046;2;115;2.0
14;103;1046;1073;27;115;2.0
14;104;1073;1076;3;115;2.0
14;105;1076;1079;3;115;2.0
14;106;1079;1093;14;115;2.0
14;107;1093;1105;12;115;2.0
14;108;1105;1112;7;115;2.0
14;109;1112;1133;21;115;2.0
14;110;1133;1150;17;115;2.0
14;111;1150;1160;10;115;2.0
14;112;1160;1162;2;115;2.0
14;113;1162;1188;26;115;2.0
14;114;1188;1223;35;115;2.0
14;115;1223;1235;12;115;2.0
14;116;1235;1280;45;115;2.0
14;117;1280;1293;13;115;2.0
14;118;1293;1335;42;115;2.0
14;119;1335;1356;21;115;2.0
14;120;1356;1400;44;115;2.0
14;121;1400;1406;6;115;2.0
14;122;1406;1421;15;115;2.0
14;123;1421;1436;15;115;2.0
14;124;1436;1451;15;115;2.0
14;125;1451;1466;15;115;2.0
14;126;1466;1481;15;115;2.0
14;127;1481;1496;15;115;2.0
14;128;1496;1511;15;115;2.0
14;129;1511;1526;15;115;2.0
14;130;1526;1541;15;115;2.0
14;131;1541;1556;15;115;2.0
14;132;1556;1571;15;115;2.0
14;133;1571;1586;15;115;2.0
14;134;1586;1601;15;115;2.0
14;135;1601;1616;15;115;2.0
14;136;1616;1631;15;115;2.0
14;137;1631;1646;15;115;2.0
14;138;1646;1661;15;115;2.0
14;139;1661;1680;19;115;2.0
15;0;260;344;84;159;2.0
15;1;344;349;5;159;2.0
15;2;349;358;9;159;2.0
15;3;358;364;6;159;2.0
15;4;364;369;5;159;2.0
15;5;369;373;4;159;2.0
15;6;373;375;2;159;2.0
15;7;375;381;6;159;2.0
15;8;381;385;4;159;2.0
15;9;385;395;10;159;2.0
15;10;395;398;3;159;2.0
15;11;398;404;6;159;2.0
15;12;404;405;1;159;2.0
15;13;405;415;10;159;2.0
15;14;415;419;4;159;2.0
15;15;419;435;16;159;2.0
15;16;435;436;1;159;2.0
15;17;436;441;5;159;2.0
15;18;441;445;4;159;2.0
15;19;445;464;19;159;2.0
15;20;464;465;1;159;2.0
15;21;465;466;1;159;2.0
15;22;466;477;11;159;2.0
15;23;477;479;2;159;2.0
15;24;479;485;6;159;2.0
15;25;485;486;1;159;2.0
15;26;486;494;8;159;2.0
15;27;494;495;1;159;2.0
15;28;495;500;5;159;2.0
15;29;500;515;15;159;2.0
15;30;515;528;13;159;2.0
15;31;528;550;22;159;2.0
15;32;550;555;5;159;2.0
15;33;555;562;7;159;2.0
15;34;562;565;3;159;2.0
15;35;565;580;15;159;2.0
15;36;580;584;4;159;2.0
15;37;584;589;5;159;2.0
15;38;589;603;14;159;2.0
15;39;603;610;7;159;2.0
15;40;610;629;19;159;2.0
15;41;629;631;2;159;2.0
15;42;631;640;9;159;2.0
15;43;640;643;3;159;2.0
15;44;643;645;2;159;2.0
15;45;645;670;25;159;2.0
15;46;670;673;3;159;2.0
15;47;673;695;22;159;2.0
15;48;695;700;5;159;2.0
15;49;700;704;4;159;2.0
15;50;704;715;11;159;2.0
15;51;715;730;15;159;2.0
15;52;730;738;8;159;2.0
15;53;738;749;11;159;2.0
15;54;749;751;2;159;2.0
15;55;751;763;12;159;2.0
15;56;763;775;12;159;2.0
15;57;775;778;3;159;2.0
15;58;778;790;12;159;2.0
15;59;790;804;14;159;2.0
15;60;804;805;1;159;2.0
15;61;805;808;3;159;2.0
15;62;808;809;1;159;2.0
15;63;809;814;5;159;2.0
15;64;814;835;21;159;2.0
15;65;835;846;11;159;2.0
15;66;846;848;2;159;2.0
15;67;848;850;2;159;2.0
15;68;850;863;13;159;2.0
15;69;863;869;6;159;2.0
15;70;869;870;1;159;2.0
15;71;870;878;8;159;2.0
15;72;878;893;15;159;2.0
15;73;893;895;2;159;2.0
15;74;895;903;8;159;2.0
15;75;903;910;7;159;2.0
15;76;910;913;3;159;2.0
15;77;913;914;1;159;2.0
15;78;914;923;9;159;2.0
15;79;923;924;1;159;2.0
15;80;924;925;1;159;2.0
15;81;925;928;3;159;2.0
15;82;928;929;1;159;2.0
15;83;929;930;1;159;2.0
15;84;930;936;6;159;2.0
15;85;936;943;7;159;2.0
15;86;943;955;12;159;2.0
15;87;955;958;3;159;2.0
15;88;958;973;15;159;2.0
15;89;973;974;1;159;2.0
15;90;974;983;9;159;2.0
15;91;983;984;1;159;2.0
15;92;984;985;1;159;2.0
15;93;985;988;3;159;2.0
15;94;988;989;1;159;2.0
15;95;989;990;1;159;2.0
15;96;990;994;4;159;2.0
15;97;994;1015;21;159;2.0
15;98;1015;1018;3;159;2.0
15;99;1018;1023;5;159;2.0
15;100;1023;1024;1;159;2.0
15;101;1024;1033;9;159;2.0
15;102;1033;1034;1;159;2.0
15;103;1034;1043;9;159;2.0
15;104;1043;1048;5;159;2.0
15;105;1048;1050;2;159;2.0
15;106;1050;1053;3;159;2.0
15;107;1053;1078;25;159;2.0
15;108;1078;1101;23;159;2.0
15;109;1101;1107;6;159;2.0
15;110;1107;1114;7;159;2.0
15;111;1114;1134;20;159;2.0
15;112;1134;1138;4;159;2.0
15;113;1138;1153;15;159;2.0
15;114;1153;1164;11;159;2.0
15;115;1164;1190;26;159;2.0
15;116;1190;1231;41;159;2.0
15;117;1231;1237;6;159;2.0
15;118;1237;1254;17;159;2.0
15;119;1254;1295;41;159;2.0
15;120;1295;1334;39;159;2.0
15;121;1334;1358;24;159;2.0
15;122;1358;1374;16;159;2.0
15;123;1374;1408;34;159;2.0
15;124;1408;1423;15;159;2.0
15;125;1423;1438;15;159;2.0
15;126;1438;1453;15;159;2.0
15;127;1453;1468;15;159;2.0
15;128;1468;1483;15;159;2.0
15;129;1483;1498;15;159;2.0
15;130;1498;1513;15;159;2.0
15;131;1513;1528;15;159;2.0
15;132;1528;1543;15;159;2.0
15;133;1543;1558;15;159;2.0
15;134;1558;1573;15;159;2.0
15;135;1573;1588;15;159;2.0
15;136;1588;1603;15;159;2.0
15;137;1603;1618;15;159;2.0
15;138;1618;1633;15;159;2.0
15;139;1633;1648;15;159;2.0
15;140;1648;1680;32;159;2.0
16;0;247;325;78;14;2.0
16;1;325;336;11;14;2.0
16;2;336;342;6;14;2.0
16;3;342;357;15;14;2.0
16;4;357;362;5;14;2.0
16;5;362;364;2;14;2.0
16;6;364;365;1;14;2.0
16;7;365;370;5;14;2.0
16;8;370;374;4;14;2.0
16;9;374;376;2;14;2.0
16;10;376;387;11;14;2.0
16;11;387;388;1;14;2.0
16;12;388;394;6;14;2.0
16;13;394;397;3;14;2.0
16;14;397;412;15;14;2.0
16;15;412;424;12;14;2.0
16;16;424;427;3;14;2.0
16;17;427;429;2;14;2.0
16;18;429;430;1;14;2.0
16;19;430;433;3;14;2.0
16;20;433;434;1;14;2.0
16;21;434;447;13;14;2.0
16;22;447;454;7;14;2.0
16;23;454;457;3;14;2.0
16;24;457;466;9;14;2.0
16;25;466;472;6;14;2.0
16;26;472;476;4;14;2.0
16;27;476;483;7;14;2.0
16;28;483;487;4;14;2.0
16;29;487;489;2;14;2.0
16;30;489;503;14;14;2.0
16;31;503;505;2;14;2.0
16;32;505;518;13;14;2.0
16;33;518;541;23;14;2.0
16;34;541;547;6;14;2.0
16;35;547;553;6;14;2.0
16;36;553;554;1;14;2.0
16;37;554;573;19;14;2.0
16;38;573;581;8;14;2.0
16;39;581;596;15;14;2.0
16;40;596;598;2;14;2.0
16;41;598;601;3;14;2.0
16;42;601;612;11;14;2.0
16;43;612;619;7;14;2.0
16;44;619;632;13;14;2.0
16;45;632;633;1;14;2.0
16;46;633;634;1;14;2.0
16;47;634;661;27;14;2.0
16;48;661;666;5;14;2.0
16;49;666;685;19;14;2.0
16;50;685;693;8;14;2.0
16;51;693;707;14;14;2.0
16;52;707;718;11;14;2.0
16;53;718;721;3;14;2.0
16;54;721;731;10;14;2.0
16;55;731;732;1;14;2.0
16;56;732;739;7;14;2.0
16;57;739;753;14;14;2.0
16;58;753;767;14;14;2.0
16;59;767;781;14;14;2.0
16;60;781;793;12;14;2.0
16;61;793;799;6;14;2.0
16;62;799;801;2;14;2.0
16;63;801;804;3;14;2.0
16;64;804;823;19;14;2.0
16;65;823;827;4;14;2.0
16;66;827;836;9;14;2.0
16;67;836;837;1;14;2.0
16;68;837;841;4;14;2.0
16;69;841;843;2;14;2.0
16;70;843;856;13;14;2.0
16;71;856;859;3;14;2.0
16;72;859;861;2;14;2.0
16;73;861;871;10;14;2.0
16;74;871;884;13;14;2.0
16;75;884;886;2;14;2.0
16;76;886;887;1;14;2.0
16;77;887;888;1;14;2.0
16;78;888;892;4;14;2.0
16;79;892;901;9;14;2.0
16;80;901;903;2;14;2.0
16;81;903;914;11;14;2.0
16;82;914;916;2;14;2.0
16;83;916;917;1;14;2.0
16;84;917;919;2;14;2.0
16;85;919;933;14;14;2.0
16;86;933;947;14;14;2.0
16;87;947;948;1;14;2.0
16;88;948;951;3;14;2.0
16;89;951;963;12;14;2.0
16;90;963;974;11;14;2.0
16;91;974;976;2;14;2.0
16;92;976;977;1;14;2.0
16;93;977;979;2;14;2.0
16;94;979;984;5;14;2.0
16;95;984;1007;23;14;2.0
16;96;1007;1008;1;14;2.0
16;97;1008;1011;3;14;2.0
16;98;1011;1013;2;14;2.0
16;99;1013;1023;10;14;2.0
16;100;1023;1024;1;14;2.0
16;101;1024;1036;12;14;2.0
16;102;1036;1037;1;14;2.0
16;103;1037;1041;4;14;2.0
16;104;1041;1067;26;14;2.0
16;105;1067;1068;1;14;2.0
16;106;1068;1071;3;14;2.0
16;107;1071;1082;11;14;2.0
16;108;1082;1097;15;14;2.0
16;109;1097;1104;7;14;2.0
16;110;1104;1127;23;14;2.0
16;111;1127;1142;15;14;2.0
16;112;1142;1152;10;14;2.0
16;113;1152;1154;2;14;2.0
16;114;1154;1180;26;14;2.0
16;115;1180;1212;32;14;2.0
16;116;1212;1227;15;14;2.0
16;117;1227;1272;45;14;2.0
16;118;1272;1285;13;14;2.0
16;119;1285;1327;42;14;2.0
16;120;1327;1348;21;14;2.0
16;121;1348;1392;44;14;2.0
16;122;1392;1398;6;14;2.0
16;123;1398;1413;15;14;2.0
16;124;1413;1428;15;14;2.0
16;125;1428;1443;15;14;2.0
16;126;1443;1458;15;14;2.0
16;127;1458;1473;15;14;2.0
16;128;1473;1488;15;14;2.0
16;129;1488;1503;15;14;2.0
16;130;1503;1518;15;14;2.0
16;131;1518;1533;15;14;2.0
16;132;1533;1548;15;14;2.0
16;133;1548;1563;15;14;2.0
16;134;1563;1578;15;14;2.0
16;135;1578;1593;15;14;2.0
16;136;1593;1608;15;14;2.0
16;137;1608;1623;15;14;2.0
16;138;1623;1638;15;14;2.0
16;139;1638;1653;15;14;2.0
16;140;1653;1668;15;14;2.0
16;141;1668;1680;12;14;2.0
17;0;252;333;81;99;2.0
17;1;333;339;6;99;2.0
17;2;339;345;6;99;2.0
17;3;345;360;15;99;2.0
17;4;360;361;1;99;2.0
17;5;361;365;4;99;2.0
17;6;365;368;3;99;2.0
17;7;368;369;1;99;2.0
17;8;369;378;9;99;2.0
17;9;378;379;1;99;2.0
17;10;379;390;11;99;2.0
17;11;390;391;1;99;2.0
17;12;391;399;8;99;2.0
17;13;399;400;1;99;2.0
17;14;400;415;15;99;2.0
17;15;415;421;6;99;2.0
17;16;421;429;8;99;2.0
17;17;429;430;1;99;2.0
17;18;430;432;2;99;2.0
17;19;432;435;3;99;2.0
17;20;435;439;4;99;2.0
17;21;439;455;16;99;2.0
17;22;455;459;4;99;2.0
17;23;459;460;1;99;2.0
17;24;460;471;11;99;2.0
17;25;471;475;4;99;2.0
17;26;475;479;4;99;2.0
17;27;479;487;8;99;2.0
17;28;487;490;3;99;2.0
17;29;490;494;4;99;2.0
17;30;494;505;11;99;2.0
17;31;505;508;3;99;2.0
17;32;508;521;13;99;2.0
17;33;521;544;23;99;2.0
17;34;544;550;6;99;2.0
17;35;550;556;6;99;2.0
17;36;556;559;3;99;2.0
17;37;559;564;5;99;2.0
17;38;564;584;20;99;2.0
17;39;584;599;15;99;2.0
17;40;599;600;1;99;2.0
17;41;600;604;4;99;2.0
17;42;604;620;16;99;2.0
17;43;620;622;2;99;2.0
17;44;622;635;13;99;2.0
17;45;635;636;1;99;2.0
17;46;636;639;3;99;2.0
17;47;639;664;25;99;2.0
17;48;664;669;5;99;2.0
17;49;669;684;15;99;2.0
17;50;684;688;4;99;2.0
17;51;688;710;22;99;2.0
17;52;710;720;10;99;2.0
17;53;720;724;4;99;2.0
17;54;724;734;10;99;2.0
17;55;734;740;6;99;2.0
17;56;740;742;2;99;2.0
17;57;742;756;14;99;2.0
17;58;756;770;14;99;2.0
17;59;770;772;2;99;2.0
17;60;772;784;12;99;2.0
17;61;784;802;18;99;2.0
17;62;802;804;2;99;2.0
17;63;804;807;3;99;2.0
17;64;807;825;18;99;2.0
17;65;825;830;5;99;2.0
17;66;830;839;9;99;2.0
17;67;839;842;3;99;2.0
17;68;842;844;2;99;2.0
17;69;844;846;2;99;2.0
17;70;846;859;13;99;2.0
17;71;859;862;3;99;2.0
17;72;862;864;2;99;2.0
17;73;864;874;10;99;2.0
17;74;874;889;15;99;2.0
17;75;889;890;1;99;2.0
17;76;890;894;4;99;2.0
17;77;894;897;3;99;2.0
17;78;897;904;7;99;2.0
17;79;904;906;2;99;2.0
17;80;906;917;11;99;2.0
17;81;917;919;2;99;2.0
17;82;919;920;1;99;2.0
17;83;920;922;2;99;2.0
17;84;922;925;3;99;2.0
17;85;925;936;11;99;2.0
17;86;936;950;14;99;2.0
17;87;950;952;2;99;2.0
17;88;952;954;2;99;2.0
17;89;954;966;12;99;2.0
17;90;966;977;11;99;2.0
17;91;977;979;2;99;2.0
17;92;979;980;1;99;2.0
17;93;980;982;2;99;2.0
17;94;982;987;5;99;2.0
17;95;987;1004;17;99;2.0
17;96;1004;1010;6;99;2.0
17;97;1010;1012;2;99;2.0
17;98;1012;1015;3;99;2.0
17;99;1015;1026;11;99;2.0
17;100;1026;1027;1;99;2.0
17;101;1027;1039;12;99;2.0
17;102;1039;1042;3;99;2.0
17;103;1042;1045;3;99;2.0
17;104;1045;1070;25;99;2.0
17;105;1070;1072;2;99;2.0
17;106;1072;1074;2;99;2.0
17;107;1074;1090;16;99;2.0
17;108;1090;1100;10;99;2.0
17;109;1100;1107;7;99;2.0
17;110;1107;1132;25;99;2.0
17;111;1132;1133;1;99;2.0
17;112;1133;1154;21;99;2.0
17;113;1154;1157;3;99;2.0
17;114;1157;1183;26;99;2.0
17;115;1183;1220;37;99;2.0
17;116;1220;1230;10;99;2.0
17;117;1230;1274;44;99;2.0
17;118;1274;1288;14;99;2.0
17;119;1288;1330;42;99;2.0
17;120;1330;1351;21;99;2.0
17;121;1351;1394;43;99;2.0
17;122;1394;1401;7;99;2.0
17;123;1401;1416;15;99;2.0
17;124;1416;1431;15;99;2.0
17;125;1431;1446;15;99;2.0
17;126;1446;1461;15;99;2.0
17;127;1461;1476;15;99;2.0
17;128;1476;1491;15;99;2.0
17;129;1491;1506;15;99;2.0
17;130;1506;1521;15;99;2.0
17;131;1521;1536;15;99;2.0
17;132;1536;1551;15;99;2.0
17;133;1551;1566;15;99;2.0
17;134;1566;1581;15;99;2.0
17;135;1581;1596;15;99;2.0
17;136;1596;1611;15;99;2.0
17;137;1611;1626;15;99;2.0
17;138;1626;1641;15;99;2.0
17;139;1641;1656;15;99;2.0
17;140;1656;1680;24;99;2.0
18;0;246;331;85;501;2.0
18;1;331;337;6;501;2.0
18;2;337;339;2;501;2.0
18;3;339;354;15;501;2.0
18;4;354;357;3;501;2.0
18;5;357;359;2;501;2.0
18;6;359;360;1;501;2.0
18;7;360;367;7;501;2.0
18;8;367;375;8;501;2.0
18;9;375;378;3;501;2.0
18;10;378;382;4;501;2.0
18;11;382;387;5;501;2.0
18;12;387;388;1;501;2.0
18;13;388;394;6;501;2.0
18;14;394;409;15;501;2.0
18;15;409;417;8;501;2.0
18;16;417;422;5;501;2.0
18;17;422;426;4;501;2.0
18;18;426;427;1;501;2.0
18;19;427;435;8;501;2.0
18;20;435;447;12;501;2.0
18;21;447;452;5;501;2.0
18;22;452;454;2;501;2.0
18;23;454;459;5;501;2.0
18;24;459;469;10;501;2.0
18;25;469;476;7;501;2.0
18;26;476;478;2;501;2.0
18;27;478;482;4;501;2.0
18;28;482;484;2;501;2.0
18;29;484;505;21;501;2.0
18;30;505;518;13;501;2.0
18;31;518;529;11;501;2.0
18;32;529;542;13;501;2.0
18;33;542;547;5;501;2.0
18;34;547;549;2;501;2.0
18;35;549;576;27;501;2.0
18;36;576;578;2;501;2.0
18;37;578;589;11;501;2.0
18;38;589;593;4;501;2.0
18;39;593;600;7;501;2.0
18;40;600;619;19;501;2.0
18;41;619;624;5;501;2.0
18;42;624;627;3;501;2.0
18;43;627;633;6;501;2.0
18;44;633;649;16;501;2.0
18;45;649;663;14;501;2.0
18;46;663;685;22;501;2.0
18;47;685;698;13;501;2.0
18;48;698;702;4;501;2.0
18;49;702;709;7;501;2.0
18;50;709;720;11;501;2.0
18;51;720;728;8;501;2.0
18;52;728;739;11;501;2.0
18;53;739;744;5;501;2.0
18;54;744;753;9;501;2.0
18;55;753;760;7;501;2.0
18;56;760;762;2;501;2.0
18;57;762;769;7;501;2.0
18;58;769;798;29;501;2.0
18;59;798;799;1;501;2.0
18;60;799;804;5;501;2.0
18;61;804;822;18;501;2.0
18;62;822;825;3;501;2.0
18;63;825;829;4;501;2.0
18;64;829;830;1;501;2.0
18;65;830;836;6;501;2.0
18;66;836;840;4;501;2.0
18;67;840;853;13;501;2.0
18;68;853;856;3;501;2.0
18;69;856;859;3;501;2.0
18;70;859;868;9;501;2.0
18;71;868;877;9;501;2.0
18;72;877;882;5;501;2.0
18;73;882;883;1;501;2.0
18;74;883;885;2;501;2.0
18;75;885;889;4;501;2.0
18;76;889;890;1;501;2.0
18;77;890;903;13;501;2.0
18;78;903;908;5;501;2.0
18;79;908;910;2;501;2.0
18;80;910;912;2;501;2.0
18;81;912;913;1;501;2.0
18;82;913;914;1;501;2.0
18;83;914;919;5;501;2.0
18;84;919;929;10;501;2.0
18;85;929;933;4;501;2.0
18;86;933;940;7;501;2.0
18;87;940;942;2;501;2.0
18;88;942;948;6;501;2.0
18;89;948;950;2;501;2.0
18;90;950;963;13;501;2.0
18;91;963;968;5;501;2.0
18;92;968;970;2;501;2.0
18;93;970;972;2;501;2.0
18;94;972;973;1;501;2.0
18;95;973;974;1;501;2.0
18;96;974;979;5;501;2.0
18;97;979;984;5;501;2.0
18;98;984;1000;16;501;2.0
18;99;1000;1002;2;501;2.0
18;100;1002;1006;4;501;2.0
18;101;1006;1010;4;501;2.0
18;102;1010;1018;8;501;2.0
18;103;1018;1023;5;501;2.0
18;104;1023;1024;1;501;2.0
18;105;1024;1030;6;501;2.0
18;106;1030;1033;3;501;2.0
18;107;1033;1036;3;501;2.0
18;108;1036;1060;24;501;2.0
18;109;1060;1068;8;501;2.0
18;110;1068;1070;2;501;2.0
18;111;1070;1094;24;501;2.0
18;112;1094;1097;3;501;2.0
18;113;1097;1104;7;501;2.0
18;114;1104;1120;16;501;2.0
18;115;1120;1147;27;501;2.0
18;116;1147;1154;7;501;2.0
18;117;1154;1180;26;501;2.0
18;118;1180;1224;44;501;2.0
18;119;1224;1227;3;501;2.0
18;120;1227;1274;47;501;2.0
18;121;1274;1285;11;501;2.0
18;122;1285;1324;39;501;2.0
18;123;1324;1348;24;501;2.0
18;124;1348;1394;46;501;2.0
18;125;1394;1398;4;501;2.0
18;126;1398;1413;15;501;2.0
18;127;1413;1428;15;501;2.0
18;128;1428;1443;15;501;2.0
18;129;1443;1458;15;501;2.0
18;130;1458;1473;15;501;2.0
18;131;1473;1488;15;501;2.0
18;132;1488;1503;15;501;2.0
18;133;1503;1518;15;501;2.0
18;134;1518;1533;15;501;2.0
18;135;1533;1548;15;501;2.0
18;136;1548;1563;15;501;2.0
18;137;1563;1578;15;501;2.0
18;138;1578;1593;15;501;2.0
18;139;1593;1608;15;501;2.0
18;140;1608;1623;15;501;2.0
18;141;1623;1638;15;501;2.0
18;142;1638;1653;15;501;2.0
18;143;1653;1668;15;501;2.0
18;144;1668;1680;12;501;2.0
19;0;250;340;90;66;2.0
19;1;340;341;1;66;2.0
19;2;341;347;6;66;2.0
19;3;347;362;15;66;2.0
19;4;362;367;5;66;2.0
19;5;367;369;2;66;2.0
19;6;369;372;3;66;2.0
19;7;372;380;8;66;2.0
19;8;380;385;5;66;2.0
19;9;385;391;6;66;2.0
19;10;391;392;1;66;2.0
19;11;392;394;2;66;2.0
19;12;394;402;8;66;2.0
19;13;402;417;15;66;2.0
19;14;417;422;5;66;2.0
19;15;422;431;9;66;2.0
19;16;431;432;1;66;2.0
19;17;432;434;2;66;2.0
19;18;434;440;6;66;2.0
19;19;440;442;2;66;2.0
19;20;442;452;10;66;2.0
19;21;452;461;9;66;2.0
19;22;461;462;1;66;2.0
19;23;462;463;1;66;2.0
19;24;463;464;1;66;2.0
19;25;464;477;13;66;2.0
19;26;477;481;4;66;2.0
19;27;481;482;1;66;2.0
19;28;482;487;5;66;2.0
19;29;487;491;4;66;2.0
19;30;491;492;1;66;2.0
19;31;492;511;19;66;2.0
19;32;511;512;1;66;2.0
19;33;512;524;12;66;2.0
19;34;524;541;17;66;2.0
19;35;541;551;10;66;2.0
19;36;551;552;1;66;2.0
19;37;552;557;5;66;2.0
19;38;557;583;26;66;2.0
19;39;583;585;2;66;2.0
19;40;585;601;16;66;2.0
19;41;601;607;6;66;2.0
19;42;607;625;18;66;2.0
19;43;625;628;3;66;2.0
19;44;628;632;4;66;2.0
19;45;632;636;4;66;2.0
19;46;636;639;3;66;2.0
19;47;639;661;22;66;2.0
19;48;661;671;10;66;2.0
19;49;671;691;20;66;2.0
19;50;691;703;12;66;2.0
19;51;703;711;8;66;2.0
19;52;711;721;10;66;2.0
19;53;721;727;6;66;2.0
19;54;727;736;9;66;2.0
19;55;736;745;9;66;2.0
19;56;745;748;3;66;2.0
19;57;748;759;11;66;2.0
19;58;759;765;6;66;2.0
19;59;765;771;6;66;2.0
19;60;771;781;10;66;2.0
19;61;781;803;22;66;2.0
19;62;803;805;2;66;2.0
19;63;805;806;1;66;2.0
19;64;806;810;4;66;2.0
19;65;810;831;21;66;2.0
19;66;831;832;1;66;2.0
19;67;832;835;3;66;2.0
19;68;835;841;6;66;2.0
19;69;841;842;1;66;2.0
19;70;842;848;6;66;2.0
19;71;848;861;13;66;2.0
19;72;861;865;4;66;2.0
19;73;865;876;11;66;2.0
19;74;876;882;6;66;2.0
19;75;882;890;8;66;2.0
19;76;890;891;1;66;2.0
19;77;891;897;6;66;2.0
19;78;897;901;4;66;2.0
19;79;901;909;8;66;2.0
19;80;909;913;4;66;2.0
19;81;913;915;2;66;2.0
19;82;915;920;5;66;2.0
19;83;920;921;1;66;2.0
19;84;921;925;4;66;2.0
19;85;925;933;8;66;2.0
19;86;933;939;6;66;2.0
19;87;939;945;6;66;2.0
19;88;945;951;6;66;2.0
19;89;951;956;5;66;2.0
19;90;956;957;1;66;2.0
19;91;957;969;12;66;2.0
19;92;969;973;4;66;2.0
19;93;973;975;2;66;2.0
19;94;975;980;5;66;2.0
19;95;980;981;1;66;2.0
19;96;981;985;4;66;2.0
19;97;985;990;5;66;2.0
19;98;990;1005;15;66;2.0
19;99;1005;1009;4;66;2.0
19;100;1009;1011;2;66;2.0
19;101;1011;1017;6;66;2.0
19;102;1017;1023;6;66;2.0
19;103;1023;1029;6;66;2.0
19;104;1029;1030;1;66;2.0
19;105;1030;1035;5;66;2.0
19;106;1035;1039;4;66;2.0
19;107;1039;1041;2;66;2.0
19;108;1041;1065;24;66;2.0
19;109;1065;1076;11;66;2.0
19;110;1076;1077;1;66;2.0
19;111;1077;1098;21;66;2.0
19;112;1098;1103;5;66;2.0
19;113;1103;1110;7;66;2.0
19;114;1110;1125;15;66;2.0
19;115;1125;1152;27;66;2.0
19;116;1152;1160;8;66;2.0
19;117;1160;1161;1;66;2.0
19;118;1161;1186;25;66;2.0
19;119;1186;1228;42;66;2.0
19;120;1228;1233;5;66;2.0
19;121;1233;1281;48;66;2.0
19;122;1281;1291;10;66;2.0
19;123;1291;1332;41;66;2.0
19;124;1332;1354;22;66;2.0
19;125;1354;1401;47;66;2.0
19;126;1401;1404;3;66;2.0
19;127;1404;1419;15;66;2.0
19;128;1419;1434;15;66;2.0
19;129;1434;1449;15;66;2.0
19;130;1449;1464;15;66;2.0
19;131;1464;1479;15;66;2.0
19;132;1479;1494;15;66;2.0
19;133;1494;1509;15;66;2.0
19;134;1509;1524;15;66;2.0
19;135;1524;1539;15;66;2.0
19;136;1539;1554;15;66;2.0
19;137;1554;1569;15;66;2.0
19;138;1569;1584;15;66;2.0
19;139;1584;1599;15;66;2.0
19;140;1599;1614;15;66;2.0
19;141;1614;1629;15;66;2.0
19;142;1629;1644;15;66;2.0
19;143;1644;1659;15;66;2.0
19;144;1659;1680;21;66;2.0
20;0;252;342;90;63;2.0
20;1;342;343;1;63;2.0
20;2;343;349;6;63;2.0
20;3;349;364;15;63;2.0
20;4;364;369;5;63;2.0
20;5;369;371;2;63;2.0
20;6;371;374;3;63;2.0
20;7;374;382;8;63;2.0
20;8;382;387;5;63;2.0
20;9;387;393;6;63;2.0
20;10;393;394;1;63;2.0
20;11;394;396;2;63;2.0
20;12;396;404;8;63;2.0
20;13;404;419;15;63;2.0
20;14;419;424;5;63;2.0
20;15;424;433;9;63;2.0
20;16;433;434;1;63;2.0
20;17;434;436;2;63;2.0
20;18;436;442;6;63;2.0
20;19;442;444;2;63;2.0
20;20;444;454;10;63;2.0
20;21;454;463;9;63;2.0
20;22;463;464;1;63;2.0
20;23;464;465;1;63;2.0
20;24;465;466;1;63;2.0
20;25;466;479;13;63;2.0
20;26;479;483;4;63;2.0
20;27;483;484;1;63;2.0
20;28;484;489;5;63;2.0
20;29;489;493;4;63;2.0
20;30;493;494;1;63;2.0
20;31;494;513;19;63;2.0
20;32;513;514;1;63;2.0
20;33;514;526;12;63;2.0
20;34;526;543;17;63;2.0
20;35;543;553;10;63;2.0
20;36;553;554;1;63;2.0
20;37;554;559;5;63;2.0
20;38;559;585;26;63;2.0
20;39;585;587;2;63;2.0
20;40;587;603;16;63;2.0
20;41;603;609;6;63;2.0
20;42;609;627;18;63;2.0
20;43;627;630;3;63;2.0
20;44;630;634;4;63;2.0
20;45;634;638;4;63;2.0
20;46;638;641;3;63;2.0
20;47;641;663;22;63;2.0
20;48;663;673;10;63;2.0
20;49;673;693;20;63;2.0
20;50;693;705;12;63;2.0
20;51;705;713;8;63;2.0
20;52;713;723;10;63;2.0
20;53;723;729;6;63;2.0
20;54;729;738;9;63;2.0
20;55;738;747;9;63;2.0
20;56;747;750;3;63;2.0
20;57;750;761;11;63;2.0
20;58;761;767;6;63;2.0
20;59;767;773;6;63;2.0
20;60;773;783;10;63;2.0
20;61;783;805;22;63;2.0
20;62;805;807;2;63;2.0
20;63;807;808;1;63;2.0
20;64;808;812;4;63;2.0
20;65;812;833;21;63;2.0
20;66;833;834;1;63;2.0
20;67;834;837;3;63;2.0
20;68;837;843;6;63;2.0
20;69;843;844;1;63;2.0
20;70;844;850;6;63;2.0
20;71;850;863;13;63;2.0
20;72;863;867;4;63;2.0
20;73;867;878;11;63;2.0
20;74;878;884;6;63;2.0
20;75;884;892;8;63;2.0
20;76;892;893;1;63;2.0
20;77;893;899;6;63;2.0
20;78;899;903;4;63;2.0
20;79;903;911;8;63;2.0
20;80;911;915;4;63;2.0
20;81;915;917;2;63;2.0
20;82;917;922;5;63;2.0
20;83;922;923;1;63;2.0
20;84;923;927;4;63;2.0
20;85;927;935;8;63;2.0
20;86;935;941;6;63;2.0
20;87;941;947;6;63;2.0
20;88;947;953;6;63;2.0
20;89;953;958;5;63;2.0
20;90;958;959;1;63;2.0
20;91;959;971;12;63;2.0
20;92;971;975;4;63;2.0
20;93;975;977;2;63;2.0
20;94;977;982;5;63;2.0
20;95;982;983;1;63;2.0
20;96;983;987;4;63;2.0
20;97;987;992;5;63;2.0
20;98;992;1007;15;63;2.0
20;99;1007;1011;4;63;2.0
20;100;1011;1013;2;63;2.0
20;101;1013;1019;6;63;2.0
20;102;1019;1025;6;63;2.0
20;103;1025;1031;6;63;2.0
20;104;1031;1032;1;63;2.0
20;105;1032;1037;5;63;2.0
20;106;1037;1041;4;63;2.0
20;107;1041;1043;2;63;2.0
20;108;1043;1067;24;63;2.0
20;109;1067;1078;11;63;2.0
20;110;1078;1079;1;63;2.0
20;111;1079;1100;21;63;2.0
20;112;1100;1105;5;63;2.0
20;113;1105;1112;7;63;2.0
20;114;1112;1127;15;63;2.0
20;115;1127;1154;27;63;2.0
20;116;1154;1162;8;63;2.0
20;117;1162;1163;1;63;2.0
20;118;1163;1188;25;63;2.0
20;119;1188;1230;42;63;2.0
20;120;1230;1235;5;63;2.0
20;121;1235;1283;48;63;2.0
20;122;1283;1293;10;63;2.0
20;123;1293;1334;41;63;2.0
20;124;1334;1356;22;63;2.0
20;125;1356;1403;47;63;2.0
20;126;1403;1406;3;63;2.0
20;127;1406;1421;15;63;2.0
20;128;1421;1436;15;63;2.0
20;129;1436;1451;15;63;2.0
20;130;1451;1466;15;63;2.0
20;131;1466;1481;15;63;2.0
20;132;1481;1496;15;63;2.0
20;133;1496;1511;15;63;2.0
20;134;1511;1526;15;63;2.0
20;135;1526;1541;15;63;2.0
20;136;1541;1556;15;63;2.0
20;137;1556;1571;15;63;2.0
20;138;1571;1586;15;63;2.0
20;139;1586;1601;15;63;2.0
20;140;1601;1616;15;63;2.0
20;141;1616;1631;15;63;2.0
20;142;1631;1646;15;63;2.0
20;143;1646;1661;15;63;2.0
20;144;1661;1680;19;63;2.0
21;0;249;333;84;114;2.0
21;1;333;335;2;114;2.0
21;2;335;338;3;114;2.0
21;3;338;353;15;114;2.0
21;4;353;358;5;114;2.0
21;5;358;362;4;114;2.0
21;6;362;364;2;114;2.0
21;7;364;372;8;114;2.0
21;8;372;373;1;114;2.0
21;9;373;374;1;114;2.0
21;10;374;384;10;114;2.0
21;11;384;389;5;114;2.0
21;12;389;393;4;114;2.0
21;13;393;394;1;114;2.0
21;14;394;408;14;114;2.0
21;15;408;424;16;114;2.0
21;16;424;425;1;114;2.0
21;17;425;430;5;114;2.0
21;18;430;432;2;114;2.0
21;19;432;434;2;114;2.0
21;20;434;453;19;114;2.0
21;21;453;454;1;114;2.0
21;22;454;457;3;114;2.0
21;23;457;466;9;114;2.0
21;24;466;468;2;114;2.0
21;25;468;477;9;114;2.0
21;26;477;483;6;114;2.0
21;27;483;484;1;114;2.0
21;28;484;489;5;114;2.0
21;29;489;500;11;114;2.0
21;30;500;506;6;114;2.0
21;31;506;519;13;114;2.0
21;32;519;539;20;114;2.0
21;33;539;544;5;114;2.0
21;34;544;552;8;114;2.0
21;35;552;554;2;114;2.0
21;36;554;575;21;114;2.0
21;37;575;578;3;114;2.0
21;38;578;592;14;114;2.0
21;39;592;595;3;114;2.0
21;40;595;599;4;114;2.0
21;41;599;620;21;114;2.0
21;42;620;622;2;114;2.0
21;43;622;629;7;114;2.0
21;44;629;634;5;114;2.0
21;45;634;659;25;114;2.0
21;46;659;662;3;114;2.0
21;47;662;686;24;114;2.0
21;48;686;695;9;114;2.0
21;49;695;704;9;114;2.0
21;50;704;715;11;114;2.0
21;51;715;719;4;114;2.0
21;52;719;727;8;114;2.0
21;53;727;740;13;114;2.0
21;54;740;742;2;114;2.0
21;55;742;754;12;114;2.0
21;56;754;764;10;114;2.0
21;57;764;767;3;114;2.0
21;58;767;779;12;114;2.0
21;59;779;795;16;114;2.0
21;60;795;797;2;114;2.0
21;61;797;800;3;114;2.0
21;62;800;805;5;114;2.0
21;63;805;820;15;114;2.0
21;64;820;824;4;114;2.0
21;65;824;837;13;114;2.0
21;66;837;839;2;114;2.0
21;67;839;852;13;114;2.0
21;68;852;858;6;114;2.0
21;69;858;860;2;114;2.0
21;70;860;867;7;114;2.0
21;71;867;882;15;114;2.0
21;72;882;884;2;114;2.0
21;73;884;885;1;114;2.0
21;74;885;892;7;114;2.0
21;75;892;899;7;114;2.0
21;76;899;904;5;114;2.0
21;77;904;905;1;114;2.0
21;78;905;912;7;114;2.0
21;79;912;914;2;114;2.0
21;80;914;915;1;114;2.0
21;81;915;917;2;114;2.0
21;82;917;920;3;114;2.0
21;83;920;927;7;114;2.0
21;84;927;934;7;114;2.0
21;85;934;944;10;114;2.0
21;86;944;945;1;114;2.0
21;87;945;947;2;114;2.0
21;88;947;964;17;114;2.0
21;89;964;965;1;114;2.0
21;90;965;972;7;114;2.0
21;91;972;974;2;114;2.0
21;92;974;975;1;114;2.0
21;93;975;977;2;114;2.0
21;94;977;980;3;114;2.0
21;95;980;985;5;114;2.0
21;96;985;1004;19;114;2.0
21;97;1004;1005;1;114;2.0
21;98;1005;1007;2;114;2.0
21;99;1007;1012;5;114;2.0
21;100;1012;1015;3;114;2.0
21;101;1015;1024;9;114;2.0
21;102;1024;1025;1;114;2.0
21;103;1025;1032;7;114;2.0
21;104;1032;1037;5;114;2.0
21;105;1037;1042;5;114;2.0
21;106;1042;1065;23;114;2.0
21;107;1065;1067;2;114;2.0
21;108;1067;1092;25;114;2.0
21;109;1092;1098;6;114;2.0
21;110;1098;1105;7;114;2.0
21;111;1105;1127;22;114;2.0
21;112;1127;1144;17;114;2.0
21;113;1144;1149;5;114;2.0
21;114;1149;1155;6;114;2.0
21;115;1155;1181;26;114;2.0
21;116;1181;1222;41;114;2.0
21;117;1222;1228;6;114;2.0
21;118;1228;1269;41;114;2.0
21;119;1269;1286;17;114;2.0
21;120;1286;1323;37;114;2.0
21;121;1323;1349;26;114;2.0
21;122;1349;1389;40;114;2.0
21;123;1389;1399;10;114;2.0
21;124;1399;1414;15;114;2.0
21;125;1414;1429;15;114;2.0
21;126;1429;1444;15;114;2.0
21;127;1444;1459;15;114;2.0
21;128;1459;1474;15;114;2.0
21;129;1474;1489;15;114;2.0
21;130;1489;1504;15;114;2.0
21;131;1504;1519;15;114;2.0
21;132;1519;1534;15;114;2.0
21;133;1534;1549;15;114;2.0
21;134;1549;1564;15;114;2.0
21;135;1564;1579;15;114;2.0
21;136;1579;1594;15;114;2.0
21;137;1594;1609;15;114;2.0
21;138;1609;1624;15;114;2.0
21;139;1624;1639;15;114;2.0
21;140;1639;1654;15;114;2.0
21;141;1654;1669;15;114;2.0
21;142;1669;1680;11;114;2.0
22;0;243;332;89;42;2.0
22;1;332;339;7;42;2.0
22;2;339;354;15;42;2.0
22;3;354;359;5;42;2.0
22;4;359;361;2;42;2.0
22;5;361;369;8;42;2.0
22;6;369;371;2;42;2.0
22;7;371;374;3;42;2.0
22;8;374;383;9;42;2.0
22;9;383;391;8;42;2.0
22;10;391;394;3;42;2.0
22;11;394;409;15;42;2.0
22;12;409;421;12;42;2.0
22;13;421;423;2;42;2.0
22;14;423;426;3;42;2.0
22;15;426;429;3;42;2.0
22;16;429;431;2;42;2.0
22;17;431;451;20;42;2.0
22;18;451;453;2;42;2.0
22;19;453;454;1;42;2.0
22;20;454;463;9;42;2.0
22;21;463;469;6;42;2.0
22;22;469;471;2;42;2.0
22;23;471;480;9;42;2.0
22;24;480;483;3;42;2.0
22;25;483;484;1;42;2.0
22;26;484;486;2;42;2.0
22;27;486;500;14;42;2.0
22;28;500;501;1;42;2.0
22;29;501;513;12;42;2.0
22;30;513;536;23;42;2.0
22;31;536;543;7;42;2.0
22;32;543;548;5;42;2.0
22;33;548;551;3;42;2.0
22;34;551;572;21;42;2.0
22;35;572;577;5;42;2.0
22;36;577;593;16;42;2.0
22;37;593;596;3;42;2.0
22;38;596;614;18;42;2.0
22;39;614;619;5;42;2.0
22;40;619;628;9;42;2.0
22;41;628;631;3;42;2.0
22;42;631;656;25;42;2.0
22;43;656;663;7;42;2.0
22;44;663;680;17;42;2.0
22;45;680;692;12;42;2.0
22;46;692;703;11;42;2.0
22;47;703;716;13;42;2.0
22;48;716;728;12;42;2.0
22;49;728;734;6;42;2.0
22;50;734;739;5;42;2.0
22;51;739;748;9;42;2.0
22;52;748;763;15;42;2.0
22;53;763;764;1;42;2.0
22;54;764;776;12;42;2.0
22;55;776;792;16;42;2.0
22;56;792;794;2;42;2.0
22;57;794;798;4;42;2.0
22;58;798;799;1;42;2.0
22;59;799;821;22;42;2.0
22;60;821;823;2;42;2.0
22;61;823;831;8;42;2.0
22;62;831;834;3;42;2.0
22;63;834;836;2;42;2.0
22;64;836;840;4;42;2.0
22;65;840;853;13;42;2.0
22;66;853;854;1;42;2.0
22;67;854;857;3;42;2.0
22;68;857;868;11;42;2.0
22;69;868;881;13;42;2.0
22;70;881;883;2;42;2.0
22;71;883;886;3;42;2.0
22;72;886;889;3;42;2.0
22;73;889;896;7;42;2.0
22;74;896;898;2;42;2.0
22;75;898;902;4;42;2.0
22;76;902;909;7;42;2.0
22;77;909;913;4;42;2.0
22;78;913;914;1;42;2.0
22;79;914;924;10;42;2.0
22;80;924;928;4;42;2.0
22;81;928;943;15;42;2.0
22;82;943;944;1;42;2.0
22;83;944;946;2;42;2.0
22;84;946;948;2;42;2.0
22;85;948;958;10;42;2.0
22;86;958;962;4;42;2.0
22;87;962;969;7;42;2.0
22;88;969;973;4;42;2.0
22;89;973;974;1;42;2.0
22;90;974;979;5;42;2.0
22;91;979;1003;24;42;2.0
22;92;1003;1004;1;42;2.0
22;93;1004;1006;2;42;2.0
22;94;1006;1008;2;42;2.0
22;95;1008;1012;4;42;2.0
22;96;1012;1018;6;42;2.0
22;97;1018;1019;1;42;2.0
22;98;1019;1033;14;42;2.0
22;99;1033;1034;1;42;2.0
22;100;1034;1038;4;42;2.0
22;101;1038;1064;26;42;2.0
22;102;1064;1066;2;42;2.0
22;103;1066;1068;2;42;2.0
22;104;1068;1089;21;42;2.0
22;105;1089;1092;3;42;2.0
22;106;1092;1099;7;42;2.0
22;107;1099;1124;25;42;2.0
22;108;1124;1141;17;42;2.0
22;109;1141;1149;8;42;2.0
22;110;1149;1150;1;42;2.0
22;111;1150;1175;25;42;2.0
22;112;1175;1219;44;42;2.0
22;113;1219;1222;3;42;2.0
22;114;1222;1270;48;42;2.0
22;115;1270;1280;10;42;2.0
22;116;1280;1324;44;42;2.0
22;117;1324;1343;19;42;2.0
22;118;1343;1390;47;42;2.0
22;119;1390;1393;3;42;2.0
22;120;1393;1408;15;42;2.0
22;121;1408;1423;15;42;2.0
22;122;1423;1438;15;42;2.0
22;123;1438;1453;15;42;2.0
22;124;1453;1468;15;42;2.0
22;125;1468;1483;15;42;2.0
22;126;1483;1498;15;42;2.0
22;127;1498;1513;15;42;2.0
22;128;1513;1528;15;42;2.0
22;129;1528;1543;15;42;2.0
22;130;1543;1558;15;42;2.0
22;131;1558;1573;15;42;2.0
22;132;1573;1588;15;42;2.0
22;133;1588;1603;15;42;2.0
22;134;1603;1618;15;42;2.0
22;135;1618;1633;15;42;2.0
22;136;1633;1648;15;42;2.0
22;137;1648;1663;15;42;2.0
22;138;1663;1680;17;42;2.0
23;0;245;332;87;25;2.0
23;1;332;338;6;25;2.0
23;2;338;353;15;25;2.0
23;3;353;358;5;25;2.0
23;4;358;361;3;25;2.0
23;5;361;369;8;25;2.0
23;6;369;371;2;25;2.0
23;7;371;374;3;25;2.0
23;8;374;383;9;25;2.0
23;9;383;384;1;25;2.0
23;10;384;391;7;25;2.0
23;11;391;393;2;25;2.0
23;12;393;408;15;25;2.0
23;13;408;421;13;25;2.0
23;14;421;423;2;25;2.0
23;15;423;425;2;25;2.0
23;16;425;429;4;25;2.0
23;17;429;431;2;25;2.0
23;18;431;451;20;25;2.0
23;19;451;453;2;25;2.0
23;20;453;454;1;25;2.0
23;21;454;463;9;25;2.0
23;22;463;468;5;25;2.0
23;23;468;472;4;25;2.0
23;24;472;480;8;25;2.0
23;25;480;483;3;25;2.0
23;26;483;486;3;25;2.0
23;27;486;501;15;25;2.0
23;28;501;514;13;25;2.0
23;29;514;536;22;25;2.0
23;30;536;543;7;25;2.0
23;31;543;548;5;25;2.0
23;32;548;551;3;25;2.0
23;33;551;572;21;25;2.0
23;34;572;577;5;25;2.0
23;35;577;592;15;25;2.0
23;36;592;596;4;25;2.0
23;37;596;615;19;25;2.0
23;38;615;619;4;25;2.0
23;39;619;628;9;25;2.0
23;40;628;629;1;25;2.0
23;41;629;631;2;25;2.0
23;42;631;656;25;25;2.0
23;43;656;662;6;25;2.0
23;44;662;681;19;25;2.0
23;45;681;692;11;25;2.0
23;46;692;703;11;25;2.0
23;47;703;716;13;25;2.0
23;48;716;727;11;25;2.0
23;49;727;735;8;25;2.0
23;50;735;739;4;25;2.0
23;51;739;749;10;25;2.0
23;52;749;763;14;25;2.0
23;53;763;764;1;25;2.0
23;54;764;776;12;25;2.0
23;55;776;792;16;25;2.0
23;56;792;795;3;25;2.0
23;57;795;797;2;25;2.0
23;58;797;800;3;25;2.0
23;59;800;821;21;25;2.0
23;60;821;823;2;25;2.0
23;61;823;832;9;25;2.0
23;62;832;834;2;25;2.0
23;63;834;836;2;25;2.0
23;64;836;839;3;25;2.0
23;65;839;852;13;25;2.0
23;66;852;855;3;25;2.0
23;67;855;857;2;25;2.0
23;68;857;867;10;25;2.0
23;69;867;881;14;25;2.0
23;70;881;882;1;25;2.0
23;71;882;883;1;25;2.0
23;72;883;886;3;25;2.0
23;73;886;889;3;25;2.0
23;74;889;896;7;25;2.0
23;75;896;899;3;25;2.0
23;76;899;902;3;25;2.0
23;77;902;910;8;25;2.0
23;78;910;912;2;25;2.0
23;79;912;913;1;25;2.0
23;80;913;914;1;25;2.0
23;81;914;915;1;25;2.0
23;82;915;924;9;25;2.0
23;83;924;929;5;25;2.0
23;84;929;943;14;25;2.0
23;85;943;944;1;25;2.0
23;86;944;946;2;25;2.0
23;87;946;947;1;25;2.0
23;88;947;959;12;25;2.0
23;89;959;962;3;25;2.0
23;90;962;970;8;25;2.0
23;91;970;972;2;25;2.0
23;92;972;973;1;25;2.0
23;93;973;974;1;25;2.0
23;94;974;975;1;25;2.0
23;95;975;980;5;25;2.0
23;96;980;1003;23;25;2.0
23;97;1003;1004;1;25;2.0
23;98;1004;1006;2;25;2.0
23;99;1006;1008;2;25;2.0
23;100;1008;1012;4;25;2.0
23;101;1012;1019;7;25;2.0
23;102;1019;1020;1;25;2.0
23;103;1020;1032;12;25;2.0
23;104;1032;1034;2;25;2.0
23;105;1034;1038;4;25;2.0
23;106;1038;1064;26;25;2.0
23;107;1064;1066;2;25;2.0
23;108;1066;1067;1;25;2.0
23;109;1067;1089;22;25;2.0
23;110;1089;1093;4;25;2.0
23;111;1093;1100;7;25;2.0
23;112;1100;1124;24;25;2.0
23;113;1124;1141;17;25;2.0
23;114;1141;1150;9;25;2.0
23;115;1150;1176;26;25;2.0
23;116;1176;1219;43;25;2.0
23;117;1219;1223;4;25;2.0
23;118;1223;1270;47;25;2.0
23;119;1270;1281;11;25;2.0
23;120;1281;1323;42;25;2.0
23;121;1323;1344;21;25;2.0
23;122;1344;1390;46;25;2.0
23;123;1390;1394;4;25;2.0
23;124;1394;1409;15;25;2.0
23;125;1409;1424;15;25;2.0
23;126;1424;1439;15;25;2.0
23;127;1439;1454;15;25;2.0
23;128;1454;1469;15;25;2.0
23;129;1469;1484;15;25;2.0
23;130;1484;1499;15;25;2.0
23;131;1499;1514;15;25;2.0
23;132;1514;1529;15;25;2.0
23;133;1529;1544;15;25;2.0
23;134;1544;1559;15;25;2.0
23;135;1559;1574;15;25;2.0
23;136;1574;1589;15;25;2.0
23;137;1589;1604;15;25;2.0
23;138;1604;1619;15;25;2.0
23;139;1619;1634;15;25;2.0
23;140;1634;1649;15;25;2.0
23;141;1649;1664;15;25;2.0
23;142;1664;1680;16;25;2.0
24;0;240;333;93;0;0.83
24;1;333;339;6;0;0.83
24;2;339;354;15;0;0.83
24;3;354;359;5;0;0.83
24;4;359;362;3;0;0.83
24;5;362;369;7;0;0.83
24;6;369;372;3;0;0.83
24;7;372;378;6;0;0.83
24;8;378;384;6;0;0.83
24;9;384;386;2;0;0.83
24;10;386;389;3;0;0.83
24;11;389;394;5;0;0.83
24;12;394;409;15;0;0.83
24;13;409;419;10;0;0.83
24;14;419;424;5;0;0.83
24;15;424;426;2;0;0.83
24;16;426;429;3;0;0.83
24;17;429;432;3;0;0.83
24;18;432;435;3;0;0.83
24;19;435;449;14;0;0.83
24;20;449;454;5;0;0.83
24;21;454;455;1;0;0.83
24;22;455;461;6;0;0.83
24;23;461;469;8;0;0.83
24;24;469;474;5;0;0.83
24;25;474;477;3;0;0.83
24;26;477;484;7;0;0.83
24;27;484;503;19;0;0.83
24;28;503;505;2;0;0.83
24;29;505;516;11;0;0.83
24;30;516;536;20;0;0.83
24;31;536;544;8;0;0.83
24;32;544;548;4;0;0.83
24;33;548;549;1;0;0.83
24;34;549;575;26;0;0.83
24;35;575;578;3;0;0.83
24;36;578;593;15;0;0.83
24;37;593;596;3;0;0.83
24;38;596;600;4;0;0.83
24;39;600;617;17;0;0.83
24;40;617;620;3;0;0.83
24;41;620;629;9;0;0.83
24;42;629;631;2;0;0.83
24;43;631;656;25;0;0.83
24;44;656;663;7;0;0.83
24;45;663;683;20;0;0.83
24;46;683;695;12;0;0.83
24;47;695;704;9;0;0.83
24;48;704;716;12;0;0.83
24;49;716;720;4;0;0.83
24;50;720;728;8;0;0.83
24;51;728;737;9;0;0.83
24;52;737;740;3;0;0.83
24;53;740;751;11;0;0.83
24;54;751;762;11;0;0.83
24;55;762;764;2;0;0.83
24;56;764;776;12;0;0.83
24;57;776;795;19;0;0.83
24;58;795;797;2;0;0.83
24;59;797;798;1;0;0.83
24;60;798;802;4;0;0.83
24;61;802;824;22;0;0.83
24;62;824;825;1;0;0.83
24;63;825;832;7;0;0.83
24;64;832;834;2;0;0.83
24;65;834;836;2;0;0.83
24;66;836;840;4;0;0.83
24;67;840;853;13;0;0.83
24;68;853;857;4;0;0.83
24;69;857;858;1;0;0.83
24;70;858;868;10;0;0.83
24;71;868;879;11;0;0.83
24;72;879;883;4;0;0.83
24;73;883;884;1;0;0.83
24;74;884;887;3;0;0.83
24;75;887;890;3;0;0.83
24;76;890;896;6;0;0.83
24;77;896;901;5;0;0.83
24;78;901;905;4;0;0.83
24;79;905;912;7;0;0.83
24;80;912;913;1;0;0.83
24;81;913;914;1;0;0.83
24;82;914;917;3;0;0.83
24;83;917;925;8;0;0.83
24;84;925;931;6;0;0.83
24;85;931;942;11;0;0.83
24;86;942;944;2;0;0.83
24;87;944;948;4;0;0.83
24;88;948;950;2;0;0.83
24;89;950;961;11;0;0.83
24;90;961;965;4;0;0.83
24;91;965;972;7;0;0.83
24;92;972;973;1;0;0.83
24;93;973;974;1;0;0.83
24;94;974;977;3;0;0.83
24;95;977;982;5;0;0.83
24;96;982;1002;20;0;0.83
24;97;1002;1004;2;0;0.83
24;98;1004;1005;1;0;0.83
24;99;1005;1010;5;0;0.83
24;100;1010;1015;5;0;0.83
24;101;1015;1021;6;0;0.83
24;102;1021;1022;1;0;0.83
24;103;1022;1032;10;0;0.83
24;104;1032;1033;1;0;0.83
24;105;1033;1035;2;0;0.83
24;106;1035;1062;27;0;0.83
24;107;1062;1068;6;0;0.83
24;108;1068;1070;2;0;0.83
24;109;1070;1090;20;0;0.83
24;110;1090;1095;5;0;0.83
24;111;1095;1102;7;0;0.83
24;112;1102;1122;20;0;0.83
24;113;1122;1144;22;0;0.83
24;114;1144;1152;8;0;0.83
24;115;1152;1154;2;0;0.83
24;116;1154;1178;24;0;0.83
24;117;1178;1220;42;0;0.83
24;118;1220;1225;5;0;0.83
24;119;1225;1274;49;0;0.83
24;120;1274;1283;9;0;0.83
24;121;1283;1324;41;0;0.83
24;122;1324;1346;22;0;0.83
24;123;1346;1394;48;0;0.83
24;124;1394;1396;2;0;0.83
24;125;1396;1411;15;0;0.83
24;126;1411;1426;15;0;0.83
24;127;1426;1441;15;0;0.83
24;128;1441;1456;15;0;0.83
24;129;1456;1471;15;0;0.83
24;130;1471;1486;15;0;0.83
24;131;1486;1501;15;0;0.83
24;132;1501;1516;15;0;0.83
24;133;1516;1531;15;0;0.83
24;134;1531;1546;15;0;0.83
24;135;1546;1561;15;0;0.83
24;136;1561;1576;15;0;0.83
24;137;1576;1591;15;0;0.83
24;138;1591;1606;15;0;0.83
24;139;1606;1621;15;0;0.83
24;140;1621;1636;15;0;0.83
24;141;1636;1651;15;0;0.83
24;142;1651;1666;15;0;0.83
24;143;1666;1680;14;0;0.83
25;0;240;333;93;0;0.83
25;1;333;339;6;0;0.83
25;2;339;354;15;0;0.83
25;3;354;359;5;0;0.83
25;4;359;362;3;0;0.83
25;5;362;369;7;0;0.83
25;6;369;372;3;0;0.83
25;7;372;378;6;0;0.83
25;8;378;384;6;0;0.83
25;9;384;386;2;0;0.83
25;10;386;389;3;0;0.83
25;11;389;394;5;0;0.83
25;12;394;409;15;0;0.83
25;13;409;419;10;0;0.83
25;14;419;424;5;0;0.83
25;15;424;426;2;0;0.83
25;16;426;429;3;0;0.83
25;17;429;432;3;0;0.83
25;18;432;435;3;0;0.83
25;19;435;449;14;0;0.83
25;20;449;454;5;0;0.83
25;21;454;455;1;0;0.83
25;22;455;461;6;0;0.83
25;23;461;469;8;0;0.83
25;24;469;474;5;0;0.83
25;25;474;477;3;0;0.83
25;26;477;484;7;0;0.83
25;27;484;503;19;0;0.83
25;28;503;505;2;0;0.83
25;29;505;516;11;0;0.83
25;30;516;536;20;0;0.83
25;31;536;544;8;0;0.83
25;32;544;548;4;0;0.83
25;33;548;549;1;0;0.83
25;34;549;575;26;0;0.83
25;35;575;578;3;0;0.83
25;36;578;593;15;0;0.83
25;37;593;596;3;0;0.83
25;38;596;600;4;0;0.83
25;39;600;617;17;0;0.83
25;40;617;620;3;0;0.83
25;41;620;629;9;0;0.83
25;42;629;631;2;0;0.83
25;43;631;656;25;0;0.83
25;44;656;663;7;0;0.83
25;45;663;683;20;0;0.83
25;46;683;695;12;0;0.83
25;47;695;704;9;0;0.83
25;48;704;716;12;0;0.83
25;49;716;720;4;0;0.83
25;50;720;728;8;0;0.83
25;51;728;737;9;0;0.83
25;52;737;740;3;0;0.83
25;53;740;751;11;0;0.83
25;54;751;762;11;0;0.83
25;55;762;764;2;0;0.83
25;56;764;776;12;0;0.83
25;57;776;795;19;0;0.83
25;58;795;797;2;0;0.83
25;59;797;798;1;0;0.83
25;60;798;802;4;0;0.83
25;61;802;824;22;0;0.83
25;62;824;825;1;0;0.83
25;63;825;832;7;0;0.83
25;64;832;834;2;0;0.83
25;65;834;836;2;0;0.83
25;66;836;840;4;0;0.83
25;67;840;853;13;0;0.83
25;68;853;857;4;0;0.83
25;69;857;858;1;0;0.83
25;70;858;868;10;0;0.83
25;71;868;879;11;0;0.83
25;72;879;883;4;0;0.83
25;73;883;884;1;0;0.83
25;74;884;887;3;0;0.83
25;75;887;890;3;0;0.83
25;76;890;896;6;0;0.83
25;77;896;901;5;0;0.83
25;78;901;905;4;0;0.83
25;79;905;912;7;0;0.83
25;80;912;913;1;0;0.83
25;81;913;914;1;0;0.83
25;82;914;917;3;0;0.83
25;83;917;925;8;0;0.83
25;84;925;931;6;0;0.83
25;85;931;942;11;0;0.83
25;86;942;944;2;0;0.83
25;87;944;948;4;0;0.83
25;88;948;950;2;0;0.83
25;89;950;961;11;0;0.83
25;90;961;965;4;0;0.83
25;91;965;972;7;0;0.83
25;92;972;973;1;0;0.83
25;93;973;974;1;0;0.83
25;94;974;977;3;0;0.83
25;95;977;982;5;0;0.83
25;96;982;1002;20;0;0.83
25;97;1002;1004;2;0;0.83
25;98;1004;1005;1;0;0.83
25;99;1005;1010;5;0;0.83
25;100;1010;1015;5;0;0.83
25;101;1015;1021;6;0;0.83
25;102;1021;1022;1;0;0.83
25;103;1022;1032;10;0;0.83
25;104;1032;1033;1;0;0.83
25;105;1033;1035;2;0;0.83
25;106;1035;1062;27;0;0.83
25;107;1062;1068;6;0;0.83
25;108;1068;1070;2;0;0.83
25;109;1070;1090;20;0;0.83
25;110;1090;1095;5;0;0.83
25;111;1095;1102;7;0;0.83
25;112;1102;1122;20;0;0.83
25;113;1122;1144;22;0;0.83
25;114;1144;1152;8;0;0.83
25;115;1152;1154;2;0;0.83
25;116;1154;1178;24;0;0.83
25;117;1178;1220;42;0;0.83
25;118;1220;1225;5;0;0.83
25;119;1225;1274;49;0;0.83
25;120;1274;1283;9;0;0.83
25;121;1283;1324;41;0;0.83
25;122;1324;1346;22;0;0.83
25;123;1346;1394;48;0;0.83
25;124;1394;1396;2;0;0.83
25;125;1396;1411;15;0;0.83
25;126;1411;1426;15;0;0.83
25;127;1426;1441;15;0;0.83
25;128;1441;1456;15;0;0.83
25;129;1456;1471;15;0;0.83
25;130;1471;1486;15;0;0.83
25;131;1486;1501;15;0;0.83
25;132;1501;1516;15;0;0.83
25;133;1516;1531;15;0;0.83
25;134;1531;1546;15;0;0.83
25;135;1546;1561;15;0;0.83
25;136;1561;1576;15;0;0.83
25;137;1576;1591;15;0;0.83
25;138;1591;1606;15;0;0.83
25;139;1606;1621;15;0;0.83
25;140;1621;1636;15;0;0.83
25;141;1636;1651;15;0;0.83
25;142;1651;1666;15;0;0.83
25;143;1666;1680;14;0;0.83
26;0;240;333;93;0;0.83
26;1;333;339;6;0;0.83
26;2;339;354;15;0;0.83
26;3;354;359;5;0;0.83
26;4;359;362;3;0;0.83
26;5;362;369;7;0;0.83
26;6;369;372;3;0;0.83
26;7;372;378;6;0;0.83
26;8;378;384;6;0;0.83
26;9;384;386;2;0;0.83
26;10;386;389;3;0;0.83
26;11;389;394;5;0;0.83
26;12;394;409;15;0;0.83
26;13;409;419;10;0;0.83
26;14;419;424;5;0;0.83
26;15;424;426;2;0;0.83
26;16;426;429;3;0;0.83
26;17;429;432;3;0;0.83
26;18;432;435;3;0;0.83
26;19;435;449;14;0;0.83
26;20;449;454;5;0;0.83
26;21;454;455;1;0;0.83
26;22;455;461;6;0;0.83
26;23;461;469;8;0;0.83
26;24;469;474;5;0;0.83
26;25;474;477;3;0;0.83
26;26;477;484;7;0;0.83
26;27;484;503;19;0;0.83
26;28;503;505;2;0;0.83
26;29;505;516;11;0;0.83
26;30;516;536;20;0;0.83
26;31;536;544;8;0;0.83
26;32;544;548;4;0;0.83
26;33;548;549;1;0;0.83
26;34;549;575;26;0;0.83
26;35;575;578;3;0;0.83
26;36;578;593;15;0;0.83
26;37;593;596;3;0;0.83
26;38;596;600;4;0;0.83
26;39;600;617;17;0;0.83
26;40;617;620;3;0;0.83
26;41;620;629;9;0;0.83
26;42;629;631;2;0;0.83
26;43;631;656;25;0;0.83
26;44;656;663;7;0;0.83
26;45;663;683;20;0;0.83
26;46;683;695;12;0;0.83
26;47;695;704;9;0;0.83
26;48;704;716;12;0;0.83
26;49;716;720;4;0;0.83
26;50;720;728;8;0;0.83
26;51;728;737;9;0;0.83
26;52;737;740;3;0;0.83
26;53;740;751;11;0;0.83
26;54;751;762;11;0;0.83
26;55;762;764;2;0;0.83
26;56;764;776;12;0;0.83
26;57;776;795;19;0;0.83
26;58;795;797;2;0;0.83
26;59;797;798;1;0;0.83
26;60;798;802;4;0;0.83
26;61;802;824;22;0;0.83
26;62;824;825;1;0;0.83
26;63;825;832;7;0;0.83
26;64;832;834;2;0;0.83
26;65;834;836;2;0;0.83
26;66;836;840;4;0;0.83
26;67;840;853;13;0;0.83
26;68;853;857;4;0;0.83
26;69;857;858;1;0;0.83
26;70;858;868;10;0;0.83
26;71;868;879;11;0;0.83
26;72;879;883;4;0;0.83
26;73;883;884;1;0;0.83
26;74;884;887;3;0;0.83
26;75;887;890;3;0;0.83
26;76;890;896;6;0;0.83
26;77;896;901;5;0;0.83
26;78;901;905;4;0;0.83
26;79;905;912;7;0;0.83
26;80;912;913;1;0;0.83
26;81;913;914;1;0;0.83
26;82;914;917;3;0;0.83
26;83;917;925;8;0;0.83
26;84;925;931;6;0;0.83
26;85;931;942;11;0;0.83
26;86;942;944;2;0;0.83
26;87;944;948;4;0;0.83
26;88;948;950;2;0;0.83
26;89;950;961;11;0;0.83
26;90;961;965;4;0;0.83
26;91;965;972;7;0;0.83
26;92;972;973;1;0;0.83
26;93;973;974;1;0;0.83
26;94;974;977;3;0;0.83
26;95;977;982;5;0;0.83
26;96;982;1002;20;0;0.83
26;97;1002;1004;2;0;0.83
26;98;1004;1005;1;0;0.83
26;99;1005;1010;5;0;0.83
26;100;1010;1015;5;0;0.83
26;101;1015;1021;6;0;0.83
26;102;1021;1022;1;0;0.83
26;103;1022;1032;10;0;0.83
26;104;1032;1033;1;0;0.83
26;105;1033;1035;2;0;0.83
26;106;1035;1062;27;0;0.83
26;107;1062;1068;6;0;0.83
26;108;1068;1070;2;0;0.83
26;109;1070;1090;20;0;0.83
26;110;1090;1095;5;0;0.83
26;111;1095;1102;7;0;0.83
26;112;1102;1122;20;0;0.83
26;113;1122;1144;22;0;0.83
26;114;1144;1152;8;0;0.83
26;115;1152;1154;2;0;0.83
26;116;1154;1178;24;0;0.83
26;117;1178;1220;42;0;0.83
26;118;1220;1225;5;0;0.83
26;119;1225;1274;49;0;0.83
26;120;1274;1283;9;0;0.83
26;121;1283;1324;41;0;0.83
26;122;1324;1346;22;0;0.83
26;123;1346;1394;48;0;0.83
26;124;1394;1396;2;0;0.83
26;125;1396;1411;15;0;0.83
26;126;1411;1426;15;0;0.83
26;127;1426;1441;15;0;0.83
26;128;1441;1456;15;0;0.83
26;129;1456;1471;15;0;0.83
26;130;1471;1486;15;0;0.83
26;131;1486;1501;15;0;0.83
26;132;1501;1516;15;0;0.83
26;133;1516;1531;15;0;0.83
26;134;1531;1546;15;0;0.83
26;135;1546;1561;15;0;0.83
26;136;1561;1576;15;0;0.83
26;137;1576;1591;15;0;0.83
26;138;1591;1606;15;0;0.83
26;139;1606;1621;15;0;0.83
26;140;1621;1636;15;0;0.83
26;141;1636;1651;15;0;0.83
26;142;1651;1666;15;0;0.83
26;143;1666;1680;14;0;0.83
27;0;240;333;93;0;0.83
27;1;333;339;6;0;0.83
27;2;339;354;15;0;0.83
27;3;354;359;5;0;0.83
27;4;359;362;3;0;0.83
27;5;362;369;7;0;0.83
27;6;369;372;3;0;0.83
27;7;372;378;6;0;0.83
27;8;378;384;6;0;0.83
27;9;384;386;2;0;0.83
27;10;386;389;3;0;0.83
27;11;389;394;5;0;0.83
27;12;394;409;15;0;0.83
27;13;409;419;10;0;0.83
27;14;419;424;5;0;0.83
27;15;424;426;2;0;0.83
27;16;426;429;3;0;0.83
27;17;429;432;3;0;0.83
27;18;432;435;3;0;0.83
27;19;435;449;14;0;0.83
27;20;449;454;5;0;0.83
27;21;454;455;1;0;0.83
27;22;455;461;6;0;0.83
27;23;461;469;8;0;0.83
27;24;469;474;5;0;0.83
27;25;474;477;3;0;0.83
27;26;477;484;7;0;0.83
27;27;484;503;19;0;0.83
27;28;503;505;2;0;0.83
27;29;505;516;11;0;0.83
27;30;516;536;20;0;0.83
27;31;536;544;8;0;0.83
27;32;544;548;4;0;0.83
27;33;548;549;1;0;0.83
27;34;549;575;26;0;0.83
27;35;575;578;3;0;0.83
27;36;578;593;15;0;0.83
27;37;593;596;3;0;0.83
27;38;596;600;4;0;0.83
27;39;600;617;17;0;0.83
27;40;617;620;3;0;0.83
27;41;620;629;9;0;0.83
27;42;629;631;2;0;0.83
27;43;631;656;25;0;0.83
27;44;656;663;7;0;0.83
27;45;663;683;20;0;0.83
27;46;683;695;12;0;0.83
27;47;695;704;9;0;0.83
27;48;704;716;12;0;0.83
27;49;716;720;4;0;0.83
27;50;720;728;8;0;0.83
27;51;728;737;9;0;0.83
27;52;737;740;3;0;0.83
27;53;740;751;11;0;0.83
27;54;751;762;11;0;0.83
27;55;762;764;2;0;0.83
27;56;764;776;12;0;0.83
27;57;776;795;19;0;0.83
27;58;795;797;2;0;0.83
27;59;797;798;1;0;0.83
27;60;798;802;4;0;0.83
27;61;802;824;22;0;0.83
27;62;824;825;1;0;0.83
27;63;825;832;7;0;0.83
27;64;832;834;2;0;0.83
27;65;834;836;2;0;0.83
27;66;836;840;4;0;0.83
27;67;840;853;13;0;0.83
27;68;853;857;4;0;0.83
27;69;857;858;1;0;0.83
27;70;858;868;10;0;0.83
27;71;868;879;11;0;0.83
27;72;879;883;4;0;0.83
27;73;883;884;1;0;0.83
27;74;884;887;3;0;0.83
27;75;887;890;3;0;0.83
27;76;890;896;6;0;0.83
27;77;896;901;5;0;0.83
27;78;901;905;4;0;0.83
27;79;905;912;7;0;0.83
27;80;912;913;1;0;0.83
27;81;913;914;1;0;0.83
27;82;914;917;3;0;0.83
27;83;917;925;8;0;0.83
27;84;925;931;6;0;0.83
27;85;931;942;11;0;0.83
27;86;942;944;2;0;0.83
27;87;944;948;4;0;0.83
27;88;948;950;2;0;0.83
27;89;950;961;11;0;0.83
27;90;961;965;4;0;0.83
27;91;965;972;7;0;0.83
27;92;972;973;1;0;0.83
27;93;973;974;1;0;0.83
27;94;974;977;3;0;0.83
27;95;977;982;5;0;0.83
27;96;982;1002;20;0;0.83
27;97;1002;1004;2;0;0.83
27;98;1004;1005;1;0;0.83
27;99;1005;1010;5;0;0.83
27;100;1010;1015;5;0;0.83
27;101;1015;1021;6;0;0.83
27;102;1021;1022;1;0;0.83
27;103;1022;1032;10;0;0.83
27;104;1032;1033;1;0;0.83
27;105;1033;1035;2;0;0.83
27;106;1035;1062;27;0;0.83
27;107;1062;1068;6;0;0.83
27;108;1068;1070;2;0;0.83
27;109;1070;1090;20;0;0.83
27;110;1090;1095;5;0;0.83
27;111;1095;1102;7;0;0.83
27;112;1102;1122;20;0;0.83
27;113;1122;1144;22;0;0.83
27;114;1144;1152;8;0;0.83
27;115;1152;1154;2;0;0.83
27;116;1154;1178;24;0;0.83
27;117;1178;1220;42;0;0.83
27;118;1220;1225;5;0;0.83
27;119;1225;1274;49;0;0.83
27;120;1274;1283;9;0;0.83
27;121;1283;1324;41;0;0.83
27;122;1324;1346;22;0;0.83
27;123;1346;1394;48;0;0.83
27;124;1394;1396;2;0;0.83
27;125;1396;1411;15;0;0.83
27;126;1411;1426;15;0;0.83
27;127;1426;1441;15;0;0.83
27;128;1441;1456;15;0;0.83
27;129;1456;1471;15;0;0.83
27;130;1471;1486;15;0;0.83
27;131;1486;1501;15;0;0.83
27;132;1501;1516;15;0;0.83
27;133;1516;1531;15;0;0.83
27;134;1531;1546;15;0;0.83
27;135;1546;1561;15;0;0.83
27;136;1561;1576;15;0;0.83
27;137;1576;1591;15;0;0.83
27;138;1591;1606;15;0;0.83
27;139;1606;1621;15;0;0.83
27;140;1621;1636;15;0;0.83
27;141;1636;1651;15;0;0.83
27;142;1651;1666;15;0;0.83
27;143;1666;1680;14;0;0.83
28;0;240;333;93;0;0.83
28;1;333;339;6;0;0.83
28;2;339;354;15;0;0.83
28;3;354;359;5;0;0.83
28;4;359;362;3;0;0.83
28;5;362;369;7;0;0.83
28;6;369;372;3;0;0.83
28;7;372;378;6;0;0.83
28;8;378;384;6;0;0.83
28;9;384;386;2;0;0.83
28;10;386;389;3;0;0.83
28;11;389;394;5;0;0.83
28;12;394;409;15;0;0.83
28;13;409;419;10;0;0.83
28;14;419;424;5;0;0.83
28;15;424;426;2;0;0.83
28;16;426;429;3;0;0.83
28;17;429;432;3;0;0.83
28;18;432;435;3;0;0.83
28;19;435;449;14;0;0.83
28;20;449;454;5;0;0.83
28;21;454;455;1;0;0.83
28;22;455;461;6;0;0.83
28;23;461;469;8;0;0.83
28;24;469;474;5;0;0.83
28;25;474;477;3;0;0.83
28;26;477;484;7;0;0.83
28;27;484;503;19;0;0.83
28;28;503;505;2;0;0.83
28;29;505;516;11;0;0.83
28;30;516;536;20;0;0.83
28;31;536;544;8;0;0.83
28;32;544;548;4;0;0.83
28;33;548;549;1;0;0.83
28;34;549;575;26;0;0.83
28;35;575;578;3;0;0.83
28;36;578;593;15;0;0.83
28;37;593;596;3;0;0.83
28;38;596;600;4;0;0.83
28;39;600;617;17;0;0.83
28;40;617;620;3;0;0.83
28;41;620;629;9;0;0.83
28;42;629;631;2;0;0.83
28;43;631;656;25;0;0.83
28;44;656;663;7;0;0.83
28;45;663;683;20;0;0.83
28;46;683;695;12;0;0.83
28;47;695;704;9;0;0.83
28;48;704;716;12;0;0.83
28;49;716;720;4;0;0.83
28;50;720;728;8;0;0.83
28;51;728;737;9;0;0.83
28;52;737;740;3;0;0.83
28;53;740;751;11;0;0.83
28;54;751;762;11;0;0.83
28;55;762;764;2;0;0.83
28;56;764;776;12;0;0.83
28;57;776;795;19;0;0.83
28;58;795;797;2;0;0.83
28;59;797;798;1;0;0.83
28;60;798;802;4;0;0.83
28;61;802;824;22;0;0.83
28;62;824;825;1;0;0.83
28;63;825;832;7;0;0.83
28;64;832;834;2;0;0.83
28;65;834;836;2;0;0.83
28;66;836;840;4;0;0.83
28;67;840;853;13;0;0.83
28;68;853;857;4;0;0.83
28;69;857;858;1;0;0.83
28;70;858;868;10;0;0.83
28;71;868;879;11;0;0.83
28;72;879;883;4;0;0.83
28;73;883;884;1;0;0.83
28;74;884;887;3;0;0.83
28;75;887;890;3;0;0.83
28;76;890;896;6;0;0.83
28;77;896;901;5;0;0.83
28;78;901;905;4;0;0.83
28;79;905;912;7;0;0.83
28;80;912;913;1;0;0.83
28;81;913;914;1;0;0.83
28;82;914;917;3;0;0.83
28;83;917;925;8;0;0.83
28;84;925;931;6;0;0.83
28;85;931;942;11;0;0.83
28;86;942;944;2;0;0.83
28;87;944;948;4;0;0.83
28;88;948;950;2;0;0.83
28;89;950;961;11;0;0.83
28;90;961;965;4;0;0.83
28;91;965;972;7;0;0.83
28;92;972;973;1;0;0.83
28;93;973;974;1;0;0.83
28;94;974;977;3;0;0.83
28;95;977;982;5;0;0.83
28;96;982;1002;20;0;0.83
28;97;1002;1004;2;0;0.83
28;98;1004;1005;1;0;0.83
28;99;1005;1010;5;0;0.83
28;100;1010;1015;5;0;0.83
28;101;1015;1021;6;0;0.83
28;102;1021;1022;1;0;0.83
28;103;1022;1032;10;0;0.83
28;104;1032;1033;1;0;0.83
28;105;1033;1035;2;0;0.83
28;106;1035;1062;27;0;0.83
28;107;1062;1068;6;0;0.83
28;108;1068;1070;2;0;0.83
28;109;1070;1090;20;0;0.83
28;110;1090;1095;5;0;0.83
28;111;1095;1102;7;0;0.83
28;112;1102;1122;20;0;0.83
28;113;1122;1144;22;0;0.83
28;114;1144;1152;8;0;0.83
28;115;1152;1154;2;0;0.83
28;116;1154;1178;24;0;0.83
28;117;1178;1220;42;0;0.83
28;118;1220;1225;5;0;0.83
28;119;1225;1274;49;0;0.83
28;120;1274;1283;9;0;0.83
28;121;1283;1324;41;0;0.83
28;122;1324;1346;22;0;0.83
28;123;1346;1394;48;0;0.83
28;124;1394;1396;2;0;0.83
28;125;1396;1411;15;0;0.83
28;126;1411;1426;15;0;0.83
28;127;1426;1441;15;0;0.83
28;128;1441;1456;15;0;0.83
28;129;1456;1471;15;0;0.83
28;130;1471;1486;15;0;0.83
28;131;1486;1501;15;0;0.83
28;132;1501;1516;15;0;0.83
28;133;1516;1531;15;0;0.83
28;134;1531;1546;15;0;0.83
28;135;1546;1561;15;0;0.83
28;136;1561;1576;15;0;0.83
28;137;1576;1591;15;0;0.83
28;138;1591;1606;15;0;0.83
28;139;1606;1621;15;0;0.83
28;140;1621;1636;15;0;0.83
28;141;1636;1651;15;0;0.83
28;142;1651;1666;15;0;0.83
28;143;1666;1680;14;0;0.83
29;0;240;333;93;0;2.0
29;1;333;339;6;0;2.0
29;2;339;354;15;0;2.0
29;3;354;359;5;0;2.0
29;4;359;362;3;0;2.0
29;5;362;369;7;0;2.0
29;6;369;372;3;0;2.0
29;7;372;378;6;0;2.0
29;8;378;384;6;0;2.0
29;9;384;386;2;0;2.0
29;10;386;389;3;0;2.0
29;11;389;394;5;0;2.0
29;12;394;409;15;0;2.0
29;13;409;419;10;0;2.0
29;14;419;424;5;0;2.0
29;15;424;426;2;0;2.0
29;16;426;429;3;0;2.0
29;17;429;432;3;0;2.0
29;18;432;435;3;0;2.0
29;19;435;449;14;0;2.0
29;20;449;454;5;0;2.0
29;21;454;455;1;0;2.0
29;22;455;461;6;0;2.0
29;23;461;469;8;0;2.0
29;24;469;474;5;0;2.0
29;25;474;477;3;0;2.0
29;26;477;484;7;0;2.0
29;27;484;503;19;0;2.0
29;28;503;505;2;0;2.0
29;29;505;516;11;0;2.0
29;30;516;536;20;0;2.0
29;31;536;544;8;0;2.0
29;32;544;548;4;0;2.0
29;33;548;549;1;0;2.0
29;34;549;575;26;0;2.0
29;35;575;578;3;0;2.0
29;36;578;593;15;0;2.0
29;37;593;596;3;0;2.0
29;38;596;600;4;0;2.0
29;39;600;617;17;0;2.0
29;40;617;620;3;0;2.0
29;41;620;629;9;0;2.0
29;42;629;631;2;0;2.0
29;43;631;656;25;0;2.0
29;44;656;663;7;0;2.0
29;45;663;683;20;0;2.0
29;46;683;695;12;0;2.0
29;47;695;704;9;0;2.0
29;48;704;716;12;0;2.0
29;49;716;720;4;0;2.0
29;50;720;728;8;0;2.0
29;51;728;737;9;0;2.0
29;52;737;740;3;0;2.0
29;53;740;751;11;0;2.0
29;54;751;762;11;0;2.0
29;55;762;764;2;0;2.0
29;56;764;776;12;0;2.0
29;57;776;795;19;0;2.0
29;58;795;797;2;0;2.0
29;59;797;798;1;0;2.0
29;60;798;802;4;0;2.0
29;61;802;824;22;0;2.0
29;62;824;825;1;0;2.0
29;63;825;832;7;0;2.0
29;64;832;834;2;0;2.0
29;65;834;836;2;0;2.0
29;66;836;840;4;0;2.0
29;67;840;853;13;0;2.0
29;68;853;857;4;0;2.0
29;69;857;858;1;0;2.0
29;70;858;868;10;0;2.0
29;71;868;879;11;0;2.0
29;72;879;883;4;0;2.0
29;73;883;884;1;0;2.0
29;74;884;887;3;0;2.0
29;75;887;890;3;0;2.0
29;76;890;896;6;0;2.0
29;77;896;901;5;0;2.0
29;78;901;905;4;0;2.0
29;79;905;912;7;0;2.0
29;80;912;913;1;0;2.0
29;81;913;914;1;0;2.0
29;82;914;917;3;0;2.0
29;83;917;925;8;0;2.0
29;84;925;931;6;0;2.0
29;85;931;942;11;0;2.0
29;86;942;944;2;0;2.0
29;87;944;948;4;0;2.0
29;88;948;950;2;0;2.0
29;89;950;961;11;0;2.0
29;90;961;965;4;0;2.0
29;91;965;972;7;0;2.0
29;92;972;973;1;0;2.0
29;93;973;974;1;0;2.0
29;94;974;977;3;0;2.0
29;95;977;982;5;0;2.0
29;96;982;1002;20;0;2.0
29;97;1002;1004;2;0;2.0
29;98;1004;1005;1;0;2.0
29;99;1005;1010;5;0;2.0
29;100;1010;1015;5;0;2.0
29;101;1015;1021;6;0;2.0
29;102;1021;1022;1;0;2.0
29;103;1022;1032;10;0;2.0
29;104;1032;1033;1;0;2.0
29;105;1033;1035;2;0;2.0
29;106;1035;1062;27;0;2.0
29;107;1062;1068;6;0;2.0
29;108;1068;1070;2;0;2.0
29;109;1070;1090;20;0;2.0
29;110;1090;1095;5;0;2.0
29;111;1095;1102;7;0;2.0
29;112;1102;1122;20;0;2.0
29;113;1122;1144;22;0;2.0
29;114;1144;1152;8;0;2.0
29;115;1152;1154;2;0;2.0
29;116;1154;1178;24;0;2.0
29;117;1178;1220;42;0;2.0
29;118;1220;1225;5;0;2.0
29;119;1225;1274;49;0;2.0
29;120;1274;1283;9;0;2.0
29;121;1283;1324;41;0;2.0
29;122;1324;1346;22;0;2.0
29;123;1346;1394;48;0;2.0
29;124;1394;1396;2;0;2.0
29;125;1396;1411;15;0;2.0
29;126;1411;1426;15;0;2.0
29;127;1426;1441;15;0;2.0
29;128;1441;1456;15;0;2.0
29;129;1456;1471;15;0;2.0
29;130;1471;1486;15;0;2.0
29;131;1486;1501;15;0;2.0
29;132;1501;1516;15;0;2.0
29;133;1516;1531;15;0;2.0
29;134;1531;1546;15;0;2.0
29;135;1546;1561;15;0;2.0
29;136;1561;1576;15;0;2.0
29;137;1576;1591;15;0;2.0
29;138;1591;1606;15;0;2.0
29;139;1606;1621;15;0;2.0
29;140;1621;1636;15;0;2.0
29;141;1636;1651;15;0;2.0
29;142;1651;1666;15;0;2.0
29;143;1666;1680;14;0;2.0
30;0;240;333;93;0;2.0
30;1;333;339;6;0;2.0
30;2;339;354;15;0;2.0
30;3;354;359;5;0;2.0
30;4;359;362;3;0;2.0
30;5;362;369;7;0;2.0
30;6;369;372;3;0;2.0
30;7;372;378;6;0;2.0
30;8;378;384;6;0;2.0
30;9;384;386;2;0;2.0
30;10;386;389;3;0;2.0
30;11;389;394;5;0;2.0
30;12;394;409;15;0;2.0
30;13;409;419;10;0;2.0
30;14;419;424;5;0;2.0
30;15;424;426;2;0;2.0
30;16;426;429;3;0;2.0
30;17;429;432;3;0;2.0
30;18;432;435;3;0;2.0
30;19;435;449;14;0;2.0
30;20;449;454;5;0;2.0
30;21;454;455;1;0;2.0
30;22;455;461;6;0;2.0
30;23;461;469;8;0;2.0
30;24;469;474;5;0;2.0
30;25;474;477;3;0;2.0
30;26;477;484;7;0;2.0
30;27;484;503;19;0;2.0
30;28;503;505;2;0;2.0
30;29;505;516;11;0;2.0
30;30;516;536;20;0;2.0
30;31;536;544;8;0;2.0
30;32;544;548;4;0;2.0
30;33;548;549;1;0;2.0
30;34;549;575;26;0;2.0
30;35;575;578;3;0;2.0
30;36;578;593;15;0;2.0
30;37;593;596;3;0;2.0
30;38;596;600;4;0;2.0
30;39;600;617;17;0;2.0
30;40;617;620;3;0;2.0
30;41;620;629;9;0;2.0
30;42;629;631;2;0;2.0
30;43;631;656;25;0;2.0
30;44;656;663;7;0;2.0
30;45;663;683;20;0;2.0
30;46;683;695;12;0;2.0
30;47;695;704;9;0;2.0
30;48;704;716;12;0;2.0
30;49;716;720;4;0;2.0
30;50;720;728;8;0;2.0
30;51;728;737;9;0;2.0
30;52;737;740;3;0;2.0
30;53;740;751;11;0;2.0
30;54;751;762;11;0;2.0
30;55;762;764;2;0;2.0
30;56;764;776;12;0;2.0
30;57;776;795;19;0;2.0
30;58;795;797;2;0;2.0
30;59;797;798;1;0;2.0
30;60;798;802;4;0;2.0
30;61;802;824;22;0;2.0
30;62;824;825;1;0;2.0
30;63;825;832;7;0;2.0
30;64;832;834;2;0;2.0
30;65;834;836;2;0;2.0
30;66;836;840;4;0;2.0
30;67;840;853;13;0;2.0
30;68;853;857;4;0;2.0
30;69;857;858;1;0;2.0
30;70;858;868;10;0;2.0
30;71;868;879;11;0;2.0
30;72;879;883;4;0;2.0
30;73;883;884;1;0;2.0
30;74;884;887;3;0;2.0
30;75;887;890;3;0;2.0
30;76;890;896;6;0;2.0
30;77;896;901;5;0;2.0
30;78;901;905;4;0;2.0
30;79;905;912;7;0;2.0
30;80;912;913;1;0;2.0
30;81;913;914;1;0;2.0
30;82;914;917;3;0;2.0
30;83;917;925;8;0;2.0
30;84;925;931;6;0;2.0
30;85;931;942;11;0;2.0
30;86;942;944;2;0;2.0
30;87;944;948;4;0;2.0
30;88;948;950;2;0;2.0
30;89;950;961;11;0;2.0
30;90;961;965;4;0;2.0
30;91;965;972;7;0;2.0
30;92;972;973;1;0;2.0
30;93;973;974;1;0;2.0
30;94;974;977;3;0;2.0
30;95;977;982;5;0;2.0
30;96;982;1002;20;0;2.0
30;97;1002;1004;2;0;2.0
30;98;1004;1005;1;0;2.0
30;99;1005;1010;5;0;2.0
30;100;1010;1015;5;0;2.0
30;101;1015;1021;6;0;2.0
30;102;1021;1022;1;0;2.0
30;103;1022;1032;10;0;2.0
30;104;1032;1033;1;0;2.0
30;105;1033;1035;2;0;2.0
30;106;1035;1062;27;0;2.0
30;107;1062;1068;6;0;2.0
30;108;1068;1070;2;0;2.0
30;109;1070;1090;20;0;2.0
30;110;1090;1095;5;0;2.0
30;111;1095;1102;7;0;2.0
30;112;1102;1122;20;0;2.0
30;113;1122;1144;22;0;2.0
30;114;1144;1152;8;0;2.0
30;115;1152;1154;2;0;2.0
30;116;1154;1178;24;0;2.0
30;117;1178;1220;42;0;2.0
30;118;1220;1225;5;0;2.0
30;119;1225;1274;49;0;2.0
30;120;1274;1283;9;0;2.0
30;121;1283;1324;41;0;2.0
30;122;1324;1346;22;0;2.0
30;123;1346;1394;48;0;2.0
30;124;1394;1396;2;0;2.0
30;125;1396;1411;15;0;2.0
30;126;1411;1426;15;0;2.0
30;127;1426;1441;15;0;2.0
30;128;1441;1456;15;0;2.0
30;129;1456;1471;15;0;2.0
30;130;1471;1486;15;0;2.0
30;131;1486;1501;15;0;2.0
30;132;1501;1516;15;0;2.0
30;133;1516;1531;15;0;2.0
30;134;1531;1546;15;0;2.0
30;135;1546;1561;15;0;2.0
30;136;1561;1576;15;0;2.0
30;137;1576;1591;15;0;2.0
30;138;1591;1606;15;0;2.0
30;139;1606;1621;15;0;2.0
30;140;1621;1636;15;0;2.0
30;141;1636;1651;15;0;2.0
30;142;1651;1666;15;0;2.0
30;143;1666;1680;14;0;2.0
