Index Nabijacky;Index Udalosti;Cas Zaciatku;Cas Konca;CasTrvania;Miesto;Rychlost nabijania
0;0;249;337;88;112;2.0
0;1;337;352;15;112;2.0
0;2;352;357;5;112;2.0
0;3;357;363;6;112;2.0
0;4;363;373;10;112;2.0
0;5;373;392;19;112;2.0
0;6;392;393;1;112;2.0
0;7;393;407;14;112;2.0
0;8;407;423;16;112;2.0
0;9;423;424;1;112;2.0
0;10;424;433;9;112;2.0
0;11;433;452;19;112;2.0
0;12;452;453;1;112;2.0
0;13;453;465;12;112;2.0
0;14;465;467;2;112;2.0
0;15;467;482;15;112;2.0
0;16;482;488;6;112;2.0
0;17;488;505;17;112;2.0
0;18;505;553;48;112;2.0
0;19;553;591;38;112;2.0
0;20;591;633;42;112;2.0
0;21;633;661;28;112;2.0
0;22;661;685;24;112;2.0
0;23;685;726;41;112;2.0
0;24;726;766;40;112;2.0
0;25;766;796;30;112;2.0
0;26;796;836;40;112;2.0
0;27;836;838;2;112;2.0
0;28;838;851;13;112;2.0
0;29;851;866;15;112;2.0
0;30;866;881;15;112;2.0
0;31;881;883;2;112;2.0
0;32;883;891;8;112;2.0
0;33;891;911;20;112;2.0
0;34;911;916;5;112;2.0
0;35;916;946;30;112;2.0
0;36;946;971;25;112;2.0
0;37;971;976;5;112;2.0
0;38;976;984;8;112;2.0
0;39;984;1006;22;112;2.0
0;40;1006;1031;25;112;2.0
0;41;1031;1036;5;112;2.0
0;42;1036;1066;30;112;2.0
0;43;1066;1104;38;112;2.0
0;44;1104;1126;22;112;2.0
0;45;1126;1322;196;112;2.0
0;46;1322;1348;26;112;2.0
0;47;1348;1363;15;112;2.0
0;48;1363;1378;15;112;2.0
0;49;1378;1393;15;112;2.0
0;50;1393;1408;15;112;2.0
0;51;1408;1423;15;112;2.0
0;52;1423;1438;15;112;2.0
0;53;1438;1453;15;112;2.0
0;54;1453;1468;15;112;2.0
0;55;1468;1483;15;112;2.0
0;56;1483;1498;15;112;2.0
0;57;1498;1513;15;112;2.0
0;58;1513;1528;15;112;2.0
0;59;1528;1543;15;112;2.0
0;60;1543;1558;15;112;2.0
0;61;1558;1573;15;112;2.0
0;62;1573;1588;15;112;2.0
0;63;1588;1603;15;112;2.0
0;64;1603;1618;15;112;2.0
0;65;1618;1633;15;112;2.0
0;66;1633;1648;15;112;2.0
0;67;1648;1663;15;112;2.0
0;68;1663;1680;17;112;2.0
1;0;245;340;95;93;2.0
1;1;340;355;15;93;2.0
1;2;355;356;1;93;2.0
1;3;356;360;4;93;2.0
1;4;360;366;6;93;2.0
1;5;366;386;20;93;2.0
1;6;386;395;9;93;2.0
1;7;395;410;15;93;2.0
1;8;410;416;6;93;2.0
1;9;416;426;10;93;2.0
1;10;426;427;1;93;2.0
1;11;427;446;19;93;2.0
1;12;446;455;9;93;2.0
1;13;455;458;3;93;2.0
1;14;458;470;12;93;2.0
1;15;470;481;11;93;2.0
1;16;481;485;4;93;2.0
1;17;485;506;21;93;2.0
1;18;506;546;40;93;2.0
1;19;546;594;48;93;2.0
1;20;594;626;32;93;2.0
1;21;626;664;38;93;2.0
1;22;664;686;22;93;2.0
1;23;686;729;43;93;2.0
1;24;729;759;30;93;2.0
1;25;759;799;40;93;2.0
1;26;799;829;30;93;2.0
1;27;829;841;12;93;2.0
1;28;841;854;13;93;2.0
1;29;854;869;15;93;2.0
1;30;869;876;7;93;2.0
1;31;876;884;8;93;2.0
1;32;884;909;25;93;2.0
1;33;909;914;5;93;2.0
1;34;914;939;25;93;2.0
1;35;939;949;10;93;2.0
1;36;949;969;20;93;2.0
1;37;969;974;5;93;2.0
1;38;974;985;11;93;2.0
1;39;985;999;14;93;2.0
1;40;999;1029;30;93;2.0
1;41;1029;1034;5;93;2.0
1;42;1034;1059;25;93;2.0
1;43;1059;1069;10;93;2.0
1;44;1069;1105;36;93;2.0
1;45;1105;1119;14;93;2.0
1;46;1119;1325;206;93;2.0
1;47;1325;1349;24;93;2.0
1;48;1349;1364;15;93;2.0
1;49;1364;1379;15;93;2.0
1;50;1379;1394;15;93;2.0
1;51;1394;1409;15;93;2.0
1;52;1409;1424;15;93;2.0
1;53;1424;1439;15;93;2.0
1;54;1439;1454;15;93;2.0
1;55;1454;1469;15;93;2.0
1;56;1469;1484;15;93;2.0
1;57;1484;1499;15;93;2.0
1;58;1499;1514;15;93;2.0
1;59;1514;1529;15;93;2.0
1;60;1529;1544;15;93;2.0
1;61;1544;1559;15;93;2.0
1;62;1559;1574;15;93;2.0
1;63;1574;1589;15;93;2.0
1;64;1589;1604;15;93;2.0
1;65;1604;1619;15;93;2.0
1;66;1619;1634;15;93;2.0
1;67;1634;1649;15;93;2.0
1;68;1649;1664;15;93;2.0
1;69;1664;1680;16;93;2.0
2;0;246;339;93;92;2.0
2;1;339;354;15;92;2.0
2;2;354;355;1;92;2.0
2;3;355;359;4;92;2.0
2;4;359;365;6;92;2.0
2;5;365;385;20;92;2.0
2;6;385;394;9;92;2.0
2;7;394;409;15;92;2.0
2;8;409;415;6;92;2.0
2;9;415;425;10;92;2.0
2;10;425;426;1;92;2.0
2;11;426;445;19;92;2.0
2;12;445;454;9;92;2.0
2;13;454;457;3;92;2.0
2;14;457;469;12;92;2.0
2;15;469;480;11;92;2.0
2;16;480;484;4;92;2.0
2;17;484;505;21;92;2.0
2;18;505;545;40;92;2.0
2;19;545;593;48;92;2.0
2;20;593;625;32;92;2.0
2;21;625;663;38;92;2.0
2;22;663;685;22;92;2.0
2;23;685;728;43;92;2.0
2;24;728;758;30;92;2.0
2;25;758;798;40;92;2.0
2;26;798;828;30;92;2.0
2;27;828;840;12;92;2.0
2;28;840;853;13;92;2.0
2;29;853;868;15;92;2.0
2;30;868;875;7;92;2.0
2;31;875;883;8;92;2.0
2;32;883;908;25;92;2.0
2;33;908;913;5;92;2.0
2;34;913;938;25;92;2.0
2;35;938;948;10;92;2.0
2;36;948;968;20;92;2.0
2;37;968;973;5;92;2.0
2;38;973;984;11;92;2.0
2;39;984;998;14;92;2.0
2;40;998;1028;30;92;2.0
2;41;1028;1033;5;92;2.0
2;42;1033;1058;25;92;2.0
2;43;1058;1068;10;92;2.0
2;44;1068;1104;36;92;2.0
2;45;1104;1118;14;92;2.0
2;46;1118;1324;206;92;2.0
2;47;1324;1348;24;92;2.0
2;48;1348;1363;15;92;2.0
2;49;1363;1378;15;92;2.0
2;50;1378;1393;15;92;2.0
2;51;1393;1408;15;92;2.0
2;52;1408;1423;15;92;2.0
2;53;1423;1438;15;92;2.0
2;54;1438;1453;15;92;2.0
2;55;1453;1468;15;92;2.0
2;56;1468;1483;15;92;2.0
2;57;1483;1498;15;92;2.0
2;58;1498;1513;15;92;2.0
2;59;1513;1528;15;92;2.0
2;60;1528;1543;15;92;2.0
2;61;1543;1558;15;92;2.0
2;62;1558;1573;15;92;2.0
2;63;1573;1588;15;92;2.0
2;64;1588;1603;15;92;2.0
2;65;1603;1618;15;92;2.0
2;66;1618;1633;15;92;2.0
2;67;1633;1648;15;92;2.0
2;68;1648;1663;15;92;2.0
2;69;1663;1680;17;92;2.0
3;0;248;336;88;77;2.0
3;1;336;351;15;77;2.0
3;2;351;356;5;77;2.0
3;3;356;358;2;77;2.0
3;4;358;368;10;77;2.0
3;5;368;388;20;77;2.0
3;6;388;391;3;77;2.0
3;7;391;406;15;77;2.0
3;8;406;418;12;77;2.0
3;9;418;423;5;77;2.0
3;10;423;428;5;77;2.0
3;11;428;448;20;77;2.0
3;12;448;451;3;77;2.0
3;13;451;460;9;77;2.0
3;14;460;466;6;77;2.0
3;15;466;481;15;77;2.0
3;16;481;483;2;77;2.0
3;17;483;505;22;77;2.0
3;18;505;548;43;77;2.0
3;19;548;590;42;77;2.0
3;20;590;628;38;77;2.0
3;21;628;660;32;77;2.0
3;22;660;685;25;77;2.0
3;23;685;725;40;77;2.0
3;24;725;761;36;77;2.0
3;25;761;795;34;77;2.0
3;26;795;831;36;77;2.0
3;27;831;837;6;77;2.0
3;28;837;850;13;77;2.0
3;29;850;865;15;77;2.0
3;30;865;878;13;77;2.0
3;31;878;880;2;77;2.0
3;32;880;886;6;77;2.0
3;33;886;910;24;77;2.0
3;34;910;911;1;77;2.0
3;35;911;941;30;77;2.0
3;36;941;945;4;77;2.0
3;37;945;970;25;77;2.0
3;38;970;971;1;77;2.0
3;39;971;984;13;77;2.0
3;40;984;1001;17;77;2.0
3;41;1001;1030;29;77;2.0
3;42;1030;1031;1;77;2.0
3;43;1031;1061;30;77;2.0
3;44;1061;1065;4;77;2.0
3;45;1065;1104;39;77;2.0
3;46;1104;1121;17;77;2.0
3;47;1121;1321;200;77;2.0
3;48;1321;1348;27;77;2.0
3;49;1348;1363;15;77;2.0
3;50;1363;1378;15;77;2.0
3;51;1378;1393;15;77;2.0
3;52;1393;1408;15;77;2.0
3;53;1408;1423;15;77;2.0
3;54;1423;1438;15;77;2.0
3;55;1438;1453;15;77;2.0
3;56;1453;1468;15;77;2.0
3;57;1468;1483;15;77;2.0
3;58;1483;1498;15;77;2.0
3;59;1498;1513;15;77;2.0
3;60;1513;1528;15;77;2.0
3;61;1528;1543;15;77;2.0
3;62;1543;1558;15;77;2.0
3;63;1558;1573;15;77;2.0
3;64;1573;1588;15;77;2.0
3;65;1588;1603;15;77;2.0
3;66;1603;1618;15;77;2.0
3;67;1618;1633;15;77;2.0
3;68;1633;1648;15;77;2.0
3;69;1648;1663;15;77;2.0
3;70;1663;1680;17;77;2.0
4;0;245;337;92;119;2.0
4;1;337;352;15;119;2.0
4;2;352;357;5;119;2.0
4;3;357;367;10;119;2.0
4;4;367;387;20;119;2.0
4;5;387;392;5;119;2.0
4;6;392;407;15;119;2.0
4;7;407;417;10;119;2.0
4;8;417;424;7;119;2.0
4;9;424;427;3;119;2.0
4;10;427;447;20;119;2.0
4;11;447;452;5;119;2.0
4;12;452;459;7;119;2.0
4;13;459;467;8;119;2.0
4;14;467;482;15;119;2.0
4;15;482;503;21;119;2.0
4;16;503;547;44;119;2.0
4;17;547;591;44;119;2.0
4;18;591;627;36;119;2.0
4;19;627;661;34;119;2.0
4;20;661;683;22;119;2.0
4;21;683;726;43;119;2.0
4;22;726;760;34;119;2.0
4;23;760;796;36;119;2.0
4;24;796;830;34;119;2.0
4;25;830;838;8;119;2.0
4;26;838;851;13;119;2.0
4;27;851;866;15;119;2.0
4;28;866;877;11;119;2.0
4;29;877;881;4;119;2.0
4;30;881;885;4;119;2.0
4;31;885;910;25;119;2.0
4;32;910;911;1;119;2.0
4;33;911;940;29;119;2.0
4;34;940;946;6;119;2.0
4;35;946;970;24;119;2.0
4;36;970;971;1;119;2.0
4;37;971;982;11;119;2.0
4;38;982;1000;18;119;2.0
4;39;1000;1030;30;119;2.0
4;40;1030;1031;1;119;2.0
4;41;1031;1060;29;119;2.0
4;42;1060;1066;6;119;2.0
4;43;1066;1102;36;119;2.0
4;44;1102;1120;18;119;2.0
4;45;1120;1322;202;119;2.0
4;46;1322;1346;24;119;2.0
4;47;1346;1361;15;119;2.0
4;48;1361;1376;15;119;2.0
4;49;1376;1391;15;119;2.0
4;50;1391;1406;15;119;2.0
4;51;1406;1421;15;119;2.0
4;52;1421;1436;15;119;2.0
4;53;1436;1451;15;119;2.0
4;54;1451;1466;15;119;2.0
4;55;1466;1481;15;119;2.0
4;56;1481;1496;15;119;2.0
4;57;1496;1511;15;119;2.0
4;58;1511;1526;15;119;2.0
4;59;1526;1541;15;119;2.0
4;60;1541;1556;15;119;2.0
4;61;1556;1571;15;119;2.0
4;62;1571;1586;15;119;2.0
4;63;1586;1601;15;119;2.0
4;64;1601;1616;15;119;2.0
4;65;1616;1631;15;119;2.0
4;66;1631;1646;15;119;2.0
4;67;1646;1661;15;119;2.0
4;68;1661;1680;19;119;2.0
5;0;243;339;96;96;2.0
5;1;339;354;15;96;2.0
5;2;354;357;3;96;2.0
5;3;357;359;2;96;2.0
5;4;359;367;8;96;2.0
5;5;367;387;20;96;2.0
5;6;387;394;7;96;2.0
5;7;394;409;15;96;2.0
5;8;409;417;8;96;2.0
5;9;417;426;9;96;2.0
5;10;426;427;1;96;2.0
5;11;427;447;20;96;2.0
5;12;447;454;7;96;2.0
5;13;454;459;5;96;2.0
5;14;459;469;10;96;2.0
5;15;469;482;13;96;2.0
5;16;482;484;2;96;2.0
5;17;484;504;20;96;2.0
5;18;504;547;43;96;2.0
5;19;547;593;46;96;2.0
5;20;593;627;34;96;2.0
5;21;627;663;36;96;2.0
5;22;663;684;21;96;2.0
5;23;684;728;44;96;2.0
5;24;728;760;32;96;2.0
5;25;760;798;38;96;2.0
5;26;798;830;32;96;2.0
5;27;830;840;10;96;2.0
5;28;840;853;13;96;2.0
5;29;853;868;15;96;2.0
5;30;868;877;9;96;2.0
5;31;877;883;6;96;2.0
5;32;883;885;2;96;2.0
5;33;885;910;25;96;2.0
5;34;910;913;3;96;2.0
5;35;913;940;27;96;2.0
5;36;940;948;8;96;2.0
5;37;948;970;22;96;2.0
5;38;970;973;3;96;2.0
5;39;973;983;10;96;2.0
5;40;983;1000;17;96;2.0
5;41;1000;1030;30;96;2.0
5;42;1030;1033;3;96;2.0
5;43;1033;1060;27;96;2.0
5;44;1060;1068;8;96;2.0
5;45;1068;1103;35;96;2.0
5;46;1103;1120;17;96;2.0
5;47;1120;1324;204;96;2.0
5;48;1324;1347;23;96;2.0
5;49;1347;1362;15;96;2.0
5;50;1362;1377;15;96;2.0
5;51;1377;1392;15;96;2.0
5;52;1392;1407;15;96;2.0
5;53;1407;1422;15;96;2.0
5;54;1422;1437;15;96;2.0
5;55;1437;1452;15;96;2.0
5;56;1452;1467;15;96;2.0
5;57;1467;1482;15;96;2.0
5;58;1482;1497;15;96;2.0
5;59;1497;1512;15;96;2.0
5;60;1512;1527;15;96;2.0
5;61;1527;1542;15;96;2.0
5;62;1542;1557;15;96;2.0
5;63;1557;1572;15;96;2.0
5;64;1572;1587;15;96;2.0
5;65;1587;1602;15;96;2.0
5;66;1602;1617;15;96;2.0
5;67;1617;1632;15;96;2.0
5;68;1632;1647;15;96;2.0
5;69;1647;1662;15;96;2.0
5;70;1662;1680;18;96;2.0
6;0;252;334;82;160;2.0
6;1;334;349;15;160;2.0
6;2;349;354;5;160;2.0
6;3;354;363;9;160;2.0
6;4;363;373;10;160;2.0
6;5;373;389;16;160;2.0
6;6;389;393;4;160;2.0
6;7;393;404;11;160;2.0
6;8;404;421;17;160;2.0
6;9;421;423;2;160;2.0
6;10;423;433;10;160;2.0
6;11;433;449;16;160;2.0
6;12;449;453;4;160;2.0
6;13;453;464;11;160;2.0
6;14;464;465;1;160;2.0
6;15;465;479;14;160;2.0
6;16;479;488;9;160;2.0
6;17;488;511;23;160;2.0
6;18;511;553;42;160;2.0
6;19;553;588;35;160;2.0
6;20;588;633;45;160;2.0
6;21;633;658;25;160;2.0
6;22;658;691;33;160;2.0
6;23;691;723;32;160;2.0
6;24;723;766;43;160;2.0
6;25;766;793;27;160;2.0
6;26;793;835;42;160;2.0
6;27;835;836;1;160;2.0
6;28;836;848;12;160;2.0
6;29;848;863;15;160;2.0
6;30;863;878;15;160;2.0
6;31;878;883;5;160;2.0
6;32;883;891;8;160;2.0
6;33;891;908;17;160;2.0
6;34;908;916;8;160;2.0
6;35;916;943;27;160;2.0
6;36;943;946;3;160;2.0
6;37;946;968;22;160;2.0
6;38;968;976;8;160;2.0
6;39;976;990;14;160;2.0
6;40;990;1006;16;160;2.0
6;41;1006;1028;22;160;2.0
6;42;1028;1036;8;160;2.0
6;43;1036;1063;27;160;2.0
6;44;1063;1066;3;160;2.0
6;45;1066;1110;44;160;2.0
6;46;1110;1126;16;160;2.0
6;47;1126;1319;193;160;2.0
6;48;1319;1354;35;160;2.0
6;49;1354;1369;15;160;2.0
6;50;1369;1384;15;160;2.0
6;51;1384;1399;15;160;2.0
6;52;1399;1414;15;160;2.0
6;53;1414;1429;15;160;2.0
6;54;1429;1444;15;160;2.0
6;55;1444;1459;15;160;2.0
6;56;1459;1474;15;160;2.0
6;57;1474;1489;15;160;2.0
6;58;1489;1504;15;160;2.0
6;59;1504;1519;15;160;2.0
6;60;1519;1534;15;160;2.0
6;61;1534;1549;15;160;2.0
6;62;1549;1564;15;160;2.0
6;63;1564;1579;15;160;2.0
6;64;1579;1594;15;160;2.0
6;65;1594;1609;15;160;2.0
6;66;1609;1624;15;160;2.0
6;67;1624;1639;15;160;2.0
6;68;1639;1654;15;160;2.0
6;69;1654;1680;26;160;2.0
7;0;250;333;83;1;2.0
7;1;333;348;15;1;2.0
7;2;348;353;5;1;2.0
7;3;353;364;11;1;2.0
7;4;364;374;10;1;2.0
7;5;374;388;14;1;2.0
7;6;388;394;6;1;2.0
7;7;394;403;9;1;2.0
7;8;403;420;17;1;2.0
7;9;420;424;4;1;2.0
7;10;424;434;10;1;2.0
7;11;434;448;14;1;2.0
7;12;448;454;6;1;2.0
7;13;454;463;9;1;2.0
7;14;463;466;3;1;2.0
7;15;466;478;12;1;2.0
7;16;478;489;11;1;2.0
7;17;489;509;20;1;2.0
7;18;509;554;45;1;2.0
7;19;554;587;33;1;2.0
7;20;587;634;47;1;2.0
7;21;634;657;23;1;2.0
7;22;657;689;32;1;2.0
7;23;689;722;33;1;2.0
7;24;722;767;45;1;2.0
7;25;767;792;25;1;2.0
7;26;792;834;42;1;2.0
7;27;834;837;3;1;2.0
7;28;837;847;10;1;2.0
7;29;847;862;15;1;2.0
7;30;862;877;15;1;2.0
7;31;877;884;7;1;2.0
7;32;884;892;8;1;2.0
7;33;892;907;15;1;2.0
7;34;907;917;10;1;2.0
7;35;917;942;25;1;2.0
7;36;942;947;5;1;2.0
7;37;947;967;20;1;2.0
7;38;967;977;10;1;2.0
7;39;977;988;11;1;2.0
7;40;988;1007;19;1;2.0
7;41;1007;1027;20;1;2.0
7;42;1027;1037;10;1;2.0
7;43;1037;1062;25;1;2.0
7;44;1062;1067;5;1;2.0
7;45;1067;1108;41;1;2.0
7;46;1108;1127;19;1;2.0
7;47;1127;1318;191;1;2.0
7;48;1318;1352;34;1;2.0
7;49;1352;1367;15;1;2.0
7;50;1367;1382;15;1;2.0
7;51;1382;1397;15;1;2.0
7;52;1397;1412;15;1;2.0
7;53;1412;1427;15;1;2.0
7;54;1427;1442;15;1;2.0
7;55;1442;1457;15;1;2.0
7;56;1457;1472;15;1;2.0
7;57;1472;1487;15;1;2.0
7;58;1487;1502;15;1;2.0
7;59;1502;1517;15;1;2.0
7;60;1517;1532;15;1;2.0
7;61;1532;1547;15;1;2.0
7;62;1547;1562;15;1;2.0
7;63;1562;1577;15;1;2.0
7;64;1577;1592;15;1;2.0
7;65;1592;1607;15;1;2.0
7;66;1607;1622;15;1;2.0
7;67;1622;1637;15;1;2.0
7;68;1637;1652;15;1;2.0
7;69;1652;1667;15;1;2.0
7;70;1667;1680;13;1;2.0
8;0;250;344;94;43;2.0
8;1;344;359;15;43;2.0
8;2;359;364;5;43;2.0
8;3;364;367;3;43;2.0
8;4;367;377;10;43;2.0
8;5;377;397;20;43;2.0
8;6;397;399;2;43;2.0
8;7;399;414;15;43;2.0
8;8;414;427;13;43;2.0
8;9;427;431;4;43;2.0
8;10;431;437;6;43;2.0
8;11;437;457;20;43;2.0
8;12;457;459;2;43;2.0
8;13;459;469;10;43;2.0
8;14;469;474;5;43;2.0
8;15;474;489;15;43;2.0
8;16;489;492;3;43;2.0
8;17;492;506;14;43;2.0
8;18;506;557;51;43;2.0
8;19;557;598;41;43;2.0
8;20;598;637;39;43;2.0
8;21;637;668;31;43;2.0
8;22;668;686;18;43;2.0
8;23;686;733;47;43;2.0
8;24;733;770;37;43;2.0
8;25;770;803;33;43;2.0
8;26;803;840;37;43;2.0
8;27;840;845;5;43;2.0
8;28;845;858;13;43;2.0
8;29;858;873;15;43;2.0
8;30;873;887;14;43;2.0
8;31;887;888;1;43;2.0
8;32;888;895;7;43;2.0
8;33;895;918;23;43;2.0
8;34;918;920;2;43;2.0
8;35;920;950;30;43;2.0
8;36;950;953;3;43;2.0
8;37;953;978;25;43;2.0
8;38;978;980;2;43;2.0
8;39;980;985;5;43;2.0
8;40;985;1010;25;43;2.0
8;41;1010;1038;28;43;2.0
8;42;1038;1040;2;43;2.0
8;43;1040;1070;30;43;2.0
8;44;1070;1073;3;43;2.0
8;45;1073;1105;32;43;2.0
8;46;1105;1130;25;43;2.0
8;47;1130;1329;199;43;2.0
8;48;1329;1349;20;43;2.0
8;49;1349;1364;15;43;2.0
8;50;1364;1379;15;43;2.0
8;51;1379;1394;15;43;2.0
8;52;1394;1409;15;43;2.0
8;53;1409;1424;15;43;2.0
8;54;1424;1439;15;43;2.0
8;55;1439;1454;15;43;2.0
8;56;1454;1469;15;43;2.0
8;57;1469;1484;15;43;2.0
8;58;1484;1499;15;43;2.0
8;59;1499;1514;15;43;2.0
8;60;1514;1529;15;43;2.0
8;61;1529;1544;15;43;2.0
8;62;1544;1559;15;43;2.0
8;63;1559;1574;15;43;2.0
8;64;1574;1589;15;43;2.0
8;65;1589;1604;15;43;2.0
8;66;1604;1619;15;43;2.0
8;67;1619;1634;15;43;2.0
8;68;1634;1649;15;43;2.0
8;69;1649;1664;15;43;2.0
8;70;1664;1680;16;43;2.0
9;0;250;333;83;4;2.0
9;1;333;348;15;4;2.0
9;2;348;353;5;4;2.0
9;3;353;364;11;4;2.0
9;4;364;374;10;4;2.0
9;5;374;388;14;4;2.0
9;6;388;394;6;4;2.0
9;7;394;403;9;4;2.0
9;8;403;420;17;4;2.0
9;9;420;424;4;4;2.0
9;10;424;434;10;4;2.0
9;11;434;448;14;4;2.0
9;12;448;454;6;4;2.0
9;13;454;463;9;4;2.0
9;14;463;466;3;4;2.0
9;15;466;478;12;4;2.0
9;16;478;489;11;4;2.0
9;17;489;507;18;4;2.0
9;18;507;554;47;4;2.0
9;19;554;587;33;4;2.0
9;20;587;634;47;4;2.0
9;21;634;657;23;4;2.0
9;22;657;687;30;4;2.0
9;23;687;722;35;4;2.0
9;24;722;767;45;4;2.0
9;25;767;792;25;4;2.0
9;26;792;834;42;4;2.0
9;27;834;837;3;4;2.0
9;28;837;847;10;4;2.0
9;29;847;862;15;4;2.0
9;30;862;877;15;4;2.0
9;31;877;884;7;4;2.0
9;32;884;892;8;4;2.0
9;33;892;907;15;4;2.0
9;34;907;917;10;4;2.0
9;35;917;942;25;4;2.0
9;36;942;947;5;4;2.0
9;37;947;967;20;4;2.0
9;38;967;977;10;4;2.0
9;39;977;986;9;4;2.0
9;40;986;1007;21;4;2.0
9;41;1007;1027;20;4;2.0
9;42;1027;1037;10;4;2.0
9;43;1037;1062;25;4;2.0
9;44;1062;1067;5;4;2.0
9;45;1067;1106;39;4;2.0
9;46;1106;1127;21;4;2.0
9;47;1127;1318;191;4;2.0
9;48;1318;1350;32;4;2.0
9;49;1350;1365;15;4;2.0
9;50;1365;1380;15;4;2.0
9;51;1380;1395;15;4;2.0
9;52;1395;1410;15;4;2.0
9;53;1410;1425;15;4;2.0
9;54;1425;1440;15;4;2.0
9;55;1440;1455;15;4;2.0
9;56;1455;1470;15;4;2.0
9;57;1470;1485;15;4;2.0
9;58;1485;1500;15;4;2.0
9;59;1500;1515;15;4;2.0
9;60;1515;1530;15;4;2.0
9;61;1530;1545;15;4;2.0
9;62;1545;1560;15;4;2.0
9;63;1560;1575;15;4;2.0
9;64;1575;1590;15;4;2.0
9;65;1590;1605;15;4;2.0
9;66;1605;1620;15;4;2.0
9;67;1620;1635;15;4;2.0
9;68;1635;1650;15;4;2.0
9;69;1650;1665;15;4;2.0
9;70;1665;1680;15;4;2.0
10;0;252;344;92;11;2.0
10;1;344;359;15;11;2.0
10;2;359;364;5;11;2.0
10;3;364;368;4;11;2.0
10;4;368;378;10;11;2.0
10;5;378;398;20;11;2.0
10;6;398;399;1;11;2.0
10;7;399;414;15;11;2.0
10;8;414;428;14;11;2.0
10;9;428;431;3;11;2.0
10;10;431;438;7;11;2.0
10;11;438;458;20;11;2.0
10;12;458;459;1;11;2.0
10;13;459;470;11;11;2.0
10;14;470;474;4;11;2.0
10;15;474;489;15;11;2.0
10;16;489;493;4;11;2.0
10;17;493;507;14;11;2.0
10;18;507;558;51;11;2.0
10;19;558;598;40;11;2.0
10;20;598;638;40;11;2.0
10;21;638;668;30;11;2.0
10;22;668;687;19;11;2.0
10;23;687;733;46;11;2.0
10;24;733;771;38;11;2.0
10;25;771;803;32;11;2.0
10;26;803;841;38;11;2.0
10;27;841;845;4;11;2.0
10;28;845;858;13;11;2.0
10;29;858;873;15;11;2.0
10;30;873;888;15;11;2.0
10;31;888;896;8;11;2.0
10;32;896;918;22;11;2.0
10;33;918;921;3;11;2.0
10;34;921;951;30;11;2.0
10;35;951;953;2;11;2.0
10;36;953;978;25;11;2.0
10;37;978;981;3;11;2.0
10;38;981;986;5;11;2.0
10;39;986;1011;25;11;2.0
10;40;1011;1038;27;11;2.0
10;41;1038;1041;3;11;2.0
10;42;1041;1071;30;11;2.0
10;43;1071;1073;2;11;2.0
10;44;1073;1106;33;11;2.0
10;45;1106;1131;25;11;2.0
10;46;1131;1329;198;11;2.0
10;47;1329;1350;21;11;2.0
10;48;1350;1365;15;11;2.0
10;49;1365;1380;15;11;2.0
10;50;1380;1395;15;11;2.0
10;51;1395;1410;15;11;2.0
10;52;1410;1425;15;11;2.0
10;53;1425;1440;15;11;2.0
10;54;1440;1455;15;11;2.0
10;55;1455;1470;15;11;2.0
10;56;1470;1485;15;11;2.0
10;57;1485;1500;15;11;2.0
10;58;1500;1515;15;11;2.0
10;59;1515;1530;15;11;2.0
10;60;1530;1545;15;11;2.0
10;61;1545;1560;15;11;2.0
10;62;1560;1575;15;11;2.0
10;63;1575;1590;15;11;2.0
10;64;1590;1605;15;11;2.0
10;65;1605;1620;15;11;2.0
10;66;1620;1635;15;11;2.0
10;67;1635;1650;15;11;2.0
10;68;1650;1665;15;11;2.0
10;69;1665;1680;15;11;2.0
11;0;250;344;94;87;2.0
11;1;344;359;15;87;2.0
11;2;359;361;2;87;2.0
11;3;361;364;3;87;2.0
11;4;364;371;7;87;2.0
11;5;371;391;20;87;2.0
11;6;391;399;8;87;2.0
11;7;399;414;15;87;2.0
11;8;414;421;7;87;2.0
11;9;421;431;10;87;2.0
11;10;431;451;20;87;2.0
11;11;451;459;8;87;2.0
11;12;459;463;4;87;2.0
11;13;463;474;11;87;2.0
11;14;474;486;12;87;2.0
11;15;486;489;3;87;2.0
11;16;489;511;22;87;2.0
11;17;511;551;40;87;2.0
11;18;551;598;47;87;2.0
11;19;598;631;33;87;2.0
11;20;631;668;37;87;2.0
11;21;668;691;23;87;2.0
11;22;691;733;42;87;2.0
11;23;733;764;31;87;2.0
11;24;764;803;39;87;2.0
11;25;803;834;31;87;2.0
11;26;834;845;11;87;2.0
11;27;845;858;13;87;2.0
11;28;858;873;15;87;2.0
11;29;873;881;8;87;2.0
11;30;881;888;7;87;2.0
11;31;888;889;1;87;2.0
11;32;889;914;25;87;2.0
11;33;914;918;4;87;2.0
11;34;918;944;26;87;2.0
11;35;944;953;9;87;2.0
11;36;953;974;21;87;2.0
11;37;974;978;4;87;2.0
11;38;978;990;12;87;2.0
11;39;990;1004;14;87;2.0
11;40;1004;1034;30;87;2.0
11;41;1034;1038;4;87;2.0
11;42;1038;1064;26;87;2.0
11;43;1064;1073;9;87;2.0
11;44;1073;1110;37;87;2.0
11;45;1110;1124;14;87;2.0
11;46;1124;1329;205;87;2.0
11;47;1329;1354;25;87;2.0
11;48;1354;1369;15;87;2.0
11;49;1369;1384;15;87;2.0
11;50;1384;1399;15;87;2.0
11;51;1399;1414;15;87;2.0
11;52;1414;1429;15;87;2.0
11;53;1429;1444;15;87;2.0
11;54;1444;1459;15;87;2.0
11;55;1459;1474;15;87;2.0
11;56;1474;1489;15;87;2.0
11;57;1489;1504;15;87;2.0
11;58;1504;1519;15;87;2.0
11;59;1519;1534;15;87;2.0
11;60;1534;1549;15;87;2.0
11;61;1549;1564;15;87;2.0
11;62;1564;1579;15;87;2.0
11;63;1579;1594;15;87;2.0
11;64;1594;1609;15;87;2.0
11;65;1609;1624;15;87;2.0
11;66;1624;1639;15;87;2.0
11;67;1639;1654;15;87;2.0
11;68;1654;1669;15;87;2.0
11;69;1669;1680;11;87;2.0
12;0;246;340;94;72;2.0
12;1;340;354;14;72;2.0
12;2;354;355;1;72;2.0
12;3;355;360;5;72;2.0
12;4;360;364;4;72;2.0
12;5;364;384;20;72;2.0
12;6;384;395;11;72;2.0
12;7;395;410;15;72;2.0
12;8;410;414;4;72;2.0
12;9;414;424;10;72;2.0
12;10;424;427;3;72;2.0
12;11;427;444;17;72;2.0
12;12;444;455;11;72;2.0
12;13;455;456;1;72;2.0
12;14;456;470;14;72;2.0
12;15;470;479;9;72;2.0
12;16;479;485;6;72;2.0
12;17;485;506;21;72;2.0
12;18;506;544;38;72;2.0
12;19;544;594;50;72;2.0
12;20;594;624;30;72;2.0
12;21;624;664;40;72;2.0
12;22;664;686;22;72;2.0
12;23;686;729;43;72;2.0
12;24;729;757;28;72;2.0
12;25;757;799;42;72;2.0
12;26;799;827;28;72;2.0
12;27;827;841;14;72;2.0
12;28;841;854;13;72;2.0
12;29;854;869;15;72;2.0
12;30;869;874;5;72;2.0
12;31;874;882;8;72;2.0
12;32;882;884;2;72;2.0
12;33;884;907;23;72;2.0
12;34;907;914;7;72;2.0
12;35;914;937;23;72;2.0
12;36;937;949;12;72;2.0
12;37;949;967;18;72;2.0
12;38;967;974;7;72;2.0
12;39;974;985;11;72;2.0
12;40;985;997;12;72;2.0
12;41;997;1027;30;72;2.0
12;42;1027;1034;7;72;2.0
12;43;1034;1057;23;72;2.0
12;44;1057;1069;12;72;2.0
12;45;1069;1105;36;72;2.0
12;46;1105;1117;12;72;2.0
12;47;1117;1325;208;72;2.0
12;48;1325;1349;24;72;2.0
12;49;1349;1364;15;72;2.0
12;50;1364;1379;15;72;2.0
12;51;1379;1394;15;72;2.0
12;52;1394;1409;15;72;2.0
12;53;1409;1424;15;72;2.0
12;54;1424;1439;15;72;2.0
12;55;1439;1454;15;72;2.0
12;56;1454;1469;15;72;2.0
12;57;1469;1484;15;72;2.0
12;58;1484;1499;15;72;2.0
12;59;1499;1514;15;72;2.0
12;60;1514;1529;15;72;2.0
12;61;1529;1544;15;72;2.0
12;62;1544;1559;15;72;2.0
12;63;1559;1574;15;72;2.0
12;64;1574;1589;15;72;2.0
12;65;1589;1604;15;72;2.0
12;66;1604;1619;15;72;2.0
12;67;1619;1634;15;72;2.0
12;68;1634;1649;15;72;2.0
12;69;1649;1664;15;72;2.0
12;70;1664;1680;16;72;2.0
13;0;249;330;81;58;2.0
13;1;330;345;15;58;2.0
13;2;345;350;5;58;2.0
13;3;350;363;13;58;2.0
13;4;363;373;10;58;2.0
13;5;373;385;12;58;2.0
13;6;385;393;8;58;2.0
13;7;393;400;7;58;2.0
13;8;400;417;17;58;2.0
13;9;417;423;6;58;2.0
13;10;423;433;10;58;2.0
13;11;433;445;12;58;2.0
13;12;445;453;8;58;2.0
13;13;453;460;7;58;2.0
13;14;460;465;5;58;2.0
13;15;465;475;10;58;2.0
13;16;475;488;13;58;2.0
13;17;488;508;20;58;2.0
13;18;508;553;45;58;2.0
13;19;553;584;31;58;2.0
13;20;584;633;49;58;2.0
13;21;633;654;21;58;2.0
13;22;654;688;34;58;2.0
13;23;688;719;31;58;2.0
13;24;719;766;47;58;2.0
13;25;766;789;23;58;2.0
13;26;789;831;42;58;2.0
13;27;831;836;5;58;2.0
13;28;836;844;8;58;2.0
13;29;844;859;15;58;2.0
13;30;859;874;15;58;2.0
13;31;874;883;9;58;2.0
13;32;883;891;8;58;2.0
13;33;891;904;13;58;2.0
13;34;904;916;12;58;2.0
13;35;916;939;23;58;2.0
13;36;939;946;7;58;2.0
13;37;946;964;18;58;2.0
13;38;964;976;12;58;2.0
13;39;976;987;11;58;2.0
13;40;987;1006;19;58;2.0
13;41;1006;1024;18;58;2.0
13;42;1024;1036;12;58;2.0
13;43;1036;1059;23;58;2.0
13;44;1059;1066;7;58;2.0
13;45;1066;1107;41;58;2.0
13;46;1107;1126;19;58;2.0
13;47;1126;1315;189;58;2.0
13;48;1315;1351;36;58;2.0
13;49;1351;1366;15;58;2.0
13;50;1366;1381;15;58;2.0
13;51;1381;1396;15;58;2.0
13;52;1396;1411;15;58;2.0
13;53;1411;1426;15;58;2.0
13;54;1426;1441;15;58;2.0
13;55;1441;1456;15;58;2.0
13;56;1456;1471;15;58;2.0
13;57;1471;1486;15;58;2.0
13;58;1486;1501;15;58;2.0
13;59;1501;1516;15;58;2.0
13;60;1516;1531;15;58;2.0
13;61;1531;1546;15;58;2.0
13;62;1546;1561;15;58;2.0
13;63;1561;1576;15;58;2.0
13;64;1576;1591;15;58;2.0
13;65;1591;1606;15;58;2.0
13;66;1606;1621;15;58;2.0
13;67;1621;1636;15;58;2.0
13;68;1636;1651;15;58;2.0
13;69;1651;1666;15;58;2.0
13;70;1666;1680;14;58;2.0
14;0;257;350;93;115;2.0
14;1;350;365;15;115;2.0
14;2;365;370;5;115;2.0
14;3;370;380;10;115;2.0
14;4;380;400;20;115;2.0
14;5;400;405;5;115;2.0
14;6;405;420;15;115;2.0
14;7;420;430;10;115;2.0
14;8;430;437;7;115;2.0
14;9;437;440;3;115;2.0
14;10;440;460;20;115;2.0
14;11;460;465;5;115;2.0
14;12;465;472;7;115;2.0
14;13;472;480;8;115;2.0
14;14;480;495;15;115;2.0
14;15;495;513;18;115;2.0
14;16;513;560;47;115;2.0
14;17;560;604;44;115;2.0
14;18;604;640;36;115;2.0
14;19;640;674;34;115;2.0
14;20;674;693;19;115;2.0
14;21;693;739;46;115;2.0
14;22;739;773;34;115;2.0
14;23;773;809;36;115;2.0
14;24;809;843;34;115;2.0
14;25;843;851;8;115;2.0
14;26;851;864;13;115;2.0
14;27;864;879;15;115;2.0
14;28;879;890;11;115;2.0
14;29;890;894;4;115;2.0
14;30;894;898;4;115;2.0
14;31;898;923;25;115;2.0
14;32;923;924;1;115;2.0
14;33;924;953;29;115;2.0
14;34;953;959;6;115;2.0
14;35;959;983;24;115;2.0
14;36;983;984;1;115;2.0
14;37;984;992;8;115;2.0
14;38;992;1013;21;115;2.0
14;39;1013;1043;30;115;2.0
14;40;1043;1044;1;115;2.0
14;41;1044;1073;29;115;2.0
14;42;1073;1079;6;115;2.0
14;43;1079;1112;33;115;2.0
14;44;1112;1133;21;115;2.0
14;45;1133;1335;202;115;2.0
14;46;1335;1356;21;115;2.0
14;47;1356;1371;15;115;2.0
14;48;1371;1386;15;115;2.0
14;49;1386;1401;15;115;2.0
14;50;1401;1416;15;115;2.0
14;51;1416;1431;15;115;2.0
14;52;1431;1446;15;115;2.0
14;53;1446;1461;15;115;2.0
14;54;1461;1476;15;115;2.0
14;55;1476;1491;15;115;2.0
14;56;1491;1506;15;115;2.0
14;57;1506;1521;15;115;2.0
14;58;1521;1536;15;115;2.0
14;59;1536;1551;15;115;2.0
14;60;1551;1566;15;115;2.0
14;61;1566;1581;15;115;2.0
14;62;1581;1596;15;115;2.0
14;63;1596;1611;15;115;2.0
14;64;1611;1626;15;115;2.0
14;65;1626;1641;15;115;2.0
14;66;1641;1656;15;115;2.0
14;67;1656;1680;24;115;2.0
15;0;260;349;89;159;2.0
15;1;349;364;15;159;2.0
15;2;364;369;5;159;2.0
15;3;369;375;6;159;2.0
15;4;375;385;10;159;2.0
15;5;385;404;19;159;2.0
15;6;404;405;1;159;2.0
15;7;405;419;14;159;2.0
15;8;419;435;16;159;2.0
15;9;435;436;1;159;2.0
15;10;436;445;9;159;2.0
15;11;445;464;19;159;2.0
15;12;464;465;1;159;2.0
15;13;465;477;12;159;2.0
15;14;477;479;2;159;2.0
15;15;479;494;15;159;2.0
15;16;494;500;6;159;2.0
15;17;500;515;15;159;2.0
15;18;515;565;50;159;2.0
15;19;565;603;38;159;2.0
15;20;603;645;42;159;2.0
15;21;645;673;28;159;2.0
15;22;673;695;22;159;2.0
15;23;695;738;43;159;2.0
15;24;738;778;40;159;2.0
15;25;778;808;30;159;2.0
15;26;808;848;40;159;2.0
15;27;848;850;2;159;2.0
15;28;850;863;13;159;2.0
15;29;863;878;15;159;2.0
15;30;878;893;15;159;2.0
15;31;893;895;2;159;2.0
15;32;895;903;8;159;2.0
15;33;903;923;20;159;2.0
15;34;923;928;5;159;2.0
15;35;928;958;30;159;2.0
15;36;958;983;25;159;2.0
15;37;983;988;5;159;2.0
15;38;988;994;6;159;2.0
15;39;994;1018;24;159;2.0
15;40;1018;1043;25;159;2.0
15;41;1043;1048;5;159;2.0
15;42;1048;1078;30;159;2.0
15;43;1078;1114;36;159;2.0
15;44;1114;1138;24;159;2.0
15;45;1138;1334;196;159;2.0
15;46;1334;1358;24;159;2.0
15;47;1358;1373;15;159;2.0
15;48;1373;1388;15;159;2.0
15;49;1388;1403;15;159;2.0
15;50;1403;1418;15;159;2.0
15;51;1418;1433;15;159;2.0
15;52;1433;1448;15;159;2.0
15;53;1448;1463;15;159;2.0
15;54;1463;1478;15;159;2.0
15;55;1478;1493;15;159;2.0
15;56;1493;1508;15;159;2.0
15;57;1508;1523;15;159;2.0
15;58;1523;1538;15;159;2.0
15;59;1538;1553;15;159;2.0
15;60;1553;1568;15;159;2.0
15;61;1568;1583;15;159;2.0
15;62;1583;1598;15;159;2.0
15;63;1598;1613;15;159;2.0
15;64;1613;1628;15;159;2.0
15;65;1628;1643;15;159;2.0
15;66;1643;1658;15;159;2.0
15;67;1658;1680;22;159;2.0
16;0;247;342;95;14;2.0
16;1;342;357;15;14;2.0
16;2;357;362;5;14;2.0
16;3;362;364;2;14;2.0
16;4;364;374;10;14;2.0
16;5;374;394;20;14;2.0
16;6;394;397;3;14;2.0
16;7;397;412;15;14;2.0
16;8;412;424;12;14;2.0
16;9;424;429;5;14;2.0
16;10;429;434;5;14;2.0
16;11;434;454;20;14;2.0
16;12;454;457;3;14;2.0
16;13;457;466;9;14;2.0
16;14;466;472;6;14;2.0
16;15;472;487;15;14;2.0
16;16;487;489;2;14;2.0
16;17;489;505;16;14;2.0
16;18;505;554;49;14;2.0
16;19;554;596;42;14;2.0
16;20;596;634;38;14;2.0
16;21;634;666;32;14;2.0
16;22;666;685;19;14;2.0
16;23;685;731;46;14;2.0
16;24;731;767;36;14;2.0
16;25;767;801;34;14;2.0
16;26;801;837;36;14;2.0
16;27;837;843;6;14;2.0
16;28;843;856;13;14;2.0
16;29;856;871;15;14;2.0
16;30;871;884;13;14;2.0
16;31;884;886;2;14;2.0
16;32;886;892;6;14;2.0
16;33;892;916;24;14;2.0
16;34;916;917;1;14;2.0
16;35;917;947;30;14;2.0
16;36;947;951;4;14;2.0
16;37;951;976;25;14;2.0
16;38;976;977;1;14;2.0
16;39;977;984;7;14;2.0
16;40;984;1007;23;14;2.0
16;41;1007;1036;29;14;2.0
16;42;1036;1037;1;14;2.0
16;43;1037;1067;30;14;2.0
16;44;1067;1071;4;14;2.0
16;45;1071;1104;33;14;2.0
16;46;1104;1127;23;14;2.0
16;47;1127;1327;200;14;2.0
16;48;1327;1348;21;14;2.0
16;49;1348;1363;15;14;2.0
16;50;1363;1378;15;14;2.0
16;51;1378;1393;15;14;2.0
16;52;1393;1408;15;14;2.0
16;53;1408;1423;15;14;2.0
16;54;1423;1438;15;14;2.0
16;55;1438;1453;15;14;2.0
16;56;1453;1468;15;14;2.0
16;57;1468;1483;15;14;2.0
16;58;1483;1498;15;14;2.0
16;59;1498;1513;15;14;2.0
16;60;1513;1528;15;14;2.0
16;61;1528;1543;15;14;2.0
16;62;1543;1558;15;14;2.0
16;63;1558;1573;15;14;2.0
16;64;1573;1588;15;14;2.0
16;65;1588;1603;15;14;2.0
16;66;1603;1618;15;14;2.0
16;67;1618;1633;15;14;2.0
16;68;1633;1648;15;14;2.0
16;69;1648;1663;15;14;2.0
16;70;1663;1680;17;14;2.0
17;0;252;345;93;99;2.0
17;1;345;360;15;99;2.0
17;2;360;365;5;99;2.0
17;3;365;369;4;99;2.0
17;4;369;379;10;99;2.0
17;5;379;399;20;99;2.0
17;6;399;400;1;99;2.0
17;7;400;415;15;99;2.0
17;8;415;429;14;99;2.0
17;9;429;432;3;99;2.0
17;10;432;439;7;99;2.0
17;11;439;459;20;99;2.0
17;12;459;460;1;99;2.0
17;13;460;471;11;99;2.0
17;14;471;475;4;99;2.0
17;15;475;490;15;99;2.0
17;16;490;494;4;99;2.0
17;17;494;508;14;99;2.0
17;18;508;559;51;99;2.0
17;19;559;599;40;99;2.0
17;20;599;639;40;99;2.0
17;21;639;669;30;99;2.0
17;22;669;688;19;99;2.0
17;23;688;734;46;99;2.0
17;24;734;772;38;99;2.0
17;25;772;804;32;99;2.0
17;26;804;842;38;99;2.0
17;27;842;846;4;99;2.0
17;28;846;859;13;99;2.0
17;29;859;874;15;99;2.0
17;30;874;889;15;99;2.0
17;31;889;897;8;99;2.0
17;32;897;919;22;99;2.0
17;33;919;922;3;99;2.0
17;34;922;952;30;99;2.0
17;35;952;954;2;99;2.0
17;36;954;979;25;99;2.0
17;37;979;982;3;99;2.0
17;38;982;987;5;99;2.0
17;39;987;1012;25;99;2.0
17;40;1012;1039;27;99;2.0
17;41;1039;1042;3;99;2.0
17;42;1042;1072;30;99;2.0
17;43;1072;1074;2;99;2.0
17;44;1074;1107;33;99;2.0
17;45;1107;1132;25;99;2.0
17;46;1132;1330;198;99;2.0
17;47;1330;1351;21;99;2.0
17;48;1351;1366;15;99;2.0
17;49;1366;1381;15;99;2.0
17;50;1381;1396;15;99;2.0
17;51;1396;1411;15;99;2.0
17;52;1411;1426;15;99;2.0
17;53;1426;1441;15;99;2.0
17;54;1441;1456;15;99;2.0
17;55;1456;1471;15;99;2.0
17;56;1471;1486;15;99;2.0
17;57;1486;1501;15;99;2.0
17;58;1501;1516;15;99;2.0
17;59;1516;1531;15;99;2.0
17;60;1531;1546;15;99;2.0
17;61;1546;1561;15;99;2.0
17;62;1561;1576;15;99;2.0
17;63;1576;1591;15;99;2.0
17;64;1591;1606;15;99;2.0
17;65;1606;1621;15;99;2.0
17;66;1621;1636;15;99;2.0
17;67;1636;1651;15;99;2.0
17;68;1651;1666;15;99;2.0
17;69;1666;1680;14;99;2.0
18;0;246;339;93;501;2.0
18;1;339;354;15;501;2.0
18;2;354;357;3;501;2.0
18;3;357;359;2;501;2.0
18;4;359;367;8;501;2.0
18;5;367;387;20;501;2.0
18;6;387;394;7;501;2.0
18;7;394;409;15;501;2.0
18;8;409;417;8;501;2.0
18;9;417;426;9;501;2.0
18;10;426;427;1;501;2.0
18;11;427;447;20;501;2.0
18;12;447;454;7;501;2.0
18;13;454;459;5;501;2.0
18;14;459;469;10;501;2.0
18;15;469;482;13;501;2.0
18;16;482;484;2;501;2.0
18;17;484;505;21;501;2.0
18;18;505;547;42;501;2.0
18;19;547;593;46;501;2.0
18;20;593;627;34;501;2.0
18;21;627;663;36;501;2.0
18;22;663;685;22;501;2.0
18;23;685;728;43;501;2.0
18;24;728;760;32;501;2.0
18;25;760;798;38;501;2.0
18;26;798;830;32;501;2.0
18;27;830;840;10;501;2.0
18;28;840;853;13;501;2.0
18;29;853;868;15;501;2.0
18;30;868;877;9;501;2.0
18;31;877;883;6;501;2.0
18;32;883;885;2;501;2.0
18;33;885;910;25;501;2.0
18;34;910;913;3;501;2.0
18;35;913;940;27;501;2.0
18;36;940;948;8;501;2.0
18;37;948;970;22;501;2.0
18;38;970;973;3;501;2.0
18;39;973;984;11;501;2.0
18;40;984;1000;16;501;2.0
18;41;1000;1030;30;501;2.0
18;42;1030;1033;3;501;2.0
18;43;1033;1060;27;501;2.0
18;44;1060;1068;8;501;2.0
18;45;1068;1104;36;501;2.0
18;46;1104;1120;16;501;2.0
18;47;1120;1324;204;501;2.0
18;48;1324;1348;24;501;2.0
18;49;1348;1363;15;501;2.0
18;50;1363;1378;15;501;2.0
18;51;1378;1393;15;501;2.0
18;52;1393;1408;15;501;2.0
18;53;1408;1423;15;501;2.0
18;54;1423;1438;15;501;2.0
18;55;1438;1453;15;501;2.0
18;56;1453;1468;15;501;2.0
18;57;1468;1483;15;501;2.0
18;58;1483;1498;15;501;2.0
18;59;1498;1513;15;501;2.0
18;60;1513;1528;15;501;2.0
18;61;1528;1543;15;501;2.0
18;62;1543;1558;15;501;2.0
18;63;1558;1573;15;501;2.0
18;64;1573;1588;15;501;2.0
18;65;1588;1603;15;501;2.0
18;66;1603;1618;15;501;2.0
18;67;1618;1633;15;501;2.0
18;68;1633;1648;15;501;2.0
18;69;1648;1663;15;501;2.0
18;70;1663;1680;17;501;2.0
19;0;250;347;97;66;2.0
19;1;347;362;15;66;2.0
19;2;362;367;5;66;2.0
19;3;367;372;5;66;2.0
19;4;372;392;20;66;2.0
19;5;392;402;10;66;2.0
19;6;402;417;15;66;2.0
19;7;417;422;5;66;2.0
19;8;422;432;10;66;2.0
19;9;432;434;2;66;2.0
19;10;434;452;18;66;2.0
19;11;452;462;10;66;2.0
19;12;462;464;2;66;2.0
19;13;464;477;13;66;2.0
19;14;477;487;10;66;2.0
19;15;487;492;5;66;2.0
19;16;492;511;19;66;2.0
19;17;511;552;41;66;2.0
19;18;552;601;49;66;2.0
19;19;601;632;31;66;2.0
19;20;632;671;39;66;2.0
19;21;671;691;20;66;2.0
19;22;691;736;45;66;2.0
19;23;736;765;29;66;2.0
19;24;765;806;41;66;2.0
19;25;806;835;29;66;2.0
19;26;835;848;13;66;2.0
19;27;848;861;13;66;2.0
19;28;861;876;15;66;2.0
19;29;876;882;6;66;2.0
19;30;882;890;8;66;2.0
19;31;890;891;1;66;2.0
19;32;891;915;24;66;2.0
19;33;915;921;6;66;2.0
19;34;921;945;24;66;2.0
19;35;945;956;11;66;2.0
19;36;956;975;19;66;2.0
19;37;975;981;6;66;2.0
19;38;981;990;9;66;2.0
19;39;990;1005;15;66;2.0
19;40;1005;1035;30;66;2.0
19;41;1035;1041;6;66;2.0
19;42;1041;1065;24;66;2.0
19;43;1065;1076;11;66;2.0
19;44;1076;1110;34;66;2.0
19;45;1110;1125;15;66;2.0
19;46;1125;1332;207;66;2.0
19;47;1332;1354;22;66;2.0
19;48;1354;1369;15;66;2.0
19;49;1369;1384;15;66;2.0
19;50;1384;1399;15;66;2.0
19;51;1399;1414;15;66;2.0
19;52;1414;1429;15;66;2.0
19;53;1429;1444;15;66;2.0
19;54;1444;1459;15;66;2.0
19;55;1459;1474;15;66;2.0
19;56;1474;1489;15;66;2.0
19;57;1489;1504;15;66;2.0
19;58;1504;1519;15;66;2.0
19;59;1519;1534;15;66;2.0
19;60;1534;1549;15;66;2.0
19;61;1549;1564;15;66;2.0
19;62;1564;1579;15;66;2.0
19;63;1579;1594;15;66;2.0
19;64;1594;1609;15;66;2.0
19;65;1609;1624;15;66;2.0
19;66;1624;1639;15;66;2.0
19;67;1639;1654;15;66;2.0
19;68;1654;1669;15;66;2.0
19;69;1669;1680;11;66;2.0
20;0;252;349;97;63;2.0
20;1;349;364;15;63;2.0
20;2;364;369;5;63;2.0
20;3;369;374;5;63;2.0
20;4;374;394;20;63;2.0
20;5;394;404;10;63;2.0
20;6;404;419;15;63;2.0
20;7;419;424;5;63;2.0
20;8;424;434;10;63;2.0
20;9;434;436;2;63;2.0
20;10;436;454;18;63;2.0
20;11;454;464;10;63;2.0
20;12;464;466;2;63;2.0
20;13;466;479;13;63;2.0
20;14;479;489;10;63;2.0
20;15;489;494;5;63;2.0
20;16;494;513;19;63;2.0
20;17;513;554;41;63;2.0
20;18;554;603;49;63;2.0
20;19;603;634;31;63;2.0
20;20;634;673;39;63;2.0
20;21;673;693;20;63;2.0
20;22;693;738;45;63;2.0
20;23;738;767;29;63;2.0
20;24;767;808;41;63;2.0
20;25;808;837;29;63;2.0
20;26;837;850;13;63;2.0
20;27;850;863;13;63;2.0
20;28;863;878;15;63;2.0
20;29;878;884;6;63;2.0
20;30;884;892;8;63;2.0
20;31;892;893;1;63;2.0
20;32;893;917;24;63;2.0
20;33;917;923;6;63;2.0
20;34;923;947;24;63;2.0
20;35;947;958;11;63;2.0
20;36;958;977;19;63;2.0
20;37;977;983;6;63;2.0
20;38;983;992;9;63;2.0
20;39;992;1007;15;63;2.0
20;40;1007;1037;30;63;2.0
20;41;1037;1043;6;63;2.0
20;42;1043;1067;24;63;2.0
20;43;1067;1078;11;63;2.0
20;44;1078;1112;34;63;2.0
20;45;1112;1127;15;63;2.0
20;46;1127;1334;207;63;2.0
20;47;1334;1356;22;63;2.0
20;48;1356;1371;15;63;2.0
20;49;1371;1386;15;63;2.0
20;50;1386;1401;15;63;2.0
20;51;1401;1416;15;63;2.0
20;52;1416;1431;15;63;2.0
20;53;1431;1446;15;63;2.0
20;54;1446;1461;15;63;2.0
20;55;1461;1476;15;63;2.0
20;56;1476;1491;15;63;2.0
20;57;1491;1506;15;63;2.0
20;58;1506;1521;15;63;2.0
20;59;1521;1536;15;63;2.0
20;60;1536;1551;15;63;2.0
20;61;1551;1566;15;63;2.0
20;62;1566;1581;15;63;2.0
20;63;1581;1596;15;63;2.0
20;64;1596;1611;15;63;2.0
20;65;1611;1626;15;63;2.0
20;66;1626;1641;15;63;2.0
20;67;1641;1656;15;63;2.0
20;68;1656;1680;24;63;2.0
21;0;249;338;89;114;2.0
21;1;338;353;15;114;2.0
21;2;353;358;5;114;2.0
21;3;358;364;6;114;2.0
21;4;364;374;10;114;2.0
21;5;374;393;19;114;2.0
21;6;393;394;1;114;2.0
21;7;394;408;14;114;2.0
21;8;408;424;16;114;2.0
21;9;424;425;1;114;2.0
21;10;425;434;9;114;2.0
21;11;434;453;19;114;2.0
21;12;453;454;1;114;2.0
21;13;454;466;12;114;2.0
21;14;466;468;2;114;2.0
21;15;468;483;15;114;2.0
21;16;483;489;6;114;2.0
21;17;489;506;17;114;2.0
21;18;506;554;48;114;2.0
21;19;554;592;38;114;2.0
21;20;592;634;42;114;2.0
21;21;634;662;28;114;2.0
21;22;662;686;24;114;2.0
21;23;686;727;41;114;2.0
21;24;727;767;40;114;2.0
21;25;767;797;30;114;2.0
21;26;797;837;40;114;2.0
21;27;837;839;2;114;2.0
21;28;839;852;13;114;2.0
21;29;852;867;15;114;2.0
21;30;867;882;15;114;2.0
21;31;882;884;2;114;2.0
21;32;884;892;8;114;2.0
21;33;892;912;20;114;2.0
21;34;912;917;5;114;2.0
21;35;917;947;30;114;2.0
21;36;947;972;25;114;2.0
21;37;972;977;5;114;2.0
21;38;977;985;8;114;2.0
21;39;985;1007;22;114;2.0
21;40;1007;1032;25;114;2.0
21;41;1032;1037;5;114;2.0
21;42;1037;1067;30;114;2.0
21;43;1067;1105;38;114;2.0
21;44;1105;1127;22;114;2.0
21;45;1127;1323;196;114;2.0
21;46;1323;1349;26;114;2.0
21;47;1349;1364;15;114;2.0
21;48;1364;1379;15;114;2.0
21;49;1379;1394;15;114;2.0
21;50;1394;1409;15;114;2.0
21;51;1409;1424;15;114;2.0
21;52;1424;1439;15;114;2.0
21;53;1439;1454;15;114;2.0
21;54;1454;1469;15;114;2.0
21;55;1469;1484;15;114;2.0
21;56;1484;1499;15;114;2.0
21;57;1499;1514;15;114;2.0
21;58;1514;1529;15;114;2.0
21;59;1529;1544;15;114;2.0
21;60;1544;1559;15;114;2.0
21;61;1559;1574;15;114;2.0
21;62;1574;1589;15;114;2.0
21;63;1589;1604;15;114;2.0
21;64;1604;1619;15;114;2.0
21;65;1619;1634;15;114;2.0
21;66;1634;1649;15;114;2.0
21;67;1649;1664;15;114;2.0
21;68;1664;1680;16;114;2.0
22;0;243;339;96;42;2.0
22;1;339;354;15;42;2.0
22;2;354;359;5;42;2.0
22;3;359;361;2;42;2.0
22;4;361;371;10;42;2.0
22;5;371;391;20;42;2.0
22;6;391;394;3;42;2.0
22;7;394;409;15;42;2.0
22;8;409;421;12;42;2.0
22;9;421;426;5;42;2.0
22;10;426;431;5;42;2.0
22;11;431;451;20;42;2.0
22;12;451;454;3;42;2.0
22;13;454;463;9;42;2.0
22;14;463;469;6;42;2.0
22;15;469;484;15;42;2.0
22;16;484;486;2;42;2.0
22;17;486;500;14;42;2.0
22;18;500;551;51;42;2.0
22;19;551;593;42;42;2.0
22;20;593;631;38;42;2.0
22;21;631;663;32;42;2.0
22;22;663;680;17;42;2.0
22;23;680;728;48;42;2.0
22;24;728;764;36;42;2.0
22;25;764;798;34;42;2.0
22;26;798;834;36;42;2.0
22;27;834;840;6;42;2.0
22;28;840;853;13;42;2.0
22;29;853;868;15;42;2.0
22;30;868;881;13;42;2.0
22;31;881;883;2;42;2.0
22;32;883;889;6;42;2.0
22;33;889;913;24;42;2.0
22;34;913;914;1;42;2.0
22;35;914;944;30;42;2.0
22;36;944;948;4;42;2.0
22;37;948;973;25;42;2.0
22;38;973;974;1;42;2.0
22;39;974;979;5;42;2.0
22;40;979;1004;25;42;2.0
22;41;1004;1033;29;42;2.0
22;42;1033;1034;1;42;2.0
22;43;1034;1064;30;42;2.0
22;44;1064;1068;4;42;2.0
22;45;1068;1099;31;42;2.0
22;46;1099;1124;25;42;2.0
22;47;1124;1324;200;42;2.0
22;48;1324;1343;19;42;2.0
22;49;1343;1358;15;42;2.0
22;50;1358;1373;15;42;2.0
22;51;1373;1388;15;42;2.0
22;52;1388;1403;15;42;2.0
22;53;1403;1418;15;42;2.0
22;54;1418;1433;15;42;2.0
22;55;1433;1448;15;42;2.0
22;56;1448;1463;15;42;2.0
22;57;1463;1478;15;42;2.0
22;58;1478;1493;15;42;2.0
22;59;1493;1508;15;42;2.0
22;60;1508;1523;15;42;2.0
22;61;1523;1538;15;42;2.0
22;62;1538;1553;15;42;2.0
22;63;1553;1568;15;42;2.0
22;64;1568;1583;15;42;2.0
22;65;1583;1598;15;42;2.0
22;66;1598;1613;15;42;2.0
22;67;1613;1628;15;42;2.0
22;68;1628;1643;15;42;2.0
22;69;1643;1658;15;42;2.0
22;70;1658;1673;15;42;2.0
22;71;1673;1680;7;42;2.0
23;0;245;338;93;25;2.0
23;1;338;353;15;25;2.0
23;2;353;358;5;25;2.0
23;3;358;361;3;25;2.0
23;4;361;371;10;25;2.0
23;5;371;391;20;25;2.0
23;6;391;393;2;25;2.0
23;7;393;408;15;25;2.0
23;8;408;421;13;25;2.0
23;9;421;425;4;25;2.0
23;10;425;431;6;25;2.0
23;11;431;451;20;25;2.0
23;12;451;453;2;25;2.0
23;13;453;463;10;25;2.0
23;14;463;468;5;25;2.0
23;15;468;483;15;25;2.0
23;16;483;486;3;25;2.0
23;17;486;501;15;25;2.0
23;18;501;551;50;25;2.0
23;19;551;592;41;25;2.0
23;20;592;631;39;25;2.0
23;21;631;662;31;25;2.0
23;22;662;681;19;25;2.0
23;23;681;727;46;25;2.0
23;24;727;764;37;25;2.0
23;25;764;797;33;25;2.0
23;26;797;834;37;25;2.0
23;27;834;839;5;25;2.0
23;28;839;852;13;25;2.0
23;29;852;867;15;25;2.0
23;30;867;881;14;25;2.0
23;31;881;882;1;25;2.0
23;32;882;889;7;25;2.0
23;33;889;912;23;25;2.0
23;34;912;914;2;25;2.0
23;35;914;944;30;25;2.0
23;36;944;947;3;25;2.0
23;37;947;972;25;25;2.0
23;38;972;974;2;25;2.0
23;39;974;980;6;25;2.0
23;40;980;1004;24;25;2.0
23;41;1004;1032;28;25;2.0
23;42;1032;1034;2;25;2.0
23;43;1034;1064;30;25;2.0
23;44;1064;1067;3;25;2.0
23;45;1067;1100;33;25;2.0
23;46;1100;1124;24;25;2.0
23;47;1124;1323;199;25;2.0
23;48;1323;1344;21;25;2.0
23;49;1344;1359;15;25;2.0
23;50;1359;1374;15;25;2.0
23;51;1374;1389;15;25;2.0
23;52;1389;1404;15;25;2.0
23;53;1404;1419;15;25;2.0
23;54;1419;1434;15;25;2.0
23;55;1434;1449;15;25;2.0
23;56;1449;1464;15;25;2.0
23;57;1464;1479;15;25;2.0
23;58;1479;1494;15;25;2.0
23;59;1494;1509;15;25;2.0
23;60;1509;1524;15;25;2.0
23;61;1524;1539;15;25;2.0
23;62;1539;1554;15;25;2.0
23;63;1554;1569;15;25;2.0
23;64;1569;1584;15;25;2.0
23;65;1584;1599;15;25;2.0
23;66;1599;1614;15;25;2.0
23;67;1614;1629;15;25;2.0
23;68;1629;1644;15;25;2.0
23;69;1644;1659;15;25;2.0
23;70;1659;1674;15;25;2.0
23;71;1674;1680;6;25;2.0
24;0;240;339;99;0;0.83
24;1;339;354;15;0;0.83
24;2;354;359;5;0;0.83
24;3;359;369;10;0;0.83
24;4;369;389;20;0;0.83
24;5;389;394;5;0;0.83
24;6;394;409;15;0;0.83
24;7;409;419;10;0;0.83
24;8;419;426;7;0;0.83
24;9;426;429;3;0;0.83
24;10;429;449;20;0;0.83
24;11;449;454;5;0;0.83
24;12;454;461;7;0;0.83
24;13;461;469;8;0;0.83
24;14;469;484;15;0;0.83
24;15;484;503;19;0;0.83
24;16;503;549;46;0;0.83
24;17;549;593;44;0;0.83
24;18;593;629;36;0;0.83
24;19;629;663;34;0;0.83
24;20;663;683;20;0;0.83
24;21;683;728;45;0;0.83
24;22;728;762;34;0;0.83
24;23;762;798;36;0;0.83
24;24;798;832;34;0;0.83
24;25;832;840;8;0;0.83
24;26;840;853;13;0;0.83
24;27;853;868;15;0;0.83
24;28;868;879;11;0;0.83
24;29;879;883;4;0;0.83
24;30;883;887;4;0;0.83
24;31;887;912;25;0;0.83
24;32;912;913;1;0;0.83
24;33;913;942;29;0;0.83
24;34;942;948;6;0;0.83
24;35;948;972;24;0;0.83
24;36;972;973;1;0;0.83
24;37;973;982;9;0;0.83
24;38;982;1002;20;0;0.83
24;39;1002;1032;30;0;0.83
24;40;1032;1033;1;0;0.83
24;41;1033;1062;29;0;0.83
24;42;1062;1068;6;0;0.83
24;43;1068;1102;34;0;0.83
24;44;1102;1122;20;0;0.83
24;45;1122;1324;202;0;0.83
24;46;1324;1346;22;0;0.83
24;47;1346;1361;15;0;0.83
24;48;1361;1376;15;0;0.83
24;49;1376;1391;15;0;0.83
24;50;1391;1406;15;0;0.83
24;51;1406;1421;15;0;0.83
24;52;1421;1436;15;0;0.83
24;53;1436;1451;15;0;0.83
24;54;1451;1466;15;0;0.83
24;55;1466;1481;15;0;0.83
24;56;1481;1496;15;0;0.83
24;57;1496;1511;15;0;0.83
24;58;1511;1526;15;0;0.83
24;59;1526;1541;15;0;0.83
24;60;1541;1556;15;0;0.83
24;61;1556;1571;15;0;0.83
24;62;1571;1586;15;0;0.83
24;63;1586;1601;15;0;0.83
24;64;1601;1616;15;0;0.83
24;65;1616;1631;15;0;0.83
24;66;1631;1646;15;0;0.83
24;67;1646;1661;15;0;0.83
24;68;1661;1676;15;0;0.83
24;69;1676;1680;4;0;0.83
25;0;240;339;99;0;0.83
25;1;339;354;15;0;0.83
25;2;354;359;5;0;0.83
25;3;359;369;10;0;0.83
25;4;369;389;20;0;0.83
25;5;389;394;5;0;0.83
25;6;394;409;15;0;0.83
25;7;409;419;10;0;0.83
25;8;419;426;7;0;0.83
25;9;426;429;3;0;0.83
25;10;429;449;20;0;0.83
25;11;449;454;5;0;0.83
25;12;454;461;7;0;0.83
25;13;461;469;8;0;0.83
25;14;469;484;15;0;0.83
25;15;484;503;19;0;0.83
25;16;503;549;46;0;0.83
25;17;549;593;44;0;0.83
25;18;593;629;36;0;0.83
25;19;629;663;34;0;0.83
25;20;663;683;20;0;0.83
25;21;683;728;45;0;0.83
25;22;728;762;34;0;0.83
25;23;762;798;36;0;0.83
25;24;798;832;34;0;0.83
25;25;832;840;8;0;0.83
25;26;840;853;13;0;0.83
25;27;853;868;15;0;0.83
25;28;868;879;11;0;0.83
25;29;879;883;4;0;0.83
25;30;883;887;4;0;0.83
25;31;887;912;25;0;0.83
25;32;912;913;1;0;0.83
25;33;913;942;29;0;0.83
25;34;942;948;6;0;0.83
25;35;948;972;24;0;0.83
25;36;972;973;1;0;0.83
25;37;973;982;9;0;0.83
25;38;982;1002;20;0;0.83
25;39;1002;1032;30;0;0.83
25;40;1032;1033;1;0;0.83
25;41;1033;1062;29;0;0.83
25;42;1062;1068;6;0;0.83
25;43;1068;1102;34;0;0.83
25;44;1102;1122;20;0;0.83
25;45;1122;1324;202;0;0.83
25;46;1324;1346;22;0;0.83
25;47;1346;1361;15;0;0.83
25;48;1361;1376;15;0;0.83
25;49;1376;1391;15;0;0.83
25;50;1391;1406;15;0;0.83
25;51;1406;1421;15;0;0.83
25;52;1421;1436;15;0;0.83
25;53;1436;1451;15;0;0.83
25;54;1451;1466;15;0;0.83
25;55;1466;1481;15;0;0.83
25;56;1481;1496;15;0;0.83
25;57;1496;1511;15;0;0.83
25;58;1511;1526;15;0;0.83
25;59;1526;1541;15;0;0.83
25;60;1541;1556;15;0;0.83
25;61;1556;1571;15;0;0.83
25;62;1571;1586;15;0;0.83
25;63;1586;1601;15;0;0.83
25;64;1601;1616;15;0;0.83
25;65;1616;1631;15;0;0.83
25;66;1631;1646;15;0;0.83
25;67;1646;1661;15;0;0.83
25;68;1661;1676;15;0;0.83
25;69;1676;1680;4;0;0.83
26;0;240;339;99;0;0.83
26;1;339;354;15;0;0.83
26;2;354;359;5;0;0.83
26;3;359;369;10;0;0.83
26;4;369;389;20;0;0.83
26;5;389;394;5;0;0.83
26;6;394;409;15;0;0.83
26;7;409;419;10;0;0.83
26;8;419;426;7;0;0.83
26;9;426;429;3;0;0.83
26;10;429;449;20;0;0.83
26;11;449;454;5;0;0.83
26;12;454;461;7;0;0.83
26;13;461;469;8;0;0.83
26;14;469;484;15;0;0.83
26;15;484;503;19;0;0.83
26;16;503;549;46;0;0.83
26;17;549;593;44;0;0.83
26;18;593;629;36;0;0.83
26;19;629;663;34;0;0.83
26;20;663;683;20;0;0.83
26;21;683;728;45;0;0.83
26;22;728;762;34;0;0.83
26;23;762;798;36;0;0.83
26;24;798;832;34;0;0.83
26;25;832;840;8;0;0.83
26;26;840;853;13;0;0.83
26;27;853;868;15;0;0.83
26;28;868;879;11;0;0.83
26;29;879;883;4;0;0.83
26;30;883;887;4;0;0.83
26;31;887;912;25;0;0.83
26;32;912;913;1;0;0.83
26;33;913;942;29;0;0.83
26;34;942;948;6;0;0.83
26;35;948;972;24;0;0.83
26;36;972;973;1;0;0.83
26;37;973;982;9;0;0.83
26;38;982;1002;20;0;0.83
26;39;1002;1032;30;0;0.83
26;40;1032;1033;1;0;0.83
26;41;1033;1062;29;0;0.83
26;42;1062;1068;6;0;0.83
26;43;1068;1102;34;0;0.83
26;44;1102;1122;20;0;0.83
26;45;1122;1324;202;0;0.83
26;46;1324;1346;22;0;0.83
26;47;1346;1361;15;0;0.83
26;48;1361;1376;15;0;0.83
26;49;1376;1391;15;0;0.83
26;50;1391;1406;15;0;0.83
26;51;1406;1421;15;0;0.83
26;52;1421;1436;15;0;0.83
26;53;1436;1451;15;0;0.83
26;54;1451;1466;15;0;0.83
26;55;1466;1481;15;0;0.83
26;56;1481;1496;15;0;0.83
26;57;1496;1511;15;0;0.83
26;58;1511;1526;15;0;0.83
26;59;1526;1541;15;0;0.83
26;60;1541;1556;15;0;0.83
26;61;1556;1571;15;0;0.83
26;62;1571;1586;15;0;0.83
26;63;1586;1601;15;0;0.83
26;64;1601;1616;15;0;0.83
26;65;1616;1631;15;0;0.83
26;66;1631;1646;15;0;0.83
26;67;1646;1661;15;0;0.83
26;68;1661;1676;15;0;0.83
26;69;1676;1680;4;0;0.83
27;0;240;339;99;0;0.83
27;1;339;354;15;0;0.83
27;2;354;359;5;0;0.83
27;3;359;369;10;0;0.83
27;4;369;389;20;0;0.83
27;5;389;394;5;0;0.83
27;6;394;409;15;0;0.83
27;7;409;419;10;0;0.83
27;8;419;426;7;0;0.83
27;9;426;429;3;0;0.83
27;10;429;449;20;0;0.83
27;11;449;454;5;0;0.83
27;12;454;461;7;0;0.83
27;13;461;469;8;0;0.83
27;14;469;484;15;0;0.83
27;15;484;503;19;0;0.83
27;16;503;549;46;0;0.83
27;17;549;593;44;0;0.83
27;18;593;629;36;0;0.83
27;19;629;663;34;0;0.83
27;20;663;683;20;0;0.83
27;21;683;728;45;0;0.83
27;22;728;762;34;0;0.83
27;23;762;798;36;0;0.83
27;24;798;832;34;0;0.83
27;25;832;840;8;0;0.83
27;26;840;853;13;0;0.83
27;27;853;868;15;0;0.83
27;28;868;879;11;0;0.83
27;29;879;883;4;0;0.83
27;30;883;887;4;0;0.83
27;31;887;912;25;0;0.83
27;32;912;913;1;0;0.83
27;33;913;942;29;0;0.83
27;34;942;948;6;0;0.83
27;35;948;972;24;0;0.83
27;36;972;973;1;0;0.83
27;37;973;982;9;0;0.83
27;38;982;1002;20;0;0.83
27;39;1002;1032;30;0;0.83
27;40;1032;1033;1;0;0.83
27;41;1033;1062;29;0;0.83
27;42;1062;1068;6;0;0.83
27;43;1068;1102;34;0;0.83
27;44;1102;1122;20;0;0.83
27;45;1122;1324;202;0;0.83
27;46;1324;1346;22;0;0.83
27;47;1346;1361;15;0;0.83
27;48;1361;1376;15;0;0.83
27;49;1376;1391;15;0;0.83
27;50;1391;1406;15;0;0.83
27;51;1406;1421;15;0;0.83
27;52;1421;1436;15;0;0.83
27;53;1436;1451;15;0;0.83
27;54;1451;1466;15;0;0.83
27;55;1466;1481;15;0;0.83
27;56;1481;1496;15;0;0.83
27;57;1496;1511;15;0;0.83
27;58;1511;1526;15;0;0.83
27;59;1526;1541;15;0;0.83
27;60;1541;1556;15;0;0.83
27;61;1556;1571;15;0;0.83
27;62;1571;1586;15;0;0.83
27;63;1586;1601;15;0;0.83
27;64;1601;1616;15;0;0.83
27;65;1616;1631;15;0;0.83
27;66;1631;1646;15;0;0.83
27;67;1646;1661;15;0;0.83
27;68;1661;1676;15;0;0.83
27;69;1676;1680;4;0;0.83
28;0;240;339;99;0;0.83
28;1;339;354;15;0;0.83
28;2;354;359;5;0;0.83
28;3;359;369;10;0;0.83
28;4;369;389;20;0;0.83
28;5;389;394;5;0;0.83
28;6;394;409;15;0;0.83
28;7;409;419;10;0;0.83
28;8;419;426;7;0;0.83
28;9;426;429;3;0;0.83
28;10;429;449;20;0;0.83
28;11;449;454;5;0;0.83
28;12;454;461;7;0;0.83
28;13;461;469;8;0;0.83
28;14;469;484;15;0;0.83
28;15;484;503;19;0;0.83
28;16;503;549;46;0;0.83
28;17;549;593;44;0;0.83
28;18;593;629;36;0;0.83
28;19;629;663;34;0;0.83
28;20;663;683;20;0;0.83
28;21;683;728;45;0;0.83
28;22;728;762;34;0;0.83
28;23;762;798;36;0;0.83
28;24;798;832;34;0;0.83
28;25;832;840;8;0;0.83
28;26;840;853;13;0;0.83
28;27;853;868;15;0;0.83
28;28;868;879;11;0;0.83
28;29;879;883;4;0;0.83
28;30;883;887;4;0;0.83
28;31;887;912;25;0;0.83
28;32;912;913;1;0;0.83
28;33;913;942;29;0;0.83
28;34;942;948;6;0;0.83
28;35;948;972;24;0;0.83
28;36;972;973;1;0;0.83
28;37;973;982;9;0;0.83
28;38;982;1002;20;0;0.83
28;39;1002;1032;30;0;0.83
28;40;1032;1033;1;0;0.83
28;41;1033;1062;29;0;0.83
28;42;1062;1068;6;0;0.83
28;43;1068;1102;34;0;0.83
28;44;1102;1122;20;0;0.83
28;45;1122;1324;202;0;0.83
28;46;1324;1346;22;0;0.83
28;47;1346;1361;15;0;0.83
28;48;1361;1376;15;0;0.83
28;49;1376;1391;15;0;0.83
28;50;1391;1406;15;0;0.83
28;51;1406;1421;15;0;0.83
28;52;1421;1436;15;0;0.83
28;53;1436;1451;15;0;0.83
28;54;1451;1466;15;0;0.83
28;55;1466;1481;15;0;0.83
28;56;1481;1496;15;0;0.83
28;57;1496;1511;15;0;0.83
28;58;1511;1526;15;0;0.83
28;59;1526;1541;15;0;0.83
28;60;1541;1556;15;0;0.83
28;61;1556;1571;15;0;0.83
28;62;1571;1586;15;0;0.83
28;63;1586;1601;15;0;0.83
28;64;1601;1616;15;0;0.83
28;65;1616;1631;15;0;0.83
28;66;1631;1646;15;0;0.83
28;67;1646;1661;15;0;0.83
28;68;1661;1676;15;0;0.83
28;69;1676;1680;4;0;0.83
29;0;240;339;99;0;2.0
29;1;339;354;15;0;2.0
29;2;354;359;5;0;2.0
29;3;359;369;10;0;2.0
29;4;369;389;20;0;2.0
29;5;389;394;5;0;2.0
29;6;394;409;15;0;2.0
29;7;409;419;10;0;2.0
29;8;419;426;7;0;2.0
29;9;426;429;3;0;2.0
29;10;429;449;20;0;2.0
29;11;449;454;5;0;2.0
29;12;454;461;7;0;2.0
29;13;461;469;8;0;2.0
29;14;469;484;15;0;2.0
29;15;484;503;19;0;2.0
29;16;503;549;46;0;2.0
29;17;549;593;44;0;2.0
29;18;593;629;36;0;2.0
29;19;629;663;34;0;2.0
29;20;663;683;20;0;2.0
29;21;683;728;45;0;2.0
29;22;728;762;34;0;2.0
29;23;762;798;36;0;2.0
29;24;798;832;34;0;2.0
29;25;832;840;8;0;2.0
29;26;840;853;13;0;2.0
29;27;853;868;15;0;2.0
29;28;868;879;11;0;2.0
29;29;879;883;4;0;2.0
29;30;883;887;4;0;2.0
29;31;887;912;25;0;2.0
29;32;912;913;1;0;2.0
29;33;913;942;29;0;2.0
29;34;942;948;6;0;2.0
29;35;948;972;24;0;2.0
29;36;972;973;1;0;2.0
29;37;973;982;9;0;2.0
29;38;982;1002;20;0;2.0
29;39;1002;1032;30;0;2.0
29;40;1032;1033;1;0;2.0
29;41;1033;1062;29;0;2.0
29;42;1062;1068;6;0;2.0
29;43;1068;1102;34;0;2.0
29;44;1102;1122;20;0;2.0
29;45;1122;1324;202;0;2.0
29;46;1324;1346;22;0;2.0
29;47;1346;1361;15;0;2.0
29;48;1361;1376;15;0;2.0
29;49;1376;1391;15;0;2.0
29;50;1391;1406;15;0;2.0
29;51;1406;1421;15;0;2.0
29;52;1421;1436;15;0;2.0
29;53;1436;1451;15;0;2.0
29;54;1451;1466;15;0;2.0
29;55;1466;1481;15;0;2.0
29;56;1481;1496;15;0;2.0
29;57;1496;1511;15;0;2.0
29;58;1511;1526;15;0;2.0
29;59;1526;1541;15;0;2.0
29;60;1541;1556;15;0;2.0
29;61;1556;1571;15;0;2.0
29;62;1571;1586;15;0;2.0
29;63;1586;1601;15;0;2.0
29;64;1601;1616;15;0;2.0
29;65;1616;1631;15;0;2.0
29;66;1631;1646;15;0;2.0
29;67;1646;1661;15;0;2.0
29;68;1661;1676;15;0;2.0
29;69;1676;1680;4;0;2.0
30;0;240;339;99;0;2.0
30;1;339;354;15;0;2.0
30;2;354;359;5;0;2.0
30;3;359;369;10;0;2.0
30;4;369;389;20;0;2.0
30;5;389;394;5;0;2.0
30;6;394;409;15;0;2.0
30;7;409;419;10;0;2.0
30;8;419;426;7;0;2.0
30;9;426;429;3;0;2.0
30;10;429;449;20;0;2.0
30;11;449;454;5;0;2.0
30;12;454;461;7;0;2.0
30;13;461;469;8;0;2.0
30;14;469;484;15;0;2.0
30;15;484;503;19;0;2.0
30;16;503;549;46;0;2.0
30;17;549;593;44;0;2.0
30;18;593;629;36;0;2.0
30;19;629;663;34;0;2.0
30;20;663;683;20;0;2.0
30;21;683;728;45;0;2.0
30;22;728;762;34;0;2.0
30;23;762;798;36;0;2.0
30;24;798;832;34;0;2.0
30;25;832;840;8;0;2.0
30;26;840;853;13;0;2.0
30;27;853;868;15;0;2.0
30;28;868;879;11;0;2.0
30;29;879;883;4;0;2.0
30;30;883;887;4;0;2.0
30;31;887;912;25;0;2.0
30;32;912;913;1;0;2.0
30;33;913;942;29;0;2.0
30;34;942;948;6;0;2.0
30;35;948;972;24;0;2.0
30;36;972;973;1;0;2.0
30;37;973;982;9;0;2.0
30;38;982;1002;20;0;2.0
30;39;1002;1032;30;0;2.0
30;40;1032;1033;1;0;2.0
30;41;1033;1062;29;0;2.0
30;42;1062;1068;6;0;2.0
30;43;1068;1102;34;0;2.0
30;44;1102;1122;20;0;2.0
30;45;1122;1324;202;0;2.0
30;46;1324;1346;22;0;2.0
30;47;1346;1361;15;0;2.0
30;48;1361;1376;15;0;2.0
30;49;1376;1391;15;0;2.0
30;50;1391;1406;15;0;2.0
30;51;1406;1421;15;0;2.0
30;52;1421;1436;15;0;2.0
30;53;1436;1451;15;0;2.0
30;54;1451;1466;15;0;2.0
30;55;1466;1481;15;0;2.0
30;56;1481;1496;15;0;2.0
30;57;1496;1511;15;0;2.0
30;58;1511;1526;15;0;2.0
30;59;1526;1541;15;0;2.0
30;60;1541;1556;15;0;2.0
30;61;1556;1571;15;0;2.0
30;62;1571;1586;15;0;2.0
30;63;1586;1601;15;0;2.0
30;64;1601;1616;15;0;2.0
30;65;1616;1631;15;0;2.0
30;66;1631;1646;15;0;2.0
30;67;1646;1661;15;0;2.0
30;68;1661;1676;15;0;2.0
30;69;1676;1680;4;0;2.0
