Index Nabijacky;Index Udalosti;Cas Zaciatku;Cas Konca;CasTrvania;Miesto;Rychlost nabijania
0;0;249;333;84;112;2.0
0;1;333;337;4;112;2.0
0;2;337;352;15;112;2.0
0;3;352;357;5;112;2.0
0;4;357;363;6;112;2.0
0;5;363;371;8;112;2.0
0;6;371;373;2;112;2.0
0;7;373;388;15;112;2.0
0;8;388;392;4;112;2.0
0;9;392;393;1;112;2.0
0;10;393;407;14;112;2.0
0;11;407;423;16;112;2.0
0;12;423;424;1;112;2.0
0;13;424;428;4;112;2.0
0;14;428;433;5;112;2.0
0;15;433;452;19;112;2.0
0;16;452;453;1;112;2.0
0;17;453;455;2;112;2.0
0;18;455;465;10;112;2.0
0;19;465;467;2;112;2.0
0;20;467;482;15;112;2.0
0;21;482;488;6;112;2.0
0;22;488;498;10;112;2.0
0;23;498;505;7;112;2.0
0;24;505;518;13;112;2.0
0;25;518;553;35;112;2.0
0;26;553;591;38;112;2.0
0;27;591;593;2;112;2.0
0;28;593;620;27;112;2.0
0;29;620;633;13;112;2.0
0;30;633;661;28;112;2.0
0;31;661;685;24;112;2.0
0;32;685;713;28;112;2.0
0;33;713;726;13;112;2.0
0;34;726;740;14;112;2.0
0;35;740;753;13;112;2.0
0;36;753;766;13;112;2.0
0;37;766;796;30;112;2.0
0;38;796;818;22;112;2.0
0;39;818;836;18;112;2.0
0;40;836;838;2;112;2.0
0;41;838;851;13;112;2.0
0;42;851;866;15;112;2.0
0;43;866;881;15;112;2.0
0;44;881;883;2;112;2.0
0;45;883;891;8;112;2.0
0;46;891;903;12;112;2.0
0;47;903;911;8;112;2.0
0;48;911;916;5;112;2.0
0;49;916;925;9;112;2.0
0;50;925;933;8;112;2.0
0;51;933;943;10;112;2.0
0;52;943;946;3;112;2.0
0;53;946;963;17;112;2.0
0;54;963;971;8;112;2.0
0;55;971;976;5;112;2.0
0;56;976;984;8;112;2.0
0;57;984;1003;19;112;2.0
0;58;1003;1006;3;112;2.0
0;59;1006;1023;17;112;2.0
0;60;1023;1031;8;112;2.0
0;61;1031;1036;5;112;2.0
0;62;1036;1063;27;112;2.0
0;63;1063;1066;3;112;2.0
0;64;1066;1090;24;112;2.0
0;65;1090;1097;7;112;2.0
0;66;1097;1104;7;112;2.0
0;67;1104;1126;22;112;2.0
0;68;1126;1147;21;112;2.0
0;69;1147;1180;33;112;2.0
0;70;1180;1220;40;112;2.0
0;71;1220;1227;7;112;2.0
0;72;1227;1267;40;112;2.0
0;73;1267;1285;18;112;2.0
0;74;1285;1322;37;112;2.0
0;75;1322;1348;26;112;2.0
0;76;1348;1387;39;112;2.0
0;77;1387;1398;11;112;2.0
0;78;1398;1413;15;112;2.0
0;79;1413;1428;15;112;2.0
0;80;1428;1443;15;112;2.0
0;81;1443;1458;15;112;2.0
0;82;1458;1473;15;112;2.0
0;83;1473;1488;15;112;2.0
0;84;1488;1503;15;112;2.0
0;85;1503;1518;15;112;2.0
0;86;1518;1533;15;112;2.0
0;87;1533;1548;15;112;2.0
0;88;1548;1563;15;112;2.0
0;89;1563;1578;15;112;2.0
0;90;1578;1593;15;112;2.0
0;91;1593;1608;15;112;2.0
0;92;1608;1623;15;112;2.0
0;93;1623;1638;15;112;2.0
0;94;1638;1653;15;112;2.0
0;95;1653;1668;15;112;2.0
0;96;1668;1680;12;112;2.0
1;0;245;336;91;93;2.0
1;1;336;340;4;93;2.0
1;2;340;355;15;93;2.0
1;3;355;356;1;93;2.0
1;4;356;360;4;93;2.0
1;5;360;366;6;93;2.0
1;6;366;379;13;93;2.0
1;7;379;386;7;93;2.0
1;8;386;389;3;93;2.0
1;9;389;395;6;93;2.0
1;10;395;410;15;93;2.0
1;11;410;416;6;93;2.0
1;12;416;426;10;93;2.0
1;13;426;427;1;93;2.0
1;14;427;436;9;93;2.0
1;15;436;446;10;93;2.0
1;16;446;455;9;93;2.0
1;17;455;458;3;93;2.0
1;18;458;470;12;93;2.0
1;19;470;481;11;93;2.0
1;20;481;485;4;93;2.0
1;21;485;506;21;93;2.0
1;22;506;519;13;93;2.0
1;23;519;546;27;93;2.0
1;24;546;594;48;93;2.0
1;25;594;601;7;93;2.0
1;26;601;623;22;93;2.0
1;27;623;626;3;93;2.0
1;28;626;634;8;93;2.0
1;29;634;664;30;93;2.0
1;30;664;686;22;93;2.0
1;31;686;721;35;93;2.0
1;32;721;729;8;93;2.0
1;33;729;743;14;93;2.0
1;34;743;754;11;93;2.0
1;35;754;759;5;93;2.0
1;36;759;799;40;93;2.0
1;37;799;826;27;93;2.0
1;38;826;829;3;93;2.0
1;39;829;837;8;93;2.0
1;40;837;841;4;93;2.0
1;41;841;854;13;93;2.0
1;42;854;869;15;93;2.0
1;43;869;876;7;93;2.0
1;44;876;884;8;93;2.0
1;45;884;891;7;93;2.0
1;46;891;904;13;93;2.0
1;47;904;909;5;93;2.0
1;48;909;914;5;93;2.0
1;49;914;928;14;93;2.0
1;50;928;934;6;93;2.0
1;51;934;939;5;93;2.0
1;52;939;949;10;93;2.0
1;53;949;951;2;93;2.0
1;54;951;964;13;93;2.0
1;55;964;969;5;93;2.0
1;56;969;974;5;93;2.0
1;57;974;985;11;93;2.0
1;58;985;999;14;93;2.0
1;59;999;1011;12;93;2.0
1;60;1011;1024;13;93;2.0
1;61;1024;1029;5;93;2.0
1;62;1029;1034;5;93;2.0
1;63;1034;1059;25;93;2.0
1;64;1059;1069;10;93;2.0
1;65;1069;1071;2;93;2.0
1;66;1071;1093;22;93;2.0
1;67;1093;1098;5;93;2.0
1;68;1098;1105;7;93;2.0
1;69;1105;1119;14;93;2.0
1;70;1119;1155;36;93;2.0
1;71;1155;1181;26;93;2.0
1;72;1181;1223;42;93;2.0
1;73;1223;1228;5;93;2.0
1;74;1228;1275;47;93;2.0
1;75;1275;1286;11;93;2.0
1;76;1286;1325;39;93;2.0
1;77;1325;1349;24;93;2.0
1;78;1349;1395;46;93;2.0
1;79;1395;1399;4;93;2.0
1;80;1399;1414;15;93;2.0
1;81;1414;1429;15;93;2.0
1;82;1429;1444;15;93;2.0
1;83;1444;1459;15;93;2.0
1;84;1459;1474;15;93;2.0
1;85;1474;1489;15;93;2.0
1;86;1489;1504;15;93;2.0
1;87;1504;1519;15;93;2.0
1;88;1519;1534;15;93;2.0
1;89;1534;1549;15;93;2.0
1;90;1549;1564;15;93;2.0
1;91;1564;1579;15;93;2.0
1;92;1579;1594;15;93;2.0
1;93;1594;1609;15;93;2.0
1;94;1609;1624;15;93;2.0
1;95;1624;1639;15;93;2.0
1;96;1639;1654;15;93;2.0
1;97;1654;1669;15;93;2.0
1;98;1669;1680;11;93;2.0
2;0;246;336;90;92;2.0
2;1;336;339;3;92;2.0
2;2;339;354;15;92;2.0
2;3;354;355;1;92;2.0
2;4;355;359;4;92;2.0
2;5;359;365;6;92;2.0
2;6;365;379;14;92;2.0
2;7;379;385;6;92;2.0
2;8;385;388;3;92;2.0
2;9;388;394;6;92;2.0
2;10;394;409;15;92;2.0
2;11;409;415;6;92;2.0
2;12;415;425;10;92;2.0
2;13;425;426;1;92;2.0
2;14;426;436;10;92;2.0
2;15;436;445;9;92;2.0
2;16;445;454;9;92;2.0
2;17;454;457;3;92;2.0
2;18;457;458;1;92;2.0
2;19;458;469;11;92;2.0
2;20;469;480;11;92;2.0
2;21;480;484;4;92;2.0
2;22;484;505;21;92;2.0
2;23;505;506;1;92;2.0
2;24;506;518;12;92;2.0
2;25;518;545;27;92;2.0
2;26;545;593;48;92;2.0
2;27;593;601;8;92;2.0
2;28;601;623;22;92;2.0
2;29;623;625;2;92;2.0
2;30;625;633;8;92;2.0
2;31;633;663;30;92;2.0
2;32;663;685;22;92;2.0
2;33;685;721;36;92;2.0
2;34;721;728;7;92;2.0
2;35;728;743;15;92;2.0
2;36;743;753;10;92;2.0
2;37;753;758;5;92;2.0
2;38;758;798;40;92;2.0
2;39;798;826;28;92;2.0
2;40;826;828;2;92;2.0
2;41;828;836;8;92;2.0
2;42;836;840;4;92;2.0
2;43;840;853;13;92;2.0
2;44;853;868;15;92;2.0
2;45;868;875;7;92;2.0
2;46;875;883;8;92;2.0
2;47;883;891;8;92;2.0
2;48;891;903;12;92;2.0
2;49;903;908;5;92;2.0
2;50;908;913;5;92;2.0
2;51;913;928;15;92;2.0
2;52;928;933;5;92;2.0
2;53;933;938;5;92;2.0
2;54;938;948;10;92;2.0
2;55;948;951;3;92;2.0
2;56;951;963;12;92;2.0
2;57;963;968;5;92;2.0
2;58;968;973;5;92;2.0
2;59;973;984;11;92;2.0
2;60;984;998;14;92;2.0
2;61;998;1011;13;92;2.0
2;62;1011;1023;12;92;2.0
2;63;1023;1028;5;92;2.0
2;64;1028;1033;5;92;2.0
2;65;1033;1058;25;92;2.0
2;66;1058;1068;10;92;2.0
2;67;1068;1071;3;92;2.0
2;68;1071;1093;22;92;2.0
2;69;1093;1097;4;92;2.0
2;70;1097;1104;7;92;2.0
2;71;1104;1118;14;92;2.0
2;72;1118;1155;37;92;2.0
2;73;1155;1180;25;92;2.0
2;74;1180;1223;43;92;2.0
2;75;1223;1227;4;92;2.0
2;76;1227;1275;48;92;2.0
2;77;1275;1285;10;92;2.0
2;78;1285;1324;39;92;2.0
2;79;1324;1348;24;92;2.0
2;80;1348;1395;47;92;2.0
2;81;1395;1398;3;92;2.0
2;82;1398;1413;15;92;2.0
2;83;1413;1428;15;92;2.0
2;84;1428;1443;15;92;2.0
2;85;1443;1458;15;92;2.0
2;86;1458;1473;15;92;2.0
2;87;1473;1488;15;92;2.0
2;88;1488;1503;15;92;2.0
2;89;1503;1518;15;92;2.0
2;90;1518;1533;15;92;2.0
2;91;1533;1548;15;92;2.0
2;92;1548;1563;15;92;2.0
2;93;1563;1578;15;92;2.0
2;94;1578;1593;15;92;2.0
2;95;1593;1608;15;92;2.0
2;96;1608;1623;15;92;2.0
2;97;1623;1638;15;92;2.0
2;98;1638;1653;15;92;2.0
2;99;1653;1668;15;92;2.0
2;100;1668;1680;12;92;2.0
3;0;248;336;88;77;2.0
3;1;336;338;2;77;2.0
3;2;338;351;13;77;2.0
3;3;351;356;5;77;2.0
3;4;356;358;2;77;2.0
3;5;358;368;10;77;2.0
3;6;368;378;10;77;2.0
3;7;378;388;10;77;2.0
3;8;388;391;3;77;2.0
3;9;391;406;15;77;2.0
3;10;406;418;12;77;2.0
3;11;418;423;5;77;2.0
3;12;423;428;5;77;2.0
3;13;428;435;7;77;2.0
3;14;435;448;13;77;2.0
3;15;448;451;3;77;2.0
3;16;451;460;9;77;2.0
3;17;460;466;6;77;2.0
3;18;466;481;15;77;2.0
3;19;481;483;2;77;2.0
3;20;483;505;22;77;2.0
3;21;505;518;13;77;2.0
3;22;518;548;30;77;2.0
3;23;548;590;42;77;2.0
3;24;590;600;10;77;2.0
3;25;600;625;25;77;2.0
3;26;625;628;3;77;2.0
3;27;628;633;5;77;2.0
3;28;633;660;27;77;2.0
3;29;660;685;25;77;2.0
3;30;685;720;35;77;2.0
3;31;720;725;5;77;2.0
3;32;725;745;20;77;2.0
3;33;745;753;8;77;2.0
3;34;753;761;8;77;2.0
3;35;761;795;34;77;2.0
3;36;795;825;30;77;2.0
3;37;825;831;6;77;2.0
3;38;831;836;5;77;2.0
3;39;836;837;1;77;2.0
3;40;837;850;13;77;2.0
3;41;850;865;15;77;2.0
3;42;865;878;13;77;2.0
3;43;878;880;2;77;2.0
3;44;880;886;6;77;2.0
3;45;886;890;4;77;2.0
3;46;890;903;13;77;2.0
3;47;903;910;7;77;2.0
3;48;910;911;1;77;2.0
3;49;911;930;19;77;2.0
3;50;930;933;3;77;2.0
3;51;933;941;8;77;2.0
3;52;941;945;4;77;2.0
3;53;945;950;5;77;2.0
3;54;950;963;13;77;2.0
3;55;963;970;7;77;2.0
3;56;970;971;1;77;2.0
3;57;971;984;13;77;2.0
3;58;984;1001;17;77;2.0
3;59;1001;1010;9;77;2.0
3;60;1010;1023;13;77;2.0
3;61;1023;1030;7;77;2.0
3;62;1030;1031;1;77;2.0
3;63;1031;1061;30;77;2.0
3;64;1061;1065;4;77;2.0
3;65;1065;1070;5;77;2.0
3;66;1070;1095;25;77;2.0
3;67;1095;1097;2;77;2.0
3;68;1097;1104;7;77;2.0
3;69;1104;1121;17;77;2.0
3;70;1121;1154;33;77;2.0
3;71;1154;1180;26;77;2.0
3;72;1180;1225;45;77;2.0
3;73;1225;1227;2;77;2.0
3;74;1227;1274;47;77;2.0
3;75;1274;1285;11;77;2.0
3;76;1285;1321;36;77;2.0
3;77;1321;1348;27;77;2.0
3;78;1348;1394;46;77;2.0
3;79;1394;1398;4;77;2.0
3;80;1398;1413;15;77;2.0
3;81;1413;1428;15;77;2.0
3;82;1428;1443;15;77;2.0
3;83;1443;1458;15;77;2.0
3;84;1458;1473;15;77;2.0
3;85;1473;1488;15;77;2.0
3;86;1488;1503;15;77;2.0
3;87;1503;1518;15;77;2.0
3;88;1518;1533;15;77;2.0
3;89;1533;1548;15;77;2.0
3;90;1548;1563;15;77;2.0
3;91;1563;1578;15;77;2.0
3;92;1578;1593;15;77;2.0
3;93;1593;1608;15;77;2.0
3;94;1608;1623;15;77;2.0
3;95;1623;1638;15;77;2.0
3;96;1638;1653;15;77;2.0
3;97;1653;1668;15;77;2.0
3;98;1668;1680;12;77;2.0
4;0;245;336;91;119;2.0
4;1;336;337;1;119;2.0
4;2;337;352;15;119;2.0
4;3;352;357;5;119;2.0
4;4;357;367;10;119;2.0
4;5;367;377;10;119;2.0
4;6;377;386;9;119;2.0
4;7;386;387;1;119;2.0
4;8;387;392;5;119;2.0
4;9;392;407;15;119;2.0
4;10;407;417;10;119;2.0
4;11;417;424;7;119;2.0
4;12;424;427;3;119;2.0
4;13;427;434;7;119;2.0
4;14;434;447;13;119;2.0
4;15;447;452;5;119;2.0
4;16;452;458;6;119;2.0
4;17;458;459;1;119;2.0
4;18;459;467;8;119;2.0
4;19;467;482;15;119;2.0
4;20;482;503;21;119;2.0
4;21;503;504;1;119;2.0
4;22;504;516;12;119;2.0
4;23;516;547;31;119;2.0
4;24;547;591;44;119;2.0
4;25;591;599;8;119;2.0
4;26;599;623;24;119;2.0
4;27;623;627;4;119;2.0
4;28;627;631;4;119;2.0
4;29;631;661;30;119;2.0
4;30;661;683;22;119;2.0
4;31;683;719;36;119;2.0
4;32;719;726;7;119;2.0
4;33;726;743;17;119;2.0
4;34;743;751;8;119;2.0
4;35;751;760;9;119;2.0
4;36;760;796;36;119;2.0
4;37;796;824;28;119;2.0
4;38;824;830;6;119;2.0
4;39;830;834;4;119;2.0
4;40;834;838;4;119;2.0
4;41;838;851;13;119;2.0
4;42;851;866;15;119;2.0
4;43;866;877;11;119;2.0
4;44;877;881;4;119;2.0
4;45;881;885;4;119;2.0
4;46;885;889;4;119;2.0
4;47;889;901;12;119;2.0
4;48;901;910;9;119;2.0
4;49;910;911;1;119;2.0
4;50;911;928;17;119;2.0
4;51;928;931;3;119;2.0
4;52;931;940;9;119;2.0
4;53;940;946;6;119;2.0
4;54;946;949;3;119;2.0
4;55;949;961;12;119;2.0
4;56;961;970;9;119;2.0
4;57;970;971;1;119;2.0
4;58;971;982;11;119;2.0
4;59;982;1000;18;119;2.0
4;60;1000;1009;9;119;2.0
4;61;1009;1021;12;119;2.0
4;62;1021;1030;9;119;2.0
4;63;1030;1031;1;119;2.0
4;64;1031;1060;29;119;2.0
4;65;1060;1066;6;119;2.0
4;66;1066;1069;3;119;2.0
4;67;1069;1093;24;119;2.0
4;68;1093;1095;2;119;2.0
4;69;1095;1102;7;119;2.0
4;70;1102;1120;18;119;2.0
4;71;1120;1153;33;119;2.0
4;72;1153;1178;25;119;2.0
4;73;1178;1223;45;119;2.0
4;74;1223;1225;2;119;2.0
4;75;1225;1273;48;119;2.0
4;76;1273;1283;10;119;2.0
4;77;1283;1322;39;119;2.0
4;78;1322;1346;24;119;2.0
4;79;1346;1393;47;119;2.0
4;80;1393;1396;3;119;2.0
4;81;1396;1411;15;119;2.0
4;82;1411;1426;15;119;2.0
4;83;1426;1441;15;119;2.0
4;84;1441;1456;15;119;2.0
4;85;1456;1471;15;119;2.0
4;86;1471;1486;15;119;2.0
4;87;1486;1501;15;119;2.0
4;88;1501;1516;15;119;2.0
4;89;1516;1531;15;119;2.0
4;90;1531;1546;15;119;2.0
4;91;1546;1561;15;119;2.0
4;92;1561;1576;15;119;2.0
4;93;1576;1591;15;119;2.0
4;94;1591;1606;15;119;2.0
4;95;1606;1621;15;119;2.0
4;96;1621;1636;15;119;2.0
4;97;1636;1651;15;119;2.0
4;98;1651;1666;15;119;2.0
4;99;1666;1680;14;119;2.0
5;0;243;334;91;96;2.0
5;1;334;339;5;96;2.0
5;2;339;354;15;96;2.0
5;3;354;357;3;96;2.0
5;4;357;359;2;96;2.0
5;5;359;367;8;96;2.0
5;6;367;379;12;96;2.0
5;7;379;387;8;96;2.0
5;8;387;394;7;96;2.0
5;9;394;409;15;96;2.0
5;10;409;417;8;96;2.0
5;11;417;426;9;96;2.0
5;12;426;427;1;96;2.0
5;13;427;436;9;96;2.0
5;14;436;447;11;96;2.0
5;15;447;454;7;96;2.0
5;16;454;456;2;96;2.0
5;17;456;459;3;96;2.0
5;18;459;469;10;96;2.0
5;19;469;482;13;96;2.0
5;20;482;484;2;96;2.0
5;21;484;504;20;96;2.0
5;22;504;506;2;96;2.0
5;23;506;517;11;96;2.0
5;24;517;547;30;96;2.0
5;25;547;593;46;96;2.0
5;26;593;601;8;96;2.0
5;27;601;621;20;96;2.0
5;28;621;627;6;96;2.0
5;29;627;632;5;96;2.0
5;30;632;663;31;96;2.0
5;31;663;684;21;96;2.0
5;32;684;721;37;96;2.0
5;33;721;728;7;96;2.0
5;34;728;741;13;96;2.0
5;35;741;752;11;96;2.0
5;36;752;760;8;96;2.0
5;37;760;798;38;96;2.0
5;38;798;826;28;96;2.0
5;39;826;830;4;96;2.0
5;40;830;835;5;96;2.0
5;41;835;840;5;96;2.0
5;42;840;853;13;96;2.0
5;43;853;868;15;96;2.0
5;44;868;877;9;96;2.0
5;45;877;883;6;96;2.0
5;46;883;885;2;96;2.0
5;47;885;891;6;96;2.0
5;48;891;902;11;96;2.0
5;49;902;910;8;96;2.0
5;50;910;913;3;96;2.0
5;51;913;926;13;96;2.0
5;52;926;932;6;96;2.0
5;53;932;940;8;96;2.0
5;54;940;948;8;96;2.0
5;55;948;951;3;96;2.0
5;56;951;962;11;96;2.0
5;57;962;970;8;96;2.0
5;58;970;973;3;96;2.0
5;59;973;983;10;96;2.0
5;60;983;1000;17;96;2.0
5;61;1000;1011;11;96;2.0
5;62;1011;1022;11;96;2.0
5;63;1022;1030;8;96;2.0
5;64;1030;1033;3;96;2.0
5;65;1033;1060;27;96;2.0
5;66;1060;1068;8;96;2.0
5;67;1068;1071;3;96;2.0
5;68;1071;1091;20;96;2.0
5;69;1091;1096;5;96;2.0
5;70;1096;1103;7;96;2.0
5;71;1103;1120;17;96;2.0
5;72;1120;1155;35;96;2.0
5;73;1155;1179;24;96;2.0
5;74;1179;1221;42;96;2.0
5;75;1221;1226;5;96;2.0
5;76;1226;1275;49;96;2.0
5;77;1275;1284;9;96;2.0
5;78;1284;1324;40;96;2.0
5;79;1324;1347;23;96;2.0
5;80;1347;1395;48;96;2.0
5;81;1395;1397;2;96;2.0
5;82;1397;1412;15;96;2.0
5;83;1412;1427;15;96;2.0
5;84;1427;1442;15;96;2.0
5;85;1442;1457;15;96;2.0
5;86;1457;1472;15;96;2.0
5;87;1472;1487;15;96;2.0
5;88;1487;1502;15;96;2.0
5;89;1502;1517;15;96;2.0
5;90;1517;1532;15;96;2.0
5;91;1532;1547;15;96;2.0
5;92;1547;1562;15;96;2.0
5;93;1562;1577;15;96;2.0
5;94;1577;1592;15;96;2.0
5;95;1592;1607;15;96;2.0
5;96;1607;1622;15;96;2.0
5;97;1622;1637;15;96;2.0
5;98;1637;1652;15;96;2.0
5;99;1652;1667;15;96;2.0
5;100;1667;1680;13;96;2.0
6;0;252;334;82;160;2.0
6;1;334;341;7;160;2.0
6;2;341;349;8;160;2.0
6;3;349;354;5;160;2.0
6;4;354;363;9;160;2.0
6;5;363;373;10;160;2.0
6;6;373;381;8;160;2.0
6;7;381;389;8;160;2.0
6;8;389;393;4;160;2.0
6;9;393;394;1;160;2.0
6;10;394;404;10;160;2.0
6;11;404;421;17;160;2.0
6;12;421;423;2;160;2.0
6;13;423;433;10;160;2.0
6;14;433;438;5;160;2.0
6;15;438;449;11;160;2.0
6;16;449;453;4;160;2.0
6;17;453;463;10;160;2.0
6;18;463;464;1;160;2.0
6;19;464;465;1;160;2.0
6;20;465;479;14;160;2.0
6;21;479;488;9;160;2.0
6;22;488;508;20;160;2.0
6;23;508;511;3;160;2.0
6;24;511;524;13;160;2.0
6;25;524;553;29;160;2.0
6;26;553;588;35;160;2.0
6;27;588;603;15;160;2.0
6;28;603;628;25;160;2.0
6;29;628;633;5;160;2.0
6;30;633;639;6;160;2.0
6;31;639;658;19;160;2.0
6;32;658;691;33;160;2.0
6;33;691;723;32;160;2.0
6;34;723;748;25;160;2.0
6;35;748;759;11;160;2.0
6;36;759;766;7;160;2.0
6;37;766;793;27;160;2.0
6;38;793;828;35;160;2.0
6;39;828;835;7;160;2.0
6;40;835;836;1;160;2.0
6;41;836;842;6;160;2.0
6;42;842;848;6;160;2.0
6;43;848;863;15;160;2.0
6;44;863;878;15;160;2.0
6;45;878;883;5;160;2.0
6;46;883;891;8;160;2.0
6;47;891;893;2;160;2.0
6;48;893;908;15;160;2.0
6;49;908;909;1;160;2.0
6;50;909;916;7;160;2.0
6;51;916;933;17;160;2.0
6;52;933;939;6;160;2.0
6;53;939;943;4;160;2.0
6;54;943;946;3;160;2.0
6;55;946;953;7;160;2.0
6;56;953;968;15;160;2.0
6;57;968;969;1;160;2.0
6;58;969;976;7;160;2.0
6;59;976;990;14;160;2.0
6;60;990;1006;16;160;2.0
6;61;1006;1013;7;160;2.0
6;62;1013;1028;15;160;2.0
6;63;1028;1029;1;160;2.0
6;64;1029;1036;7;160;2.0
6;65;1036;1063;27;160;2.0
6;66;1063;1066;3;160;2.0
6;67;1066;1073;7;160;2.0
6;68;1073;1098;25;160;2.0
6;69;1098;1103;5;160;2.0
6;70;1103;1110;7;160;2.0
6;71;1110;1126;16;160;2.0
6;72;1126;1157;31;160;2.0
6;73;1157;1186;29;160;2.0
6;74;1186;1228;42;160;2.0
6;75;1228;1233;5;160;2.0
6;76;1233;1277;44;160;2.0
6;77;1277;1291;14;160;2.0
6;78;1291;1319;28;160;2.0
6;79;1319;1354;35;160;2.0
6;80;1354;1397;43;160;2.0
6;81;1397;1404;7;160;2.0
6;82;1404;1419;15;160;2.0
6;83;1419;1434;15;160;2.0
6;84;1434;1449;15;160;2.0
6;85;1449;1464;15;160;2.0
6;86;1464;1479;15;160;2.0
6;87;1479;1494;15;160;2.0
6;88;1494;1509;15;160;2.0
6;89;1509;1524;15;160;2.0
6;90;1524;1539;15;160;2.0
6;91;1539;1554;15;160;2.0
6;92;1554;1569;15;160;2.0
6;93;1569;1584;15;160;2.0
6;94;1584;1599;15;160;2.0
6;95;1599;1614;15;160;2.0
6;96;1614;1629;15;160;2.0
6;97;1629;1644;15;160;2.0
6;98;1644;1659;15;160;2.0
6;99;1659;1680;21;160;2.0
7;0;250;333;83;1;2.0
7;1;333;339;6;1;2.0
7;2;339;348;9;1;2.0
7;3;348;353;5;1;2.0
7;4;353;364;11;1;2.0
7;5;364;374;10;1;2.0
7;6;374;378;4;1;2.0
7;7;378;388;10;1;2.0
7;8;388;392;4;1;2.0
7;9;392;394;2;1;2.0
7;10;394;403;9;1;2.0
7;11;403;420;17;1;2.0
7;12;420;424;4;1;2.0
7;13;424;434;10;1;2.0
7;14;434;435;1;1;2.0
7;15;435;448;13;1;2.0
7;16;448;454;6;1;2.0
7;17;454;461;7;1;2.0
7;18;461;463;2;1;2.0
7;19;463;466;3;1;2.0
7;20;466;478;12;1;2.0
7;21;478;489;11;1;2.0
7;22;489;505;16;1;2.0
7;23;505;509;4;1;2.0
7;24;509;522;13;1;2.0
7;25;522;554;32;1;2.0
7;26;554;587;33;1;2.0
7;27;587;600;13;1;2.0
7;28;600;626;26;1;2.0
7;29;626;634;8;1;2.0
7;30;634;637;3;1;2.0
7;31;637;657;20;1;2.0
7;32;657;689;32;1;2.0
7;33;689;720;31;1;2.0
7;34;720;722;2;1;2.0
7;35;722;746;24;1;2.0
7;36;746;757;11;1;2.0
7;37;757;767;10;1;2.0
7;38;767;792;25;1;2.0
7;39;792;825;33;1;2.0
7;40;825;834;9;1;2.0
7;41;834;837;3;1;2.0
7;42;837;840;3;1;2.0
7;43;840;847;7;1;2.0
7;44;847;862;15;1;2.0
7;45;862;877;15;1;2.0
7;46;877;884;7;1;2.0
7;47;884;890;6;1;2.0
7;48;890;892;2;1;2.0
7;49;892;907;15;1;2.0
7;50;907;917;10;1;2.0
7;51;917;931;14;1;2.0
7;52;931;937;6;1;2.0
7;53;937;942;5;1;2.0
7;54;942;947;5;1;2.0
7;55;947;950;3;1;2.0
7;56;950;967;17;1;2.0
7;57;967;977;10;1;2.0
7;58;977;988;11;1;2.0
7;59;988;1007;19;1;2.0
7;60;1007;1010;3;1;2.0
7;61;1010;1027;17;1;2.0
7;62;1027;1037;10;1;2.0
7;63;1037;1062;25;1;2.0
7;64;1062;1067;5;1;2.0
7;65;1067;1070;3;1;2.0
7;66;1070;1096;26;1;2.0
7;67;1096;1101;5;1;2.0
7;68;1101;1108;7;1;2.0
7;69;1108;1127;19;1;2.0
7;70;1127;1154;27;1;2.0
7;71;1154;1184;30;1;2.0
7;72;1184;1226;42;1;2.0
7;73;1226;1231;5;1;2.0
7;74;1231;1274;43;1;2.0
7;75;1274;1289;15;1;2.0
7;76;1289;1318;29;1;2.0
7;77;1318;1352;34;1;2.0
7;78;1352;1394;42;1;2.0
7;79;1394;1402;8;1;2.0
7;80;1402;1417;15;1;2.0
7;81;1417;1432;15;1;2.0
7;82;1432;1447;15;1;2.0
7;83;1447;1462;15;1;2.0
7;84;1462;1477;15;1;2.0
7;85;1477;1492;15;1;2.0
7;86;1492;1507;15;1;2.0
7;87;1507;1522;15;1;2.0
7;88;1522;1537;15;1;2.0
7;89;1537;1552;15;1;2.0
7;90;1552;1567;15;1;2.0
7;91;1567;1582;15;1;2.0
7;92;1582;1597;15;1;2.0
7;93;1597;1612;15;1;2.0
7;94;1612;1627;15;1;2.0
7;95;1627;1642;15;1;2.0
7;96;1642;1657;15;1;2.0
7;97;1657;1680;23;1;2.0
8;0;250;332;82;43;2.0
8;1;332;344;12;43;2.0
8;2;344;359;15;43;2.0
8;3;359;364;5;43;2.0
8;4;364;367;3;43;2.0
8;5;367;372;5;43;2.0
8;6;372;377;5;43;2.0
8;7;377;389;12;43;2.0
8;8;389;397;8;43;2.0
8;9;397;399;2;43;2.0
8;10;399;414;15;43;2.0
8;11;414;427;13;43;2.0
8;12;427;429;2;43;2.0
8;13;429;431;2;43;2.0
8;14;431;437;6;43;2.0
8;15;437;454;17;43;2.0
8;16;454;457;3;43;2.0
8;17;457;459;2;43;2.0
8;18;459;469;10;43;2.0
8;19;469;474;5;43;2.0
8;20;474;489;15;43;2.0
8;21;489;492;3;43;2.0
8;22;492;499;7;43;2.0
8;23;499;506;7;43;2.0
8;24;506;519;13;43;2.0
8;25;519;557;38;43;2.0
8;26;557;594;37;43;2.0
8;27;594;598;4;43;2.0
8;28;598;619;21;43;2.0
8;29;619;634;15;43;2.0
8;30;634;637;3;43;2.0
8;31;637;668;31;43;2.0
8;32;668;686;18;43;2.0
8;33;686;714;28;43;2.0
8;34;714;733;19;43;2.0
8;35;733;739;6;43;2.0
8;36;739;754;15;43;2.0
8;37;754;770;16;43;2.0
8;38;770;803;33;43;2.0
8;39;803;819;16;43;2.0
8;40;819;837;18;43;2.0
8;41;837;840;3;43;2.0
8;42;840;845;5;43;2.0
8;43;845;858;13;43;2.0
8;44;858;873;15;43;2.0
8;45;873;884;11;43;2.0
8;46;884;887;3;43;2.0
8;47;887;888;1;43;2.0
8;48;888;895;7;43;2.0
8;49;895;904;9;43;2.0
8;50;904;918;14;43;2.0
8;51;918;920;2;43;2.0
8;52;920;924;4;43;2.0
8;53;924;934;10;43;2.0
8;54;934;944;10;43;2.0
8;55;944;950;6;43;2.0
8;56;950;953;3;43;2.0
8;57;953;964;11;43;2.0
8;58;964;978;14;43;2.0
8;59;978;980;2;43;2.0
8;60;980;985;5;43;2.0
8;61;985;1004;19;43;2.0
8;62;1004;1010;6;43;2.0
8;63;1010;1024;14;43;2.0
8;64;1024;1038;14;43;2.0
8;65;1038;1040;2;43;2.0
8;66;1040;1064;24;43;2.0
8;67;1064;1070;6;43;2.0
8;68;1070;1073;3;43;2.0
8;69;1073;1089;16;43;2.0
8;70;1089;1098;9;43;2.0
8;71;1098;1105;7;43;2.0
8;72;1105;1130;25;43;2.0
8;73;1130;1148;18;43;2.0
8;74;1148;1181;33;43;2.0
8;75;1181;1219;38;43;2.0
8;76;1219;1228;9;43;2.0
8;77;1228;1268;40;43;2.0
8;78;1268;1286;18;43;2.0
8;79;1286;1329;43;43;2.0
8;80;1329;1349;20;43;2.0
8;81;1349;1388;39;43;2.0
8;82;1388;1399;11;43;2.0
8;83;1399;1414;15;43;2.0
8;84;1414;1429;15;43;2.0
8;85;1429;1444;15;43;2.0
8;86;1444;1459;15;43;2.0
8;87;1459;1474;15;43;2.0
8;88;1474;1489;15;43;2.0
8;89;1489;1504;15;43;2.0
8;90;1504;1519;15;43;2.0
8;91;1519;1534;15;43;2.0
8;92;1534;1549;15;43;2.0
8;93;1549;1564;15;43;2.0
8;94;1564;1579;15;43;2.0
8;95;1579;1594;15;43;2.0
8;96;1594;1609;15;43;2.0
8;97;1609;1624;15;43;2.0
8;98;1624;1639;15;43;2.0
8;99;1639;1654;15;43;2.0
8;100;1654;1669;15;43;2.0
8;101;1669;1680;11;43;2.0
9;0;250;333;83;4;2.0
9;1;333;337;4;4;2.0
9;2;337;348;11;4;2.0
9;3;348;353;5;4;2.0
9;4;353;364;11;4;2.0
9;5;364;374;10;4;2.0
9;6;374;376;2;4;2.0
9;7;376;388;12;4;2.0
9;8;388;390;2;4;2.0
9;9;390;394;4;4;2.0
9;10;394;403;9;4;2.0
9;11;403;420;17;4;2.0
9;12;420;424;4;4;2.0
9;13;424;433;9;4;2.0
9;14;433;434;1;4;2.0
9;15;434;448;14;4;2.0
9;16;448;454;6;4;2.0
9;17;454;459;5;4;2.0
9;18;459;463;4;4;2.0
9;19;463;466;3;4;2.0
9;20;466;478;12;4;2.0
9;21;478;489;11;4;2.0
9;22;489;503;14;4;2.0
9;23;503;507;4;4;2.0
9;24;507;520;13;4;2.0
9;25;520;554;34;4;2.0
9;26;554;587;33;4;2.0
9;27;587;598;11;4;2.0
9;28;598;624;26;4;2.0
9;29;624;634;10;4;2.0
9;30;634;635;1;4;2.0
9;31;635;657;22;4;2.0
9;32;657;687;30;4;2.0
9;33;687;718;31;4;2.0
9;34;718;722;4;4;2.0
9;35;722;744;22;4;2.0
9;36;744;755;11;4;2.0
9;37;755;767;12;4;2.0
9;38;767;792;25;4;2.0
9;39;792;823;31;4;2.0
9;40;823;834;11;4;2.0
9;41;834;837;3;4;2.0
9;42;837;838;1;4;2.0
9;43;838;847;9;4;2.0
9;44;847;862;15;4;2.0
9;45;862;877;15;4;2.0
9;46;877;884;7;4;2.0
9;47;884;888;4;4;2.0
9;48;888;892;4;4;2.0
9;49;892;905;13;4;2.0
9;50;905;907;2;4;2.0
9;51;907;917;10;4;2.0
9;52;917;929;12;4;2.0
9;53;929;935;6;4;2.0
9;54;935;942;7;4;2.0
9;55;942;947;5;4;2.0
9;56;947;948;1;4;2.0
9;57;948;965;17;4;2.0
9;58;965;967;2;4;2.0
9;59;967;977;10;4;2.0
9;60;977;986;9;4;2.0
9;61;986;1007;21;4;2.0
9;62;1007;1008;1;4;2.0
9;63;1008;1025;17;4;2.0
9;64;1025;1027;2;4;2.0
9;65;1027;1037;10;4;2.0
9;66;1037;1062;25;4;2.0
9;67;1062;1067;5;4;2.0
9;68;1067;1068;1;4;2.0
9;69;1068;1094;26;4;2.0
9;70;1094;1099;5;4;2.0
9;71;1099;1106;7;4;2.0
9;72;1106;1127;21;4;2.0
9;73;1127;1152;25;4;2.0
9;74;1152;1182;30;4;2.0
9;75;1182;1224;42;4;2.0
9;76;1224;1229;5;4;2.0
9;77;1229;1272;43;4;2.0
9;78;1272;1287;15;4;2.0
9;79;1287;1318;31;4;2.0
9;80;1318;1350;32;4;2.0
9;81;1350;1392;42;4;2.0
9;82;1392;1400;8;4;2.0
9;83;1400;1415;15;4;2.0
9;84;1415;1430;15;4;2.0
9;85;1430;1445;15;4;2.0
9;86;1445;1460;15;4;2.0
9;87;1460;1475;15;4;2.0
9;88;1475;1490;15;4;2.0
9;89;1490;1505;15;4;2.0
9;90;1505;1520;15;4;2.0
9;91;1520;1535;15;4;2.0
9;92;1535;1550;15;4;2.0
9;93;1550;1565;15;4;2.0
9;94;1565;1580;15;4;2.0
9;95;1580;1595;15;4;2.0
9;96;1595;1610;15;4;2.0
9;97;1610;1625;15;4;2.0
9;98;1625;1640;15;4;2.0
9;99;1640;1655;15;4;2.0
9;100;1655;1670;15;4;2.0
9;101;1670;1680;10;4;2.0
10;0;252;332;80;11;2.0
10;1;332;344;12;11;2.0
10;2;344;359;15;11;2.0
10;3;359;364;5;11;2.0
10;4;364;368;4;11;2.0
10;5;368;378;10;11;2.0
10;6;378;390;12;11;2.0
10;7;390;398;8;11;2.0
10;8;398;399;1;11;2.0
10;9;399;414;15;11;2.0
10;10;414;428;14;11;2.0
10;11;428;431;3;11;2.0
10;12;431;435;4;11;2.0
10;13;435;438;3;11;2.0
10;14;438;454;16;11;2.0
10;15;454;458;4;11;2.0
10;16;458;459;1;11;2.0
10;17;459;470;11;11;2.0
10;18;470;474;4;11;2.0
10;19;474;489;15;11;2.0
10;20;489;493;4;11;2.0
10;21;493;505;12;11;2.0
10;22;505;507;2;11;2.0
10;23;507;520;13;11;2.0
10;24;520;558;38;11;2.0
10;25;558;598;40;11;2.0
10;26;598;600;2;11;2.0
10;27;600;619;19;11;2.0
10;28;619;635;16;11;2.0
10;29;635;638;3;11;2.0
10;30;638;668;30;11;2.0
10;31;668;687;19;11;2.0
10;32;687;720;33;11;2.0
10;33;720;733;13;11;2.0
10;34;733;739;6;11;2.0
10;35;739;755;16;11;2.0
10;36;755;771;16;11;2.0
10;37;771;803;32;11;2.0
10;38;803;825;22;11;2.0
10;39;825;838;13;11;2.0
10;40;838;841;3;11;2.0
10;41;841;845;4;11;2.0
10;42;845;858;13;11;2.0
10;43;858;873;15;11;2.0
10;44;873;888;15;11;2.0
10;45;888;890;2;11;2.0
10;46;890;896;6;11;2.0
10;47;896;905;9;11;2.0
10;48;905;918;13;11;2.0
10;49;918;921;3;11;2.0
10;50;921;924;3;11;2.0
10;51;924;935;11;11;2.0
10;52;935;950;15;11;2.0
10;53;950;951;1;11;2.0
10;54;951;953;2;11;2.0
10;55;953;965;12;11;2.0
10;56;965;978;13;11;2.0
10;57;978;981;3;11;2.0
10;58;981;986;5;11;2.0
10;59;986;1010;24;11;2.0
10;60;1010;1011;1;11;2.0
10;61;1011;1025;14;11;2.0
10;62;1025;1038;13;11;2.0
10;63;1038;1041;3;11;2.0
10;64;1041;1070;29;11;2.0
10;65;1070;1071;1;11;2.0
10;66;1071;1073;2;11;2.0
10;67;1073;1089;16;11;2.0
10;68;1089;1099;10;11;2.0
10;69;1099;1106;7;11;2.0
10;70;1106;1131;25;11;2.0
10;71;1131;1154;23;11;2.0
10;72;1154;1182;28;11;2.0
10;73;1182;1219;37;11;2.0
10;74;1219;1229;10;11;2.0
10;75;1229;1274;45;11;2.0
10;76;1274;1287;13;11;2.0
10;77;1287;1329;42;11;2.0
10;78;1329;1350;21;11;2.0
10;79;1350;1394;44;11;2.0
10;80;1394;1400;6;11;2.0
10;81;1400;1415;15;11;2.0
10;82;1415;1430;15;11;2.0
10;83;1430;1445;15;11;2.0
10;84;1445;1460;15;11;2.0
10;85;1460;1475;15;11;2.0
10;86;1475;1490;15;11;2.0
10;87;1490;1505;15;11;2.0
10;88;1505;1520;15;11;2.0
10;89;1520;1535;15;11;2.0
10;90;1535;1550;15;11;2.0
10;91;1550;1565;15;11;2.0
10;92;1565;1580;15;11;2.0
10;93;1580;1595;15;11;2.0
10;94;1595;1610;15;11;2.0
10;95;1610;1625;15;11;2.0
10;96;1625;1640;15;11;2.0
10;97;1640;1655;15;11;2.0
10;98;1655;1680;25;11;2.0
11;0;250;341;91;87;2.0
11;1;341;344;3;87;2.0
11;2;344;359;15;87;2.0
11;3;359;361;2;87;2.0
11;4;361;364;3;87;2.0
11;5;364;371;7;87;2.0
11;6;371;386;15;87;2.0
11;7;386;391;5;87;2.0
11;8;391;394;3;87;2.0
11;9;394;399;5;87;2.0
11;10;399;414;15;87;2.0
11;11;414;421;7;87;2.0
11;12;421;431;10;87;2.0
11;13;431;443;12;87;2.0
11;14;443;451;8;87;2.0
11;15;451;459;8;87;2.0
11;16;459;463;4;87;2.0
11;17;463;474;11;87;2.0
11;18;474;486;12;87;2.0
11;19;486;489;3;87;2.0
11;20;489;511;22;87;2.0
11;21;511;513;2;87;2.0
11;22;513;524;11;87;2.0
11;23;524;551;27;87;2.0
11;24;551;598;47;87;2.0
11;25;598;608;10;87;2.0
11;26;608;628;20;87;2.0
11;27;628;631;3;87;2.0
11;28;631;639;8;87;2.0
11;29;639;668;29;87;2.0
11;30;668;691;23;87;2.0
11;31;691;728;37;87;2.0
11;32;728;733;5;87;2.0
11;33;733;748;15;87;2.0
11;34;748;759;11;87;2.0
11;35;759;764;5;87;2.0
11;36;764;803;39;87;2.0
11;37;803;833;30;87;2.0
11;38;833;834;1;87;2.0
11;39;834;842;8;87;2.0
11;40;842;845;3;87;2.0
11;41;845;858;13;87;2.0
11;42;858;873;15;87;2.0
11;43;873;881;8;87;2.0
11;44;881;888;7;87;2.0
11;45;888;889;1;87;2.0
11;46;889;898;9;87;2.0
11;47;898;909;11;87;2.0
11;48;909;914;5;87;2.0
11;49;914;918;4;87;2.0
11;50;918;933;15;87;2.0
11;51;933;939;6;87;2.0
11;52;939;944;5;87;2.0
11;53;944;953;9;87;2.0
11;54;953;958;5;87;2.0
11;55;958;969;11;87;2.0
11;56;969;974;5;87;2.0
11;57;974;978;4;87;2.0
11;58;978;990;12;87;2.0
11;59;990;1004;14;87;2.0
11;60;1004;1018;14;87;2.0
11;61;1018;1029;11;87;2.0
11;62;1029;1034;5;87;2.0
11;63;1034;1038;4;87;2.0
11;64;1038;1064;26;87;2.0
11;65;1064;1073;9;87;2.0
11;66;1073;1078;5;87;2.0
11;67;1078;1098;20;87;2.0
11;68;1098;1103;5;87;2.0
11;69;1103;1110;7;87;2.0
11;70;1110;1124;14;87;2.0
11;71;1124;1162;38;87;2.0
11;72;1162;1186;24;87;2.0
11;73;1186;1228;42;87;2.0
11;74;1228;1233;5;87;2.0
11;75;1233;1282;49;87;2.0
11;76;1282;1291;9;87;2.0
11;77;1291;1329;38;87;2.0
11;78;1329;1354;25;87;2.0
11;79;1354;1402;48;87;2.0
11;80;1402;1404;2;87;2.0
11;81;1404;1419;15;87;2.0
11;82;1419;1434;15;87;2.0
11;83;1434;1449;15;87;2.0
11;84;1449;1464;15;87;2.0
11;85;1464;1479;15;87;2.0
11;86;1479;1494;15;87;2.0
11;87;1494;1509;15;87;2.0
11;88;1509;1524;15;87;2.0
11;89;1524;1539;15;87;2.0
11;90;1539;1554;15;87;2.0
11;91;1554;1569;15;87;2.0
11;92;1569;1584;15;87;2.0
11;93;1584;1599;15;87;2.0
11;94;1599;1614;15;87;2.0
11;95;1614;1629;15;87;2.0
11;96;1629;1644;15;87;2.0
11;97;1644;1659;15;87;2.0
11;98;1659;1680;21;87;2.0
12;0;246;337;91;72;2.0
12;1;337;340;3;72;2.0
12;2;340;354;14;72;2.0
12;3;354;355;1;72;2.0
12;4;355;360;5;72;2.0
12;5;360;364;4;72;2.0
12;6;364;380;16;72;2.0
12;7;380;384;4;72;2.0
12;8;384;389;5;72;2.0
12;9;389;395;6;72;2.0
12;10;395;410;15;72;2.0
12;11;410;414;4;72;2.0
12;12;414;424;10;72;2.0
12;13;424;427;3;72;2.0
12;14;427;437;10;72;2.0
12;15;437;444;7;72;2.0
12;16;444;455;11;72;2.0
12;17;455;456;1;72;2.0
12;18;456;459;3;72;2.0
12;19;459;470;11;72;2.0
12;20;470;479;9;72;2.0
12;21;479;485;6;72;2.0
12;22;485;506;21;72;2.0
12;23;506;507;1;72;2.0
12;24;507;519;12;72;2.0
12;25;519;544;25;72;2.0
12;26;544;594;50;72;2.0
12;27;594;602;8;72;2.0
12;28;602;624;22;72;2.0
12;29;624;634;10;72;2.0
12;30;634;664;30;72;2.0
12;31;664;686;22;72;2.0
12;32;686;722;36;72;2.0
12;33;722;729;7;72;2.0
12;34;729;744;15;72;2.0
12;35;744;754;10;72;2.0
12;36;754;757;3;72;2.0
12;37;757;799;42;72;2.0
12;38;799;827;28;72;2.0
12;39;827;837;10;72;2.0
12;40;837;841;4;72;2.0
12;41;841;854;13;72;2.0
12;42;854;869;15;72;2.0
12;43;869;874;5;72;2.0
12;44;874;882;8;72;2.0
12;45;882;884;2;72;2.0
12;46;884;892;8;72;2.0
12;47;892;904;12;72;2.0
12;48;904;907;3;72;2.0
12;49;907;914;7;72;2.0
12;50;914;929;15;72;2.0
12;51;929;934;5;72;2.0
12;52;934;937;3;72;2.0
12;53;937;949;12;72;2.0
12;54;949;952;3;72;2.0
12;55;952;964;12;72;2.0
12;56;964;967;3;72;2.0
12;57;967;974;7;72;2.0
12;58;974;985;11;72;2.0
12;59;985;997;12;72;2.0
12;60;997;1012;15;72;2.0
12;61;1012;1024;12;72;2.0
12;62;1024;1027;3;72;2.0
12;63;1027;1034;7;72;2.0
12;64;1034;1057;23;72;2.0
12;65;1057;1069;12;72;2.0
12;66;1069;1072;3;72;2.0
12;67;1072;1094;22;72;2.0
12;68;1094;1098;4;72;2.0
12;69;1098;1105;7;72;2.0
12;70;1105;1117;12;72;2.0
12;71;1117;1156;39;72;2.0
12;72;1156;1181;25;72;2.0
12;73;1181;1224;43;72;2.0
12;74;1224;1228;4;72;2.0
12;75;1228;1276;48;72;2.0
12;76;1276;1286;10;72;2.0
12;77;1286;1325;39;72;2.0
12;78;1325;1349;24;72;2.0
12;79;1349;1396;47;72;2.0
12;80;1396;1399;3;72;2.0
12;81;1399;1414;15;72;2.0
12;82;1414;1429;15;72;2.0
12;83;1429;1444;15;72;2.0
12;84;1444;1459;15;72;2.0
12;85;1459;1474;15;72;2.0
12;86;1474;1489;15;72;2.0
12;87;1489;1504;15;72;2.0
12;88;1504;1519;15;72;2.0
12;89;1519;1534;15;72;2.0
12;90;1534;1549;15;72;2.0
12;91;1549;1564;15;72;2.0
12;92;1564;1579;15;72;2.0
12;93;1579;1594;15;72;2.0
12;94;1594;1609;15;72;2.0
12;95;1609;1624;15;72;2.0
12;96;1624;1639;15;72;2.0
12;97;1639;1654;15;72;2.0
12;98;1654;1669;15;72;2.0
12;99;1669;1680;11;72;2.0
13;0;249;330;81;58;2.0
13;1;330;338;8;58;2.0
13;2;338;345;7;58;2.0
13;3;345;350;5;58;2.0
13;4;350;363;13;58;2.0
13;5;363;373;10;58;2.0
13;6;373;377;4;58;2.0
13;7;377;385;8;58;2.0
13;8;385;391;6;58;2.0
13;9;391;393;2;58;2.0
13;10;393;400;7;58;2.0
13;11;400;417;17;58;2.0
13;12;417;423;6;58;2.0
13;13;423;433;10;58;2.0
13;14;433;434;1;58;2.0
13;15;434;445;11;58;2.0
13;16;445;453;8;58;2.0
13;17;453;460;7;58;2.0
13;18;460;465;5;58;2.0
13;19;465;475;10;58;2.0
13;20;475;488;13;58;2.0
13;21;488;504;16;58;2.0
13;22;504;508;4;58;2.0
13;23;508;521;13;58;2.0
13;24;521;553;32;58;2.0
13;25;553;584;31;58;2.0
13;26;584;599;15;58;2.0
13;27;599;625;26;58;2.0
13;28;625;633;8;58;2.0
13;29;633;636;3;58;2.0
13;30;636;654;18;58;2.0
13;31;654;688;34;58;2.0
13;32;688;719;31;58;2.0
13;33;719;745;26;58;2.0
13;34;745;756;11;58;2.0
13;35;756;766;10;58;2.0
13;36;766;789;23;58;2.0
13;37;789;824;35;58;2.0
13;38;824;831;7;58;2.0
13;39;831;836;5;58;2.0
13;40;836;839;3;58;2.0
13;41;839;844;5;58;2.0
13;42;844;859;15;58;2.0
13;43;859;874;15;58;2.0
13;44;874;883;9;58;2.0
13;45;883;889;6;58;2.0
13;46;889;891;2;58;2.0
13;47;891;904;13;58;2.0
13;48;904;906;2;58;2.0
13;49;906;916;10;58;2.0
13;50;916;930;14;58;2.0
13;51;930;936;6;58;2.0
13;52;936;939;3;58;2.0
13;53;939;946;7;58;2.0
13;54;946;949;3;58;2.0
13;55;949;964;15;58;2.0
13;56;964;966;2;58;2.0
13;57;966;976;10;58;2.0
13;58;976;987;11;58;2.0
13;59;987;1006;19;58;2.0
13;60;1006;1009;3;58;2.0
13;61;1009;1024;15;58;2.0
13;62;1024;1026;2;58;2.0
13;63;1026;1036;10;58;2.0
13;64;1036;1059;23;58;2.0
13;65;1059;1066;7;58;2.0
13;66;1066;1069;3;58;2.0
13;67;1069;1095;26;58;2.0
13;68;1095;1100;5;58;2.0
13;69;1100;1107;7;58;2.0
13;70;1107;1126;19;58;2.0
13;71;1126;1153;27;58;2.0
13;72;1153;1183;30;58;2.0
13;73;1183;1225;42;58;2.0
13;74;1225;1230;5;58;2.0
13;75;1230;1273;43;58;2.0
13;76;1273;1288;15;58;2.0
13;77;1288;1315;27;58;2.0
13;78;1315;1351;36;58;2.0
13;79;1351;1393;42;58;2.0
13;80;1393;1401;8;58;2.0
13;81;1401;1416;15;58;2.0
13;82;1416;1431;15;58;2.0
13;83;1431;1446;15;58;2.0
13;84;1446;1461;15;58;2.0
13;85;1461;1476;15;58;2.0
13;86;1476;1491;15;58;2.0
13;87;1491;1506;15;58;2.0
13;88;1506;1521;15;58;2.0
13;89;1521;1536;15;58;2.0
13;90;1536;1551;15;58;2.0
13;91;1551;1566;15;58;2.0
13;92;1566;1581;15;58;2.0
13;93;1581;1596;15;58;2.0
13;94;1596;1611;15;58;2.0
13;95;1611;1626;15;58;2.0
13;96;1626;1641;15;58;2.0
13;97;1641;1656;15;58;2.0
13;98;1656;1680;24;58;2.0
14;0;257;336;79;115;2.0
14;1;336;350;14;115;2.0
14;2;350;365;15;115;2.0
14;3;365;370;5;115;2.0
14;4;370;380;10;115;2.0
14;5;380;384;4;115;2.0
14;6;384;396;12;115;2.0
14;7;396;400;4;115;2.0
14;8;400;405;5;115;2.0
14;9;405;420;15;115;2.0
14;10;420;430;10;115;2.0
14;11;430;437;7;115;2.0
14;12;437;440;3;115;2.0
14;13;440;441;1;115;2.0
14;14;441;458;17;115;2.0
14;15;458;460;2;115;2.0
14;16;460;465;5;115;2.0
14;17;465;472;7;115;2.0
14;18;472;480;8;115;2.0
14;19;480;495;15;115;2.0
14;20;495;511;16;115;2.0
14;21;511;513;2;115;2.0
14;22;513;526;13;115;2.0
14;23;526;560;34;115;2.0
14;24;560;604;44;115;2.0
14;25;604;606;2;115;2.0
14;26;606;623;17;115;2.0
14;27;623;640;17;115;2.0
14;28;640;641;1;115;2.0
14;29;641;674;33;115;2.0
14;30;674;693;19;115;2.0
14;31;693;726;33;115;2.0
14;32;726;739;13;115;2.0
14;33;739;743;4;115;2.0
14;34;743;761;18;115;2.0
14;35;761;773;12;115;2.0
14;36;773;809;36;115;2.0
14;37;809;831;22;115;2.0
14;38;831;843;12;115;2.0
14;39;843;844;1;115;2.0
14;40;844;851;7;115;2.0
14;41;851;864;13;115;2.0
14;42;864;879;15;115;2.0
14;43;879;890;11;115;2.0
14;44;890;894;4;115;2.0
14;45;894;896;2;115;2.0
14;46;896;898;2;115;2.0
14;47;898;911;13;115;2.0
14;48;911;923;12;115;2.0
14;49;923;924;1;115;2.0
14;50;924;928;4;115;2.0
14;51;928;941;13;115;2.0
14;52;941;953;12;115;2.0
14;53;953;956;3;115;2.0
14;54;956;959;3;115;2.0
14;55;959;971;12;115;2.0
14;56;971;983;12;115;2.0
14;57;983;984;1;115;2.0
14;58;984;992;8;115;2.0
14;59;992;1013;21;115;2.0
14;60;1013;1016;3;115;2.0
14;61;1016;1031;15;115;2.0
14;62;1031;1043;12;115;2.0
14;63;1043;1044;1;115;2.0
14;64;1044;1073;29;115;2.0
14;65;1073;1076;3;115;2.0
14;66;1076;1079;3;115;2.0
14;67;1079;1093;14;115;2.0
14;68;1093;1105;12;115;2.0
14;69;1105;1112;7;115;2.0
14;70;1112;1133;21;115;2.0
14;71;1133;1160;27;115;2.0
14;72;1160;1188;28;115;2.0
14;73;1188;1223;35;115;2.0
14;74;1223;1235;12;115;2.0
14;75;1235;1280;45;115;2.0
14;76;1280;1293;13;115;2.0
14;77;1293;1335;42;115;2.0
14;78;1335;1356;21;115;2.0
14;79;1356;1400;44;115;2.0
14;80;1400;1406;6;115;2.0
14;81;1406;1421;15;115;2.0
14;82;1421;1436;15;115;2.0
14;83;1436;1451;15;115;2.0
14;84;1451;1466;15;115;2.0
14;85;1466;1481;15;115;2.0
14;86;1481;1496;15;115;2.0
14;87;1496;1511;15;115;2.0
14;88;1511;1526;15;115;2.0
14;89;1526;1541;15;115;2.0
14;90;1541;1556;15;115;2.0
14;91;1556;1571;15;115;2.0
14;92;1571;1586;15;115;2.0
14;93;1586;1601;15;115;2.0
14;94;1601;1616;15;115;2.0
14;95;1616;1631;15;115;2.0
14;96;1631;1646;15;115;2.0
14;97;1646;1661;15;115;2.0
14;98;1661;1680;19;115;2.0
15;0;260;344;84;159;2.0
15;1;344;349;5;159;2.0
15;2;349;358;9;159;2.0
15;3;358;364;6;159;2.0
15;4;364;369;5;159;2.0
15;5;369;375;6;159;2.0
15;6;375;385;10;159;2.0
15;7;385;398;13;159;2.0
15;8;398;404;6;159;2.0
15;9;404;405;1;159;2.0
15;10;405;415;10;159;2.0
15;11;415;419;4;159;2.0
15;12;419;435;16;159;2.0
15;13;435;436;1;159;2.0
15;14;436;445;9;159;2.0
15;15;445;464;19;159;2.0
15;16;464;465;1;159;2.0
15;17;465;466;1;159;2.0
15;18;466;477;11;159;2.0
15;19;477;479;2;159;2.0
15;20;479;485;6;159;2.0
15;21;485;494;9;159;2.0
15;22;494;500;6;159;2.0
15;23;500;515;15;159;2.0
15;24;515;528;13;159;2.0
15;25;528;565;37;159;2.0
15;26;565;580;15;159;2.0
15;27;580;603;23;159;2.0
15;28;603;631;28;159;2.0
15;29;631;643;12;159;2.0
15;30;643;645;2;159;2.0
15;31;645;673;28;159;2.0
15;32;673;695;22;159;2.0
15;33;695;700;5;159;2.0
15;34;700;738;38;159;2.0
15;35;738;751;13;159;2.0
15;36;751;763;12;159;2.0
15;37;763;778;15;159;2.0
15;38;778;805;27;159;2.0
15;39;805;808;3;159;2.0
15;40;808;846;38;159;2.0
15;41;846;848;2;159;2.0
15;42;848;850;2;159;2.0
15;43;850;863;13;159;2.0
15;44;863;870;7;159;2.0
15;45;870;878;8;159;2.0
15;46;878;893;15;159;2.0
15;47;893;895;2;159;2.0
15;48;895;903;8;159;2.0
15;49;903;913;10;159;2.0
15;50;913;923;10;159;2.0
15;51;923;928;5;159;2.0
15;52;928;930;2;159;2.0
15;53;930;936;6;159;2.0
15;54;936;943;7;159;2.0
15;55;943;958;15;159;2.0
15;56;958;973;15;159;2.0
15;57;973;983;10;159;2.0
15;58;983;988;5;159;2.0
15;59;988;990;2;159;2.0
15;60;990;994;4;159;2.0
15;61;994;1018;24;159;2.0
15;62;1018;1033;15;159;2.0
15;63;1033;1043;10;159;2.0
15;64;1043;1048;5;159;2.0
15;65;1048;1050;2;159;2.0
15;66;1050;1078;28;159;2.0
15;67;1078;1101;23;159;2.0
15;68;1101;1107;6;159;2.0
15;69;1107;1114;7;159;2.0
15;70;1114;1134;20;159;2.0
15;71;1134;1138;4;159;2.0
15;72;1138;1190;52;159;2.0
15;73;1190;1231;41;159;2.0
15;74;1231;1237;6;159;2.0
15;75;1237;1254;17;159;2.0
15;76;1254;1295;41;159;2.0
15;77;1295;1334;39;159;2.0
15;78;1334;1358;24;159;2.0
15;79;1358;1374;16;159;2.0
15;80;1374;1408;34;159;2.0
15;81;1408;1423;15;159;2.0
15;82;1423;1438;15;159;2.0
15;83;1438;1453;15;159;2.0
15;84;1453;1468;15;159;2.0
15;85;1468;1483;15;159;2.0
15;86;1483;1498;15;159;2.0
15;87;1498;1513;15;159;2.0
15;88;1513;1528;15;159;2.0
15;89;1528;1543;15;159;2.0
15;90;1543;1558;15;159;2.0
15;91;1558;1573;15;159;2.0
15;92;1573;1588;15;159;2.0
15;93;1588;1603;15;159;2.0
15;94;1603;1618;15;159;2.0
15;95;1618;1633;15;159;2.0
15;96;1633;1648;15;159;2.0
15;97;1648;1680;32;159;2.0
16;0;247;325;78;14;2.0
16;1;325;342;17;14;2.0
16;2;342;357;15;14;2.0
16;3;357;362;5;14;2.0
16;4;362;364;2;14;2.0
16;5;364;374;10;14;2.0
16;6;374;376;2;14;2.0
16;7;376;388;12;14;2.0
16;8;388;394;6;14;2.0
16;9;394;397;3;14;2.0
16;10;397;412;15;14;2.0
16;11;412;424;12;14;2.0
16;12;424;429;5;14;2.0
16;13;429;433;4;14;2.0
16;14;433;434;1;14;2.0
16;15;434;447;13;14;2.0
16;16;447;454;7;14;2.0
16;17;454;457;3;14;2.0
16;18;457;466;9;14;2.0
16;19;466;472;6;14;2.0
16;20;472;487;15;14;2.0
16;21;487;489;2;14;2.0
16;22;489;503;14;14;2.0
16;23;503;505;2;14;2.0
16;24;505;518;13;14;2.0
16;25;518;554;36;14;2.0
16;26;554;596;42;14;2.0
16;27;596;598;2;14;2.0
16;28;598;612;14;14;2.0
16;29;612;633;21;14;2.0
16;30;633;634;1;14;2.0
16;31;634;666;32;14;2.0
16;32;666;685;19;14;2.0
16;33;685;718;33;14;2.0
16;34;718;731;13;14;2.0
16;35;731;732;1;14;2.0
16;36;732;753;21;14;2.0
16;37;753;767;14;14;2.0
16;38;767;801;34;14;2.0
16;39;801;823;22;14;2.0
16;40;823;836;13;14;2.0
16;41;836;837;1;14;2.0
16;42;837;843;6;14;2.0
16;43;843;856;13;14;2.0
16;44;856;871;15;14;2.0
16;45;871;884;13;14;2.0
16;46;884;886;2;14;2.0
16;47;886;888;2;14;2.0
16;48;888;892;4;14;2.0
16;49;892;903;11;14;2.0
16;50;903;916;13;14;2.0
16;51;916;917;1;14;2.0
16;52;917;933;16;14;2.0
16;53;933;947;14;14;2.0
16;54;947;948;1;14;2.0
16;55;948;951;3;14;2.0
16;56;951;963;12;14;2.0
16;57;963;976;13;14;2.0
16;58;976;977;1;14;2.0
16;59;977;984;7;14;2.0
16;60;984;1007;23;14;2.0
16;61;1007;1008;1;14;2.0
16;62;1008;1023;15;14;2.0
16;63;1023;1036;13;14;2.0
16;64;1036;1037;1;14;2.0
16;65;1037;1067;30;14;2.0
16;66;1067;1068;1;14;2.0
16;67;1068;1071;3;14;2.0
16;68;1071;1082;11;14;2.0
16;69;1082;1097;15;14;2.0
16;70;1097;1104;7;14;2.0
16;71;1104;1127;23;14;2.0
16;72;1127;1152;25;14;2.0
16;73;1152;1180;28;14;2.0
16;74;1180;1212;32;14;2.0
16;75;1212;1227;15;14;2.0
16;76;1227;1272;45;14;2.0
16;77;1272;1285;13;14;2.0
16;78;1285;1327;42;14;2.0
16;79;1327;1348;21;14;2.0
16;80;1348;1392;44;14;2.0
16;81;1392;1398;6;14;2.0
16;82;1398;1413;15;14;2.0
16;83;1413;1428;15;14;2.0
16;84;1428;1443;15;14;2.0
16;85;1443;1458;15;14;2.0
16;86;1458;1473;15;14;2.0
16;87;1473;1488;15;14;2.0
16;88;1488;1503;15;14;2.0
16;89;1503;1518;15;14;2.0
16;90;1518;1533;15;14;2.0
16;91;1533;1548;15;14;2.0
16;92;1548;1563;15;14;2.0
16;93;1563;1578;15;14;2.0
16;94;1578;1593;15;14;2.0
16;95;1593;1608;15;14;2.0
16;96;1608;1623;15;14;2.0
16;97;1623;1638;15;14;2.0
16;98;1638;1653;15;14;2.0
16;99;1653;1668;15;14;2.0
16;100;1668;1680;12;14;2.0
17;0;252;333;81;99;2.0
17;1;333;345;12;99;2.0
17;2;345;360;15;99;2.0
17;3;360;365;5;99;2.0
17;4;365;369;4;99;2.0
17;5;369;378;9;99;2.0
17;6;378;379;1;99;2.0
17;7;379;391;12;99;2.0
17;8;391;399;8;99;2.0
17;9;399;400;1;99;2.0
17;10;400;415;15;99;2.0
17;11;415;429;14;99;2.0
17;12;429;432;3;99;2.0
17;13;432;435;3;99;2.0
17;14;435;439;4;99;2.0
17;15;439;455;16;99;2.0
17;16;455;459;4;99;2.0
17;17;459;460;1;99;2.0
17;18;460;471;11;99;2.0
17;19;471;475;4;99;2.0
17;20;475;490;15;99;2.0
17;21;490;494;4;99;2.0
17;22;494;505;11;99;2.0
17;23;505;508;3;99;2.0
17;24;508;521;13;99;2.0
17;25;521;559;38;99;2.0
17;26;559;599;40;99;2.0
17;27;599;600;1;99;2.0
17;28;600;620;20;99;2.0
17;29;620;636;16;99;2.0
17;30;636;639;3;99;2.0
17;31;639;669;30;99;2.0
17;32;669;688;19;99;2.0
17;33;688;720;32;99;2.0
17;34;720;734;14;99;2.0
17;35;734;740;6;99;2.0
17;36;740;756;16;99;2.0
17;37;756;772;16;99;2.0
17;38;772;804;32;99;2.0
17;39;804;825;21;99;2.0
17;40;825;839;14;99;2.0
17;41;839;842;3;99;2.0
17;42;842;846;4;99;2.0
17;43;846;859;13;99;2.0
17;44;859;874;15;99;2.0
17;45;874;889;15;99;2.0
17;46;889;890;1;99;2.0
17;47;890;897;7;99;2.0
17;48;897;906;9;99;2.0
17;49;906;919;13;99;2.0
17;50;919;922;3;99;2.0
17;51;922;925;3;99;2.0
17;52;925;936;11;99;2.0
17;53;936;950;14;99;2.0
17;54;950;952;2;99;2.0
17;55;952;954;2;99;2.0
17;56;954;966;12;99;2.0
17;57;966;979;13;99;2.0
17;58;979;982;3;99;2.0
17;59;982;987;5;99;2.0
17;60;987;1010;23;99;2.0
17;61;1010;1012;2;99;2.0
17;62;1012;1026;14;99;2.0
17;63;1026;1039;13;99;2.0
17;64;1039;1042;3;99;2.0
17;65;1042;1070;28;99;2.0
17;66;1070;1072;2;99;2.0
17;67;1072;1074;2;99;2.0
17;68;1074;1090;16;99;2.0
17;69;1090;1100;10;99;2.0
17;70;1100;1107;7;99;2.0
17;71;1107;1132;25;99;2.0
17;72;1132;1154;22;99;2.0
17;73;1154;1183;29;99;2.0
17;74;1183;1220;37;99;2.0
17;75;1220;1230;10;99;2.0
17;76;1230;1274;44;99;2.0
17;77;1274;1288;14;99;2.0
17;78;1288;1330;42;99;2.0
17;79;1330;1351;21;99;2.0
17;80;1351;1394;43;99;2.0
17;81;1394;1401;7;99;2.0
17;82;1401;1416;15;99;2.0
17;83;1416;1431;15;99;2.0
17;84;1431;1446;15;99;2.0
17;85;1446;1461;15;99;2.0
17;86;1461;1476;15;99;2.0
17;87;1476;1491;15;99;2.0
17;88;1491;1506;15;99;2.0
17;89;1506;1521;15;99;2.0
17;90;1521;1536;15;99;2.0
17;91;1536;1551;15;99;2.0
17;92;1551;1566;15;99;2.0
17;93;1566;1581;15;99;2.0
17;94;1581;1596;15;99;2.0
17;95;1596;1611;15;99;2.0
17;96;1611;1626;15;99;2.0
17;97;1626;1641;15;99;2.0
17;98;1641;1656;15;99;2.0
17;99;1656;1680;24;99;2.0
18;0;246;337;91;501;2.0
18;1;337;339;2;501;2.0
18;2;339;354;15;501;2.0
18;3;354;357;3;501;2.0
18;4;357;359;2;501;2.0
18;5;359;367;8;501;2.0
18;6;367;378;11;501;2.0
18;7;378;387;9;501;2.0
18;8;387;388;1;501;2.0
18;9;388;394;6;501;2.0
18;10;394;409;15;501;2.0
18;11;409;417;8;501;2.0
18;12;417;426;9;501;2.0
18;13;426;427;1;501;2.0
18;14;427;435;8;501;2.0
18;15;435;447;12;501;2.0
18;16;447;454;7;501;2.0
18;17;454;459;5;501;2.0
18;18;459;469;10;501;2.0
18;19;469;482;13;501;2.0
18;20;482;484;2;501;2.0
18;21;484;505;21;501;2.0
18;22;505;518;13;501;2.0
18;23;518;547;29;501;2.0
18;24;547;593;46;501;2.0
18;25;593;600;7;501;2.0
18;26;600;624;24;501;2.0
18;27;624;627;3;501;2.0
18;28;627;633;6;501;2.0
18;29;633;663;30;501;2.0
18;30;663;685;22;501;2.0
18;31;685;720;35;501;2.0
18;32;720;728;8;501;2.0
18;33;728;744;16;501;2.0
18;34;744;753;9;501;2.0
18;35;753;760;7;501;2.0
18;36;760;798;38;501;2.0
18;37;798;825;27;501;2.0
18;38;825;830;5;501;2.0
18;39;830;836;6;501;2.0
18;40;836;840;4;501;2.0
18;41;840;853;13;501;2.0
18;42;853;868;15;501;2.0
18;43;868;877;9;501;2.0
18;44;877;883;6;501;2.0
18;45;883;885;2;501;2.0
18;46;885;890;5;501;2.0
18;47;890;903;13;501;2.0
18;48;903;910;7;501;2.0
18;49;910;913;3;501;2.0
18;50;913;929;16;501;2.0
18;51;929;933;4;501;2.0
18;52;933;940;7;501;2.0
18;53;940;948;8;501;2.0
18;54;948;950;2;501;2.0
18;55;950;963;13;501;2.0
18;56;963;970;7;501;2.0
18;57;970;973;3;501;2.0
18;58;973;984;11;501;2.0
18;59;984;1000;16;501;2.0
18;60;1000;1010;10;501;2.0
18;61;1010;1023;13;501;2.0
18;62;1023;1030;7;501;2.0
18;63;1030;1033;3;501;2.0
18;64;1033;1060;27;501;2.0
18;65;1060;1068;8;501;2.0
18;66;1068;1070;2;501;2.0
18;67;1070;1094;24;501;2.0
18;68;1094;1097;3;501;2.0
18;69;1097;1104;7;501;2.0
18;70;1104;1120;16;501;2.0
18;71;1120;1154;34;501;2.0
18;72;1154;1180;26;501;2.0
18;73;1180;1224;44;501;2.0
18;74;1224;1227;3;501;2.0
18;75;1227;1274;47;501;2.0
18;76;1274;1285;11;501;2.0
18;77;1285;1324;39;501;2.0
18;78;1324;1348;24;501;2.0
18;79;1348;1394;46;501;2.0
18;80;1394;1398;4;501;2.0
18;81;1398;1413;15;501;2.0
18;82;1413;1428;15;501;2.0
18;83;1428;1443;15;501;2.0
18;84;1443;1458;15;501;2.0
18;85;1458;1473;15;501;2.0
18;86;1473;1488;15;501;2.0
18;87;1488;1503;15;501;2.0
18;88;1503;1518;15;501;2.0
18;89;1518;1533;15;501;2.0
18;90;1533;1548;15;501;2.0
18;91;1548;1563;15;501;2.0
18;92;1563;1578;15;501;2.0
18;93;1578;1593;15;501;2.0
18;94;1593;1608;15;501;2.0
18;95;1608;1623;15;501;2.0
18;96;1623;1638;15;501;2.0
18;97;1638;1653;15;501;2.0
18;98;1653;1668;15;501;2.0
18;99;1668;1680;12;501;2.0
19;0;250;341;91;66;2.0
19;1;341;347;6;66;2.0
19;2;347;362;15;66;2.0
19;3;362;367;5;66;2.0
19;4;367;372;5;66;2.0
19;5;372;385;13;66;2.0
19;6;385;392;7;66;2.0
19;7;392;394;2;66;2.0
19;8;394;402;8;66;2.0
19;9;402;417;15;66;2.0
19;10;417;422;5;66;2.0
19;11;422;432;10;66;2.0
19;12;432;434;2;66;2.0
19;13;434;442;8;66;2.0
19;14;442;452;10;66;2.0
19;15;452;462;10;66;2.0
19;16;462;463;1;66;2.0
19;17;463;464;1;66;2.0
19;18;464;477;13;66;2.0
19;19;477;487;10;66;2.0
19;20;487;492;5;66;2.0
19;21;492;511;19;66;2.0
19;22;511;512;1;66;2.0
19;23;512;524;12;66;2.0
19;24;524;552;28;66;2.0
19;25;552;601;49;66;2.0
19;26;601;607;6;66;2.0
19;27;607;628;21;66;2.0
19;28;628;632;4;66;2.0
19;29;632;639;7;66;2.0
19;30;639;671;32;66;2.0
19;31;671;691;20;66;2.0
19;32;691;727;36;66;2.0
19;33;727;736;9;66;2.0
19;34;736;748;12;66;2.0
19;35;748;759;11;66;2.0
19;36;759;765;6;66;2.0
19;37;765;806;41;66;2.0
19;38;806;832;26;66;2.0
19;39;832;835;3;66;2.0
19;40;835;842;7;66;2.0
19;41;842;848;6;66;2.0
19;42;848;861;13;66;2.0
19;43;861;876;15;66;2.0
19;44;876;882;6;66;2.0
19;45;882;890;8;66;2.0
19;46;890;891;1;66;2.0
19;47;891;897;6;66;2.0
19;48;897;909;12;66;2.0
19;49;909;915;6;66;2.0
19;50;915;921;6;66;2.0
19;51;921;933;12;66;2.0
19;52;933;939;6;66;2.0
19;53;939;945;6;66;2.0
19;54;945;956;11;66;2.0
19;55;956;957;1;66;2.0
19;56;957;969;12;66;2.0
19;57;969;975;6;66;2.0
19;58;975;981;6;66;2.0
19;59;981;990;9;66;2.0
19;60;990;1005;15;66;2.0
19;61;1005;1017;12;66;2.0
19;62;1017;1029;12;66;2.0
19;63;1029;1035;6;66;2.0
19;64;1035;1041;6;66;2.0
19;65;1041;1065;24;66;2.0
19;66;1065;1076;11;66;2.0
19;67;1076;1077;1;66;2.0
19;68;1077;1098;21;66;2.0
19;69;1098;1103;5;66;2.0
19;70;1103;1110;7;66;2.0
19;71;1110;1125;15;66;2.0
19;72;1125;1161;36;66;2.0
19;73;1161;1186;25;66;2.0
19;74;1186;1228;42;66;2.0
19;75;1228;1233;5;66;2.0
19;76;1233;1281;48;66;2.0
19;77;1281;1291;10;66;2.0
19;78;1291;1332;41;66;2.0
19;79;1332;1354;22;66;2.0
19;80;1354;1401;47;66;2.0
19;81;1401;1404;3;66;2.0
19;82;1404;1419;15;66;2.0
19;83;1419;1434;15;66;2.0
19;84;1434;1449;15;66;2.0
19;85;1449;1464;15;66;2.0
19;86;1464;1479;15;66;2.0
19;87;1479;1494;15;66;2.0
19;88;1494;1509;15;66;2.0
19;89;1509;1524;15;66;2.0
19;90;1524;1539;15;66;2.0
19;91;1539;1554;15;66;2.0
19;92;1554;1569;15;66;2.0
19;93;1569;1584;15;66;2.0
19;94;1584;1599;15;66;2.0
19;95;1599;1614;15;66;2.0
19;96;1614;1629;15;66;2.0
19;97;1629;1644;15;66;2.0
19;98;1644;1659;15;66;2.0
19;99;1659;1680;21;66;2.0
20;0;252;343;91;63;2.0
20;1;343;349;6;63;2.0
20;2;349;364;15;63;2.0
20;3;364;369;5;63;2.0
20;4;369;374;5;63;2.0
20;5;374;387;13;63;2.0
20;6;387;394;7;63;2.0
20;7;394;396;2;63;2.0
20;8;396;404;8;63;2.0
20;9;404;419;15;63;2.0
20;10;419;424;5;63;2.0
20;11;424;434;10;63;2.0
20;12;434;436;2;63;2.0
20;13;436;444;8;63;2.0
20;14;444;454;10;63;2.0
20;15;454;464;10;63;2.0
20;16;464;465;1;63;2.0
20;17;465;466;1;63;2.0
20;18;466;479;13;63;2.0
20;19;479;489;10;63;2.0
20;20;489;494;5;63;2.0
20;21;494;513;19;63;2.0
20;22;513;514;1;63;2.0
20;23;514;526;12;63;2.0
20;24;526;554;28;63;2.0
20;25;554;603;49;63;2.0
20;26;603;609;6;63;2.0
20;27;609;630;21;63;2.0
20;28;630;634;4;63;2.0
20;29;634;641;7;63;2.0
20;30;641;673;32;63;2.0
20;31;673;693;20;63;2.0
20;32;693;729;36;63;2.0
20;33;729;738;9;63;2.0
20;34;738;750;12;63;2.0
20;35;750;761;11;63;2.0
20;36;761;767;6;63;2.0
20;37;767;808;41;63;2.0
20;38;808;834;26;63;2.0
20;39;834;837;3;63;2.0
20;40;837;844;7;63;2.0
20;41;844;850;6;63;2.0
20;42;850;863;13;63;2.0
20;43;863;878;15;63;2.0
20;44;878;884;6;63;2.0
20;45;884;892;8;63;2.0
20;46;892;893;1;63;2.0
20;47;893;899;6;63;2.0
20;48;899;911;12;63;2.0
20;49;911;917;6;63;2.0
20;50;917;923;6;63;2.0
20;51;923;935;12;63;2.0
20;52;935;941;6;63;2.0
20;53;941;947;6;63;2.0
20;54;947;958;11;63;2.0
20;55;958;959;1;63;2.0
20;56;959;971;12;63;2.0
20;57;971;977;6;63;2.0
20;58;977;983;6;63;2.0
20;59;983;992;9;63;2.0
20;60;992;1007;15;63;2.0
20;61;1007;1019;12;63;2.0
20;62;1019;1031;12;63;2.0
20;63;1031;1037;6;63;2.0
20;64;1037;1043;6;63;2.0
20;65;1043;1067;24;63;2.0
20;66;1067;1078;11;63;2.0
20;67;1078;1079;1;63;2.0
20;68;1079;1100;21;63;2.0
20;69;1100;1105;5;63;2.0
20;70;1105;1112;7;63;2.0
20;71;1112;1127;15;63;2.0
20;72;1127;1163;36;63;2.0
20;73;1163;1188;25;63;2.0
20;74;1188;1230;42;63;2.0
20;75;1230;1235;5;63;2.0
20;76;1235;1283;48;63;2.0
20;77;1283;1293;10;63;2.0
20;78;1293;1334;41;63;2.0
20;79;1334;1356;22;63;2.0
20;80;1356;1403;47;63;2.0
20;81;1403;1406;3;63;2.0
20;82;1406;1421;15;63;2.0
20;83;1421;1436;15;63;2.0
20;84;1436;1451;15;63;2.0
20;85;1451;1466;15;63;2.0
20;86;1466;1481;15;63;2.0
20;87;1481;1496;15;63;2.0
20;88;1496;1511;15;63;2.0
20;89;1511;1526;15;63;2.0
20;90;1526;1541;15;63;2.0
20;91;1541;1556;15;63;2.0
20;92;1556;1571;15;63;2.0
20;93;1571;1586;15;63;2.0
20;94;1586;1601;15;63;2.0
20;95;1601;1616;15;63;2.0
20;96;1616;1631;15;63;2.0
20;97;1631;1646;15;63;2.0
20;98;1646;1661;15;63;2.0
20;99;1661;1680;19;63;2.0
21;0;249;335;86;114;2.0
21;1;335;338;3;114;2.0
21;2;338;353;15;114;2.0
21;3;353;358;5;114;2.0
21;4;358;364;6;114;2.0
21;5;364;373;9;114;2.0
21;6;373;374;1;114;2.0
21;7;374;389;15;114;2.0
21;8;389;393;4;114;2.0
21;9;393;394;1;114;2.0
21;10;394;408;14;114;2.0
21;11;408;424;16;114;2.0
21;12;424;425;1;114;2.0
21;13;425;430;5;114;2.0
21;14;430;434;4;114;2.0
21;15;434;453;19;114;2.0
21;16;453;454;1;114;2.0
21;17;454;457;3;114;2.0
21;18;457;466;9;114;2.0
21;19;466;468;2;114;2.0
21;20;468;483;15;114;2.0
21;21;483;489;6;114;2.0
21;22;489;500;11;114;2.0
21;23;500;506;6;114;2.0
21;24;506;519;13;114;2.0
21;25;519;554;35;114;2.0
21;26;554;592;38;114;2.0
21;27;592;595;3;114;2.0
21;28;595;622;27;114;2.0
21;29;622;634;12;114;2.0
21;30;634;662;28;114;2.0
21;31;662;686;24;114;2.0
21;32;686;715;29;114;2.0
21;33;715;727;12;114;2.0
21;34;727;742;15;114;2.0
21;35;742;754;12;114;2.0
21;36;754;767;13;114;2.0
21;37;767;797;30;114;2.0
21;38;797;820;23;114;2.0
21;39;820;837;17;114;2.0
21;40;837;839;2;114;2.0
21;41;839;852;13;114;2.0
21;42;852;867;15;114;2.0
21;43;867;882;15;114;2.0
21;44;882;884;2;114;2.0
21;45;884;885;1;114;2.0
21;46;885;892;7;114;2.0
21;47;892;904;12;114;2.0
21;48;904;912;8;114;2.0
21;49;912;917;5;114;2.0
21;50;917;927;10;114;2.0
21;51;927;934;7;114;2.0
21;52;934;945;11;114;2.0
21;53;945;947;2;114;2.0
21;54;947;964;17;114;2.0
21;55;964;972;8;114;2.0
21;56;972;977;5;114;2.0
21;57;977;985;8;114;2.0
21;58;985;1005;20;114;2.0
21;59;1005;1007;2;114;2.0
21;60;1007;1024;17;114;2.0
21;61;1024;1032;8;114;2.0
21;62;1032;1037;5;114;2.0
21;63;1037;1065;28;114;2.0
21;64;1065;1067;2;114;2.0
21;65;1067;1092;25;114;2.0
21;66;1092;1098;6;114;2.0
21;67;1098;1105;7;114;2.0
21;68;1105;1127;22;114;2.0
21;69;1127;1149;22;114;2.0
21;70;1149;1181;32;114;2.0
21;71;1181;1222;41;114;2.0
21;72;1222;1228;6;114;2.0
21;73;1228;1269;41;114;2.0
21;74;1269;1286;17;114;2.0
21;75;1286;1323;37;114;2.0
21;76;1323;1349;26;114;2.0
21;77;1349;1389;40;114;2.0
21;78;1389;1399;10;114;2.0
21;79;1399;1414;15;114;2.0
21;80;1414;1429;15;114;2.0
21;81;1429;1444;15;114;2.0
21;82;1444;1459;15;114;2.0
21;83;1459;1474;15;114;2.0
21;84;1474;1489;15;114;2.0
21;85;1489;1504;15;114;2.0
21;86;1504;1519;15;114;2.0
21;87;1519;1534;15;114;2.0
21;88;1534;1549;15;114;2.0
21;89;1549;1564;15;114;2.0
21;90;1564;1579;15;114;2.0
21;91;1579;1594;15;114;2.0
21;92;1594;1609;15;114;2.0
21;93;1609;1624;15;114;2.0
21;94;1624;1639;15;114;2.0
21;95;1639;1654;15;114;2.0
21;96;1654;1669;15;114;2.0
21;97;1669;1680;11;114;2.0
22;0;243;332;89;42;2.0
22;1;332;339;7;42;2.0
22;2;339;354;15;42;2.0
22;3;354;359;5;42;2.0
22;4;359;361;2;42;2.0
22;5;361;371;10;42;2.0
22;6;371;374;3;42;2.0
22;7;374;383;9;42;2.0
22;8;383;391;8;42;2.0
22;9;391;394;3;42;2.0
22;10;394;409;15;42;2.0
22;11;409;421;12;42;2.0
22;12;421;426;5;42;2.0
22;13;426;431;5;42;2.0
22;14;431;451;20;42;2.0
22;15;451;454;3;42;2.0
22;16;454;463;9;42;2.0
22;17;463;469;6;42;2.0
22;18;469;484;15;42;2.0
22;19;484;486;2;42;2.0
22;20;486;500;14;42;2.0
22;21;500;501;1;42;2.0
22;22;501;513;12;42;2.0
22;23;513;551;38;42;2.0
22;24;551;593;42;42;2.0
22;25;593;596;3;42;2.0
22;26;596;619;23;42;2.0
22;27;619;628;9;42;2.0
22;28;628;631;3;42;2.0
22;29;631;663;32;42;2.0
22;30;663;680;17;42;2.0
22;31;680;716;36;42;2.0
22;32;716;728;12;42;2.0
22;33;728;739;11;42;2.0
22;34;739;748;9;42;2.0
22;35;748;764;16;42;2.0
22;36;764;798;34;42;2.0
22;37;798;821;23;42;2.0
22;38;821;831;10;42;2.0
22;39;831;834;3;42;2.0
22;40;834;840;6;42;2.0
22;41;840;853;13;42;2.0
22;42;853;868;15;42;2.0
22;43;868;881;13;42;2.0
22;44;881;883;2;42;2.0
22;45;883;886;3;42;2.0
22;46;886;889;3;42;2.0
22;47;889;898;9;42;2.0
22;48;898;913;15;42;2.0
22;49;913;914;1;42;2.0
22;50;914;924;10;42;2.0
22;51;924;928;4;42;2.0
22;52;928;944;16;42;2.0
22;53;944;946;2;42;2.0
22;54;946;948;2;42;2.0
22;55;948;958;10;42;2.0
22;56;958;973;15;42;2.0
22;57;973;974;1;42;2.0
22;58;974;979;5;42;2.0
22;59;979;1004;25;42;2.0
22;60;1004;1006;2;42;2.0
22;61;1006;1018;12;42;2.0
22;62;1018;1033;15;42;2.0
22;63;1033;1034;1;42;2.0
22;64;1034;1064;30;42;2.0
22;65;1064;1066;2;42;2.0
22;66;1066;1068;2;42;2.0
22;67;1068;1089;21;42;2.0
22;68;1089;1092;3;42;2.0
22;69;1092;1099;7;42;2.0
22;70;1099;1124;25;42;2.0
22;71;1124;1150;26;42;2.0
22;72;1150;1175;25;42;2.0
22;73;1175;1219;44;42;2.0
22;74;1219;1222;3;42;2.0
22;75;1222;1270;48;42;2.0
22;76;1270;1280;10;42;2.0
22;77;1280;1324;44;42;2.0
22;78;1324;1343;19;42;2.0
22;79;1343;1390;47;42;2.0
22;80;1390;1393;3;42;2.0
22;81;1393;1408;15;42;2.0
22;82;1408;1423;15;42;2.0
22;83;1423;1438;15;42;2.0
22;84;1438;1453;15;42;2.0
22;85;1453;1468;15;42;2.0
22;86;1468;1483;15;42;2.0
22;87;1483;1498;15;42;2.0
22;88;1498;1513;15;42;2.0
22;89;1513;1528;15;42;2.0
22;90;1528;1543;15;42;2.0
22;91;1543;1558;15;42;2.0
22;92;1558;1573;15;42;2.0
22;93;1573;1588;15;42;2.0
22;94;1588;1603;15;42;2.0
22;95;1603;1618;15;42;2.0
22;96;1618;1633;15;42;2.0
22;97;1633;1648;15;42;2.0
22;98;1648;1663;15;42;2.0
22;99;1663;1680;17;42;2.0
23;0;245;332;87;25;2.0
23;1;332;338;6;25;2.0
23;2;338;353;15;25;2.0
23;3;353;358;5;25;2.0
23;4;358;361;3;25;2.0
23;5;361;371;10;25;2.0
23;6;371;374;3;25;2.0
23;7;374;384;10;25;2.0
23;8;384;391;7;25;2.0
23;9;391;393;2;25;2.0
23;10;393;408;15;25;2.0
23;11;408;421;13;25;2.0
23;12;421;425;4;25;2.0
23;13;425;431;6;25;2.0
23;14;431;451;20;25;2.0
23;15;451;453;2;25;2.0
23;16;453;454;1;25;2.0
23;17;454;463;9;25;2.0
23;18;463;468;5;25;2.0
23;19;468;483;15;25;2.0
23;20;483;486;3;25;2.0
23;21;486;501;15;25;2.0
23;22;501;514;13;25;2.0
23;23;514;551;37;25;2.0
23;24;551;592;41;25;2.0
23;25;592;596;4;25;2.0
23;26;596;619;23;25;2.0
23;27;619;629;10;25;2.0
23;28;629;631;2;25;2.0
23;29;631;662;31;25;2.0
23;30;662;681;19;25;2.0
23;31;681;716;35;25;2.0
23;32;716;727;11;25;2.0
23;33;727;739;12;25;2.0
23;34;739;749;10;25;2.0
23;35;749;764;15;25;2.0
23;36;764;797;33;25;2.0
23;37;797;821;24;25;2.0
23;38;821;832;11;25;2.0
23;39;832;834;2;25;2.0
23;40;834;839;5;25;2.0
23;41;839;852;13;25;2.0
23;42;852;867;15;25;2.0
23;43;867;881;14;25;2.0
23;44;881;882;1;25;2.0
23;45;882;886;4;25;2.0
23;46;886;889;3;25;2.0
23;47;889;899;10;25;2.0
23;48;899;912;13;25;2.0
23;49;912;914;2;25;2.0
23;50;914;924;10;25;2.0
23;51;924;929;5;25;2.0
23;52;929;944;15;25;2.0
23;53;944;946;2;25;2.0
23;54;946;947;1;25;2.0
23;55;947;959;12;25;2.0
23;56;959;972;13;25;2.0
23;57;972;974;2;25;2.0
23;58;974;980;6;25;2.0
23;59;980;1004;24;25;2.0
23;60;1004;1006;2;25;2.0
23;61;1006;1019;13;25;2.0
23;62;1019;1032;13;25;2.0
23;63;1032;1034;2;25;2.0
23;64;1034;1064;30;25;2.0
23;65;1064;1066;2;25;2.0
23;66;1066;1067;1;25;2.0
23;67;1067;1089;22;25;2.0
23;68;1089;1093;4;25;2.0
23;69;1093;1100;7;25;2.0
23;70;1100;1124;24;25;2.0
23;71;1124;1150;26;25;2.0
23;72;1150;1176;26;25;2.0
23;73;1176;1219;43;25;2.0
23;74;1219;1223;4;25;2.0
23;75;1223;1270;47;25;2.0
23;76;1270;1281;11;25;2.0
23;77;1281;1323;42;25;2.0
23;78;1323;1344;21;25;2.0
23;79;1344;1390;46;25;2.0
23;80;1390;1394;4;25;2.0
23;81;1394;1409;15;25;2.0
23;82;1409;1424;15;25;2.0
23;83;1424;1439;15;25;2.0
23;84;1439;1454;15;25;2.0
23;85;1454;1469;15;25;2.0
23;86;1469;1484;15;25;2.0
23;87;1484;1499;15;25;2.0
23;88;1499;1514;15;25;2.0
23;89;1514;1529;15;25;2.0
23;90;1529;1544;15;25;2.0
23;91;1544;1559;15;25;2.0
23;92;1559;1574;15;25;2.0
23;93;1574;1589;15;25;2.0
23;94;1589;1604;15;25;2.0
23;95;1604;1619;15;25;2.0
23;96;1619;1634;15;25;2.0
23;97;1634;1649;15;25;2.0
23;98;1649;1664;15;25;2.0
23;99;1664;1680;16;25;2.0
24;0;240;333;93;0;0.83
24;1;333;339;6;0;0.83
24;2;339;354;15;0;0.83
24;3;354;359;5;0;0.83
24;4;359;369;10;0;0.83
24;5;369;378;9;0;0.83
24;6;378;386;8;0;0.83
24;7;386;389;3;0;0.83
24;8;389;394;5;0;0.83
24;9;394;409;15;0;0.83
24;10;409;419;10;0;0.83
24;11;419;426;7;0;0.83
24;12;426;429;3;0;0.83
24;13;429;435;6;0;0.83
24;14;435;449;14;0;0.83
24;15;449;454;5;0;0.83
24;16;454;455;1;0;0.83
24;17;455;461;6;0;0.83
24;18;461;469;8;0;0.83
24;19;469;484;15;0;0.83
24;20;484;503;19;0;0.83
24;21;503;505;2;0;0.83
24;22;505;516;11;0;0.83
24;23;516;549;33;0;0.83
24;24;549;593;44;0;0.83
24;25;593;600;7;0;0.83
24;26;600;620;20;0;0.83
24;27;620;629;9;0;0.83
24;28;629;631;2;0;0.83
24;29;631;663;32;0;0.83
24;30;663;683;20;0;0.83
24;31;683;720;37;0;0.83
24;32;720;728;8;0;0.83
24;33;728;740;12;0;0.83
24;34;740;751;11;0;0.83
24;35;751;762;11;0;0.83
24;36;762;798;36;0;0.83
24;37;798;825;27;0;0.83
24;38;825;832;7;0;0.83
24;39;832;834;2;0;0.83
24;40;834;840;6;0;0.83
24;41;840;853;13;0;0.83
24;42;853;868;15;0;0.83
24;43;868;879;11;0;0.83
24;44;879;883;4;0;0.83
24;45;883;887;4;0;0.83
24;46;887;890;3;0;0.83
24;47;890;901;11;0;0.83
24;48;901;912;11;0;0.83
24;49;912;913;1;0;0.83
24;50;913;925;12;0;0.83
24;51;925;931;6;0;0.83
24;52;931;942;11;0;0.83
24;53;942;948;6;0;0.83
24;54;948;950;2;0;0.83
24;55;950;961;11;0;0.83
24;56;961;972;11;0;0.83
24;57;972;973;1;0;0.83
24;58;973;982;9;0;0.83
24;59;982;1002;20;0;0.83
24;60;1002;1010;8;0;0.83
24;61;1010;1021;11;0;0.83
24;62;1021;1032;11;0;0.83
24;63;1032;1033;1;0;0.83
24;64;1033;1062;29;0;0.83
24;65;1062;1068;6;0;0.83
24;66;1068;1070;2;0;0.83
24;67;1070;1090;20;0;0.83
24;68;1090;1095;5;0;0.83
24;69;1095;1102;7;0;0.83
24;70;1102;1122;20;0;0.83
24;71;1122;1154;32;0;0.83
24;72;1154;1178;24;0;0.83
24;73;1178;1220;42;0;0.83
24;74;1220;1225;5;0;0.83
24;75;1225;1274;49;0;0.83
24;76;1274;1283;9;0;0.83
24;77;1283;1324;41;0;0.83
24;78;1324;1346;22;0;0.83
24;79;1346;1394;48;0;0.83
24;80;1394;1396;2;0;0.83
24;81;1396;1411;15;0;0.83
24;82;1411;1426;15;0;0.83
24;83;1426;1441;15;0;0.83
24;84;1441;1456;15;0;0.83
24;85;1456;1471;15;0;0.83
24;86;1471;1486;15;0;0.83
24;87;1486;1501;15;0;0.83
24;88;1501;1516;15;0;0.83
24;89;1516;1531;15;0;0.83
24;90;1531;1546;15;0;0.83
24;91;1546;1561;15;0;0.83
24;92;1561;1576;15;0;0.83
24;93;1576;1591;15;0;0.83
24;94;1591;1606;15;0;0.83
24;95;1606;1621;15;0;0.83
24;96;1621;1636;15;0;0.83
24;97;1636;1651;15;0;0.83
24;98;1651;1666;15;0;0.83
24;99;1666;1680;14;0;0.83
25;0;240;333;93;0;0.83
25;1;333;339;6;0;0.83
25;2;339;354;15;0;0.83
25;3;354;359;5;0;0.83
25;4;359;369;10;0;0.83
25;5;369;378;9;0;0.83
25;6;378;386;8;0;0.83
25;7;386;389;3;0;0.83
25;8;389;394;5;0;0.83
25;9;394;409;15;0;0.83
25;10;409;419;10;0;0.83
25;11;419;426;7;0;0.83
25;12;426;429;3;0;0.83
25;13;429;435;6;0;0.83
25;14;435;449;14;0;0.83
25;15;449;454;5;0;0.83
25;16;454;455;1;0;0.83
25;17;455;461;6;0;0.83
25;18;461;469;8;0;0.83
25;19;469;484;15;0;0.83
25;20;484;503;19;0;0.83
25;21;503;505;2;0;0.83
25;22;505;516;11;0;0.83
25;23;516;549;33;0;0.83
25;24;549;593;44;0;0.83
25;25;593;600;7;0;0.83
25;26;600;620;20;0;0.83
25;27;620;629;9;0;0.83
25;28;629;631;2;0;0.83
25;29;631;663;32;0;0.83
25;30;663;683;20;0;0.83
25;31;683;720;37;0;0.83
25;32;720;728;8;0;0.83
25;33;728;740;12;0;0.83
25;34;740;751;11;0;0.83
25;35;751;762;11;0;0.83
25;36;762;798;36;0;0.83
25;37;798;825;27;0;0.83
25;38;825;832;7;0;0.83
25;39;832;834;2;0;0.83
25;40;834;840;6;0;0.83
25;41;840;853;13;0;0.83
25;42;853;868;15;0;0.83
25;43;868;879;11;0;0.83
25;44;879;883;4;0;0.83
25;45;883;887;4;0;0.83
25;46;887;890;3;0;0.83
25;47;890;901;11;0;0.83
25;48;901;912;11;0;0.83
25;49;912;913;1;0;0.83
25;50;913;925;12;0;0.83
25;51;925;931;6;0;0.83
25;52;931;942;11;0;0.83
25;53;942;948;6;0;0.83
25;54;948;950;2;0;0.83
25;55;950;961;11;0;0.83
25;56;961;972;11;0;0.83
25;57;972;973;1;0;0.83
25;58;973;982;9;0;0.83
25;59;982;1002;20;0;0.83
25;60;1002;1010;8;0;0.83
25;61;1010;1021;11;0;0.83
25;62;1021;1032;11;0;0.83
25;63;1032;1033;1;0;0.83
25;64;1033;1062;29;0;0.83
25;65;1062;1068;6;0;0.83
25;66;1068;1070;2;0;0.83
25;67;1070;1090;20;0;0.83
25;68;1090;1095;5;0;0.83
25;69;1095;1102;7;0;0.83
25;70;1102;1122;20;0;0.83
25;71;1122;1154;32;0;0.83
25;72;1154;1178;24;0;0.83
25;73;1178;1220;42;0;0.83
25;74;1220;1225;5;0;0.83
25;75;1225;1274;49;0;0.83
25;76;1274;1283;9;0;0.83
25;77;1283;1324;41;0;0.83
25;78;1324;1346;22;0;0.83
25;79;1346;1394;48;0;0.83
25;80;1394;1396;2;0;0.83
25;81;1396;1411;15;0;0.83
25;82;1411;1426;15;0;0.83
25;83;1426;1441;15;0;0.83
25;84;1441;1456;15;0;0.83
25;85;1456;1471;15;0;0.83
25;86;1471;1486;15;0;0.83
25;87;1486;1501;15;0;0.83
25;88;1501;1516;15;0;0.83
25;89;1516;1531;15;0;0.83
25;90;1531;1546;15;0;0.83
25;91;1546;1561;15;0;0.83
25;92;1561;1576;15;0;0.83
25;93;1576;1591;15;0;0.83
25;94;1591;1606;15;0;0.83
25;95;1606;1621;15;0;0.83
25;96;1621;1636;15;0;0.83
25;97;1636;1651;15;0;0.83
25;98;1651;1666;15;0;0.83
25;99;1666;1680;14;0;0.83
26;0;240;333;93;0;0.83
26;1;333;339;6;0;0.83
26;2;339;354;15;0;0.83
26;3;354;359;5;0;0.83
26;4;359;369;10;0;0.83
26;5;369;378;9;0;0.83
26;6;378;386;8;0;0.83
26;7;386;389;3;0;0.83
26;8;389;394;5;0;0.83
26;9;394;409;15;0;0.83
26;10;409;419;10;0;0.83
26;11;419;426;7;0;0.83
26;12;426;429;3;0;0.83
26;13;429;435;6;0;0.83
26;14;435;449;14;0;0.83
26;15;449;454;5;0;0.83
26;16;454;455;1;0;0.83
26;17;455;461;6;0;0.83
26;18;461;469;8;0;0.83
26;19;469;484;15;0;0.83
26;20;484;503;19;0;0.83
26;21;503;505;2;0;0.83
26;22;505;516;11;0;0.83
26;23;516;549;33;0;0.83
26;24;549;593;44;0;0.83
26;25;593;600;7;0;0.83
26;26;600;620;20;0;0.83
26;27;620;629;9;0;0.83
26;28;629;631;2;0;0.83
26;29;631;663;32;0;0.83
26;30;663;683;20;0;0.83
26;31;683;720;37;0;0.83
26;32;720;728;8;0;0.83
26;33;728;740;12;0;0.83
26;34;740;751;11;0;0.83
26;35;751;762;11;0;0.83
26;36;762;798;36;0;0.83
26;37;798;825;27;0;0.83
26;38;825;832;7;0;0.83
26;39;832;834;2;0;0.83
26;40;834;840;6;0;0.83
26;41;840;853;13;0;0.83
26;42;853;868;15;0;0.83
26;43;868;879;11;0;0.83
26;44;879;883;4;0;0.83
26;45;883;887;4;0;0.83
26;46;887;890;3;0;0.83
26;47;890;901;11;0;0.83
26;48;901;912;11;0;0.83
26;49;912;913;1;0;0.83
26;50;913;925;12;0;0.83
26;51;925;931;6;0;0.83
26;52;931;942;11;0;0.83
26;53;942;948;6;0;0.83
26;54;948;950;2;0;0.83
26;55;950;961;11;0;0.83
26;56;961;972;11;0;0.83
26;57;972;973;1;0;0.83
26;58;973;982;9;0;0.83
26;59;982;1002;20;0;0.83
26;60;1002;1010;8;0;0.83
26;61;1010;1021;11;0;0.83
26;62;1021;1032;11;0;0.83
26;63;1032;1033;1;0;0.83
26;64;1033;1062;29;0;0.83
26;65;1062;1068;6;0;0.83
26;66;1068;1070;2;0;0.83
26;67;1070;1090;20;0;0.83
26;68;1090;1095;5;0;0.83
26;69;1095;1102;7;0;0.83
26;70;1102;1122;20;0;0.83
26;71;1122;1154;32;0;0.83
26;72;1154;1178;24;0;0.83
26;73;1178;1220;42;0;0.83
26;74;1220;1225;5;0;0.83
26;75;1225;1274;49;0;0.83
26;76;1274;1283;9;0;0.83
26;77;1283;1324;41;0;0.83
26;78;1324;1346;22;0;0.83
26;79;1346;1394;48;0;0.83
26;80;1394;1396;2;0;0.83
26;81;1396;1411;15;0;0.83
26;82;1411;1426;15;0;0.83
26;83;1426;1441;15;0;0.83
26;84;1441;1456;15;0;0.83
26;85;1456;1471;15;0;0.83
26;86;1471;1486;15;0;0.83
26;87;1486;1501;15;0;0.83
26;88;1501;1516;15;0;0.83
26;89;1516;1531;15;0;0.83
26;90;1531;1546;15;0;0.83
26;91;1546;1561;15;0;0.83
26;92;1561;1576;15;0;0.83
26;93;1576;1591;15;0;0.83
26;94;1591;1606;15;0;0.83
26;95;1606;1621;15;0;0.83
26;96;1621;1636;15;0;0.83
26;97;1636;1651;15;0;0.83
26;98;1651;1666;15;0;0.83
26;99;1666;1680;14;0;0.83
27;0;240;333;93;0;0.83
27;1;333;339;6;0;0.83
27;2;339;354;15;0;0.83
27;3;354;359;5;0;0.83
27;4;359;369;10;0;0.83
27;5;369;378;9;0;0.83
27;6;378;386;8;0;0.83
27;7;386;389;3;0;0.83
27;8;389;394;5;0;0.83
27;9;394;409;15;0;0.83
27;10;409;419;10;0;0.83
27;11;419;426;7;0;0.83
27;12;426;429;3;0;0.83
27;13;429;435;6;0;0.83
27;14;435;449;14;0;0.83
27;15;449;454;5;0;0.83
27;16;454;455;1;0;0.83
27;17;455;461;6;0;0.83
27;18;461;469;8;0;0.83
27;19;469;484;15;0;0.83
27;20;484;503;19;0;0.83
27;21;503;505;2;0;0.83
27;22;505;516;11;0;0.83
27;23;516;549;33;0;0.83
27;24;549;593;44;0;0.83
27;25;593;600;7;0;0.83
27;26;600;620;20;0;0.83
27;27;620;629;9;0;0.83
27;28;629;631;2;0;0.83
27;29;631;663;32;0;0.83
27;30;663;683;20;0;0.83
27;31;683;720;37;0;0.83
27;32;720;728;8;0;0.83
27;33;728;740;12;0;0.83
27;34;740;751;11;0;0.83
27;35;751;762;11;0;0.83
27;36;762;798;36;0;0.83
27;37;798;825;27;0;0.83
27;38;825;832;7;0;0.83
27;39;832;834;2;0;0.83
27;40;834;840;6;0;0.83
27;41;840;853;13;0;0.83
27;42;853;868;15;0;0.83
27;43;868;879;11;0;0.83
27;44;879;883;4;0;0.83
27;45;883;887;4;0;0.83
27;46;887;890;3;0;0.83
27;47;890;901;11;0;0.83
27;48;901;912;11;0;0.83
27;49;912;913;1;0;0.83
27;50;913;925;12;0;0.83
27;51;925;931;6;0;0.83
27;52;931;942;11;0;0.83
27;53;942;948;6;0;0.83
27;54;948;950;2;0;0.83
27;55;950;961;11;0;0.83
27;56;961;972;11;0;0.83
27;57;972;973;1;0;0.83
27;58;973;982;9;0;0.83
27;59;982;1002;20;0;0.83
27;60;1002;1010;8;0;0.83
27;61;1010;1021;11;0;0.83
27;62;1021;1032;11;0;0.83
27;63;1032;1033;1;0;0.83
27;64;1033;1062;29;0;0.83
27;65;1062;1068;6;0;0.83
27;66;1068;1070;2;0;0.83
27;67;1070;1090;20;0;0.83
27;68;1090;1095;5;0;0.83
27;69;1095;1102;7;0;0.83
27;70;1102;1122;20;0;0.83
27;71;1122;1154;32;0;0.83
27;72;1154;1178;24;0;0.83
27;73;1178;1220;42;0;0.83
27;74;1220;1225;5;0;0.83
27;75;1225;1274;49;0;0.83
27;76;1274;1283;9;0;0.83
27;77;1283;1324;41;0;0.83
27;78;1324;1346;22;0;0.83
27;79;1346;1394;48;0;0.83
27;80;1394;1396;2;0;0.83
27;81;1396;1411;15;0;0.83
27;82;1411;1426;15;0;0.83
27;83;1426;1441;15;0;0.83
27;84;1441;1456;15;0;0.83
27;85;1456;1471;15;0;0.83
27;86;1471;1486;15;0;0.83
27;87;1486;1501;15;0;0.83
27;88;1501;1516;15;0;0.83
27;89;1516;1531;15;0;0.83
27;90;1531;1546;15;0;0.83
27;91;1546;1561;15;0;0.83
27;92;1561;1576;15;0;0.83
27;93;1576;1591;15;0;0.83
27;94;1591;1606;15;0;0.83
27;95;1606;1621;15;0;0.83
27;96;1621;1636;15;0;0.83
27;97;1636;1651;15;0;0.83
27;98;1651;1666;15;0;0.83
27;99;1666;1680;14;0;0.83
28;0;240;333;93;0;0.83
28;1;333;339;6;0;0.83
28;2;339;354;15;0;0.83
28;3;354;359;5;0;0.83
28;4;359;369;10;0;0.83
28;5;369;378;9;0;0.83
28;6;378;386;8;0;0.83
28;7;386;389;3;0;0.83
28;8;389;394;5;0;0.83
28;9;394;409;15;0;0.83
28;10;409;419;10;0;0.83
28;11;419;426;7;0;0.83
28;12;426;429;3;0;0.83
28;13;429;435;6;0;0.83
28;14;435;449;14;0;0.83
28;15;449;454;5;0;0.83
28;16;454;455;1;0;0.83
28;17;455;461;6;0;0.83
28;18;461;469;8;0;0.83
28;19;469;484;15;0;0.83
28;20;484;503;19;0;0.83
28;21;503;505;2;0;0.83
28;22;505;516;11;0;0.83
28;23;516;549;33;0;0.83
28;24;549;593;44;0;0.83
28;25;593;600;7;0;0.83
28;26;600;620;20;0;0.83
28;27;620;629;9;0;0.83
28;28;629;631;2;0;0.83
28;29;631;663;32;0;0.83
28;30;663;683;20;0;0.83
28;31;683;720;37;0;0.83
28;32;720;728;8;0;0.83
28;33;728;740;12;0;0.83
28;34;740;751;11;0;0.83
28;35;751;762;11;0;0.83
28;36;762;798;36;0;0.83
28;37;798;825;27;0;0.83
28;38;825;832;7;0;0.83
28;39;832;834;2;0;0.83
28;40;834;840;6;0;0.83
28;41;840;853;13;0;0.83
28;42;853;868;15;0;0.83
28;43;868;879;11;0;0.83
28;44;879;883;4;0;0.83
28;45;883;887;4;0;0.83
28;46;887;890;3;0;0.83
28;47;890;901;11;0;0.83
28;48;901;912;11;0;0.83
28;49;912;913;1;0;0.83
28;50;913;925;12;0;0.83
28;51;925;931;6;0;0.83
28;52;931;942;11;0;0.83
28;53;942;948;6;0;0.83
28;54;948;950;2;0;0.83
28;55;950;961;11;0;0.83
28;56;961;972;11;0;0.83
28;57;972;973;1;0;0.83
28;58;973;982;9;0;0.83
28;59;982;1002;20;0;0.83
28;60;1002;1010;8;0;0.83
28;61;1010;1021;11;0;0.83
28;62;1021;1032;11;0;0.83
28;63;1032;1033;1;0;0.83
28;64;1033;1062;29;0;0.83
28;65;1062;1068;6;0;0.83
28;66;1068;1070;2;0;0.83
28;67;1070;1090;20;0;0.83
28;68;1090;1095;5;0;0.83
28;69;1095;1102;7;0;0.83
28;70;1102;1122;20;0;0.83
28;71;1122;1154;32;0;0.83
28;72;1154;1178;24;0;0.83
28;73;1178;1220;42;0;0.83
28;74;1220;1225;5;0;0.83
28;75;1225;1274;49;0;0.83
28;76;1274;1283;9;0;0.83
28;77;1283;1324;41;0;0.83
28;78;1324;1346;22;0;0.83
28;79;1346;1394;48;0;0.83
28;80;1394;1396;2;0;0.83
28;81;1396;1411;15;0;0.83
28;82;1411;1426;15;0;0.83
28;83;1426;1441;15;0;0.83
28;84;1441;1456;15;0;0.83
28;85;1456;1471;15;0;0.83
28;86;1471;1486;15;0;0.83
28;87;1486;1501;15;0;0.83
28;88;1501;1516;15;0;0.83
28;89;1516;1531;15;0;0.83
28;90;1531;1546;15;0;0.83
28;91;1546;1561;15;0;0.83
28;92;1561;1576;15;0;0.83
28;93;1576;1591;15;0;0.83
28;94;1591;1606;15;0;0.83
28;95;1606;1621;15;0;0.83
28;96;1621;1636;15;0;0.83
28;97;1636;1651;15;0;0.83
28;98;1651;1666;15;0;0.83
28;99;1666;1680;14;0;0.83
29;0;240;333;93;0;2.0
29;1;333;339;6;0;2.0
29;2;339;354;15;0;2.0
29;3;354;359;5;0;2.0
29;4;359;369;10;0;2.0
29;5;369;378;9;0;2.0
29;6;378;386;8;0;2.0
29;7;386;389;3;0;2.0
29;8;389;394;5;0;2.0
29;9;394;409;15;0;2.0
29;10;409;419;10;0;2.0
29;11;419;426;7;0;2.0
29;12;426;429;3;0;2.0
29;13;429;435;6;0;2.0
29;14;435;449;14;0;2.0
29;15;449;454;5;0;2.0
29;16;454;455;1;0;2.0
29;17;455;461;6;0;2.0
29;18;461;469;8;0;2.0
29;19;469;484;15;0;2.0
29;20;484;503;19;0;2.0
29;21;503;505;2;0;2.0
29;22;505;516;11;0;2.0
29;23;516;549;33;0;2.0
29;24;549;593;44;0;2.0
29;25;593;600;7;0;2.0
29;26;600;620;20;0;2.0
29;27;620;629;9;0;2.0
29;28;629;631;2;0;2.0
29;29;631;663;32;0;2.0
29;30;663;683;20;0;2.0
29;31;683;720;37;0;2.0
29;32;720;728;8;0;2.0
29;33;728;740;12;0;2.0
29;34;740;751;11;0;2.0
29;35;751;762;11;0;2.0
29;36;762;798;36;0;2.0
29;37;798;825;27;0;2.0
29;38;825;832;7;0;2.0
29;39;832;834;2;0;2.0
29;40;834;840;6;0;2.0
29;41;840;853;13;0;2.0
29;42;853;868;15;0;2.0
29;43;868;879;11;0;2.0
29;44;879;883;4;0;2.0
29;45;883;887;4;0;2.0
29;46;887;890;3;0;2.0
29;47;890;901;11;0;2.0
29;48;901;912;11;0;2.0
29;49;912;913;1;0;2.0
29;50;913;925;12;0;2.0
29;51;925;931;6;0;2.0
29;52;931;942;11;0;2.0
29;53;942;948;6;0;2.0
29;54;948;950;2;0;2.0
29;55;950;961;11;0;2.0
29;56;961;972;11;0;2.0
29;57;972;973;1;0;2.0
29;58;973;982;9;0;2.0
29;59;982;1002;20;0;2.0
29;60;1002;1010;8;0;2.0
29;61;1010;1021;11;0;2.0
29;62;1021;1032;11;0;2.0
29;63;1032;1033;1;0;2.0
29;64;1033;1062;29;0;2.0
29;65;1062;1068;6;0;2.0
29;66;1068;1070;2;0;2.0
29;67;1070;1090;20;0;2.0
29;68;1090;1095;5;0;2.0
29;69;1095;1102;7;0;2.0
29;70;1102;1122;20;0;2.0
29;71;1122;1154;32;0;2.0
29;72;1154;1178;24;0;2.0
29;73;1178;1220;42;0;2.0
29;74;1220;1225;5;0;2.0
29;75;1225;1274;49;0;2.0
29;76;1274;1283;9;0;2.0
29;77;1283;1324;41;0;2.0
29;78;1324;1346;22;0;2.0
29;79;1346;1394;48;0;2.0
29;80;1394;1396;2;0;2.0
29;81;1396;1411;15;0;2.0
29;82;1411;1426;15;0;2.0
29;83;1426;1441;15;0;2.0
29;84;1441;1456;15;0;2.0
29;85;1456;1471;15;0;2.0
29;86;1471;1486;15;0;2.0
29;87;1486;1501;15;0;2.0
29;88;1501;1516;15;0;2.0
29;89;1516;1531;15;0;2.0
29;90;1531;1546;15;0;2.0
29;91;1546;1561;15;0;2.0
29;92;1561;1576;15;0;2.0
29;93;1576;1591;15;0;2.0
29;94;1591;1606;15;0;2.0
29;95;1606;1621;15;0;2.0
29;96;1621;1636;15;0;2.0
29;97;1636;1651;15;0;2.0
29;98;1651;1666;15;0;2.0
29;99;1666;1680;14;0;2.0
30;0;240;333;93;0;2.0
30;1;333;339;6;0;2.0
30;2;339;354;15;0;2.0
30;3;354;359;5;0;2.0
30;4;359;369;10;0;2.0
30;5;369;378;9;0;2.0
30;6;378;386;8;0;2.0
30;7;386;389;3;0;2.0
30;8;389;394;5;0;2.0
30;9;394;409;15;0;2.0
30;10;409;419;10;0;2.0
30;11;419;426;7;0;2.0
30;12;426;429;3;0;2.0
30;13;429;435;6;0;2.0
30;14;435;449;14;0;2.0
30;15;449;454;5;0;2.0
30;16;454;455;1;0;2.0
30;17;455;461;6;0;2.0
30;18;461;469;8;0;2.0
30;19;469;484;15;0;2.0
30;20;484;503;19;0;2.0
30;21;503;505;2;0;2.0
30;22;505;516;11;0;2.0
30;23;516;549;33;0;2.0
30;24;549;593;44;0;2.0
30;25;593;600;7;0;2.0
30;26;600;620;20;0;2.0
30;27;620;629;9;0;2.0
30;28;629;631;2;0;2.0
30;29;631;663;32;0;2.0
30;30;663;683;20;0;2.0
30;31;683;720;37;0;2.0
30;32;720;728;8;0;2.0
30;33;728;740;12;0;2.0
30;34;740;751;11;0;2.0
30;35;751;762;11;0;2.0
30;36;762;798;36;0;2.0
30;37;798;825;27;0;2.0
30;38;825;832;7;0;2.0
30;39;832;834;2;0;2.0
30;40;834;840;6;0;2.0
30;41;840;853;13;0;2.0
30;42;853;868;15;0;2.0
30;43;868;879;11;0;2.0
30;44;879;883;4;0;2.0
30;45;883;887;4;0;2.0
30;46;887;890;3;0;2.0
30;47;890;901;11;0;2.0
30;48;901;912;11;0;2.0
30;49;912;913;1;0;2.0
30;50;913;925;12;0;2.0
30;51;925;931;6;0;2.0
30;52;931;942;11;0;2.0
30;53;942;948;6;0;2.0
30;54;948;950;2;0;2.0
30;55;950;961;11;0;2.0
30;56;961;972;11;0;2.0
30;57;972;973;1;0;2.0
30;58;973;982;9;0;2.0
30;59;982;1002;20;0;2.0
30;60;1002;1010;8;0;2.0
30;61;1010;1021;11;0;2.0
30;62;1021;1032;11;0;2.0
30;63;1032;1033;1;0;2.0
30;64;1033;1062;29;0;2.0
30;65;1062;1068;6;0;2.0
30;66;1068;1070;2;0;2.0
30;67;1070;1090;20;0;2.0
30;68;1090;1095;5;0;2.0
30;69;1095;1102;7;0;2.0
30;70;1102;1122;20;0;2.0
30;71;1122;1154;32;0;2.0
30;72;1154;1178;24;0;2.0
30;73;1178;1220;42;0;2.0
30;74;1220;1225;5;0;2.0
30;75;1225;1274;49;0;2.0
30;76;1274;1283;9;0;2.0
30;77;1283;1324;41;0;2.0
30;78;1324;1346;22;0;2.0
30;79;1346;1394;48;0;2.0
30;80;1394;1396;2;0;2.0
30;81;1396;1411;15;0;2.0
30;82;1411;1426;15;0;2.0
30;83;1426;1441;15;0;2.0
30;84;1441;1456;15;0;2.0
30;85;1456;1471;15;0;2.0
30;86;1471;1486;15;0;2.0
30;87;1486;1501;15;0;2.0
30;88;1501;1516;15;0;2.0
30;89;1516;1531;15;0;2.0
30;90;1531;1546;15;0;2.0
30;91;1546;1561;15;0;2.0
30;92;1561;1576;15;0;2.0
30;93;1576;1591;15;0;2.0
30;94;1591;1606;15;0;2.0
30;95;1606;1621;15;0;2.0
30;96;1621;1636;15;0;2.0
30;97;1636;1651;15;0;2.0
30;98;1651;1666;15;0;2.0
30;99;1666;1680;14;0;2.0
