Index Nabijacky;Index Udalosti;Cas Zaciatku;Cas Konca;CasTrvania;Miesto;Rychlost nabijania
0;0;249;332;83;112;2.0
0;1;332;333;1;112;2.0
0;2;333;336;3;112;2.0
0;3;336;355;19;112;2.0
0;4;355;361;6;112;2.0
0;5;361;366;5;112;2.0
0;6;366;371;5;112;2.0
0;7;371;383;12;112;2.0
0;8;383;388;5;112;2.0
0;9;388;393;5;112;2.0
0;10;393;423;30;112;2.0
0;11;423;426;3;112;2.0
0;12;426;428;2;112;2.0
0;13;428;431;3;112;2.0
0;14;431;448;17;112;2.0
0;15;448;453;5;112;2.0
0;16;453;455;2;112;2.0
0;17;455;456;1;112;2.0
0;18;456;476;20;112;2.0
0;19;476;478;2;112;2.0
0;20;478;483;5;112;2.0
0;21;483;498;15;112;2.0
0;22;498;518;20;112;2.0
0;23;518;538;20;112;2.0
0;24;538;543;5;112;2.0
0;25;543;551;8;112;2.0
0;26;551;574;23;112;2.0
0;27;574;577;3;112;2.0
0;28;577;593;16;112;2.0
0;29;593;598;5;112;2.0
0;30;598;619;21;112;2.0
0;31;619;620;1;112;2.0
0;32;620;628;8;112;2.0
0;33;628;633;5;112;2.0
0;34;633;658;25;112;2.0
0;35;658;694;36;112;2.0
0;36;694;703;9;112;2.0
0;37;703;713;10;112;2.0
0;38;713;718;5;112;2.0
0;39;718;739;21;112;2.0
0;40;739;740;1;112;2.0
0;41;740;753;13;112;2.0
0;42;753;763;10;112;2.0
0;43;763;778;15;112;2.0
0;44;778;794;16;112;2.0
0;45;794;799;5;112;2.0
0;46;799;804;5;112;2.0
0;47;804;811;7;112;2.0
0;48;811;818;7;112;2.0
0;49;818;823;5;112;2.0
0;50;823;831;8;112;2.0
0;51;831;836;5;112;2.0
0;52;836;838;2;112;2.0
0;53;838;846;8;112;2.0
0;54;846;857;11;112;2.0
0;55;857;859;2;112;2.0
0;56;859;862;3;112;2.0
0;57;862;870;8;112;2.0
0;58;870;883;13;112;2.0
0;59;883;898;15;112;2.0
0;60;898;903;5;112;2.0
0;61;903;904;1;112;2.0
0;62;904;911;7;112;2.0
0;63;911;913;2;112;2.0
0;64;913;914;1;112;2.0
0;65;914;919;5;112;2.0
0;66;919;925;6;112;2.0
0;67;925;930;5;112;2.0
0;68;930;933;3;112;2.0
0;69;933;943;10;112;2.0
0;70;943;963;20;112;2.0
0;71;963;964;1;112;2.0
0;72;964;973;9;112;2.0
0;73;973;974;1;112;2.0
0;74;974;979;5;112;2.0
0;75;979;1003;24;112;2.0
0;76;1003;1011;8;112;2.0
0;77;1011;1014;3;112;2.0
0;78;1014;1023;9;112;2.0
0;79;1023;1024;1;112;2.0
0;80;1024;1041;17;112;2.0
0;81;1041;1063;22;112;2.0
0;82;1063;1090;27;112;2.0
0;83;1090;1097;7;112;2.0
0;84;1097;1143;46;112;2.0
0;85;1143;1147;4;112;2.0
0;86;1147;1154;7;112;2.0
0;87;1154;1180;26;112;2.0
0;88;1180;1220;40;112;2.0
0;89;1220;1227;7;112;2.0
0;90;1227;1262;35;112;2.0
0;91;1262;1267;5;112;2.0
0;92;1267;1285;18;112;2.0
0;93;1285;1301;16;112;2.0
0;94;1301;1336;35;112;2.0
0;95;1336;1340;4;112;2.0
0;96;1340;1371;31;112;2.0
0;97;1371;1372;1;112;2.0
0;98;1372;1387;15;112;2.0
0;99;1387;1398;11;112;2.0
0;100;1398;1413;15;112;2.0
0;101;1413;1428;15;112;2.0
0;102;1428;1443;15;112;2.0
0;103;1443;1458;15;112;2.0
0;104;1458;1473;15;112;2.0
0;105;1473;1488;15;112;2.0
0;106;1488;1503;15;112;2.0
0;107;1503;1518;15;112;2.0
0;108;1518;1533;15;112;2.0
0;109;1533;1548;15;112;2.0
0;110;1548;1563;15;112;2.0
0;111;1563;1578;15;112;2.0
0;112;1578;1593;15;112;2.0
0;113;1593;1608;15;112;2.0
0;114;1608;1623;15;112;2.0
0;115;1623;1638;15;112;2.0
0;116;1638;1653;15;112;2.0
0;117;1653;1668;15;112;2.0
0;118;1668;1680;12;112;2.0
1;0;245;328;83;93;2.0
1;1;328;332;4;93;2.0
1;2;332;336;4;93;2.0
1;3;336;357;21;93;2.0
1;4;357;358;1;93;2.0
1;5;358;361;3;93;2.0
1;6;361;376;15;93;2.0
1;7;376;379;3;93;2.0
1;8;379;383;4;93;2.0
1;9;383;389;6;93;2.0
1;10;389;401;12;93;2.0
1;11;401;418;17;93;2.0
1;12;418;423;5;93;2.0
1;13;423;436;13;93;2.0
1;14;436;448;12;93;2.0
1;15;448;449;1;93;2.0
1;16;449;453;4;93;2.0
1;17;453;458;5;93;2.0
1;18;458;475;17;93;2.0
1;19;475;477;2;93;2.0
1;20;477;483;6;93;2.0
1;21;483;486;3;93;2.0
1;22;486;506;20;93;2.0
1;23;506;519;13;93;2.0
1;24;519;533;14;93;2.0
1;25;533;543;10;93;2.0
1;26;543;550;7;93;2.0
1;27;550;577;27;93;2.0
1;28;577;579;2;93;2.0
1;29;579;593;14;93;2.0
1;30;593;601;8;93;2.0
1;31;601;620;19;93;2.0
1;32;620;623;3;93;2.0
1;33;623;628;5;93;2.0
1;34;628;634;6;93;2.0
1;35;634;653;19;93;2.0
1;36;653;699;46;93;2.0
1;37;699;703;4;93;2.0
1;38;703;713;10;93;2.0
1;39;713;721;8;93;2.0
1;40;721;740;19;93;2.0
1;41;740;743;3;93;2.0
1;42;743;754;11;93;2.0
1;43;754;763;9;93;2.0
1;44;763;773;10;93;2.0
1;45;773;799;26;93;2.0
1;46;799;800;1;93;2.0
1;47;800;803;3;93;2.0
1;48;803;805;2;93;2.0
1;49;805;823;18;93;2.0
1;50;823;826;3;93;2.0
1;51;826;833;7;93;2.0
1;52;833;837;4;93;2.0
1;53;837;838;1;93;2.0
1;54;838;839;1;93;2.0
1;55;839;857;18;93;2.0
1;56;857;860;3;93;2.0
1;57;860;863;3;93;2.0
1;58;863;872;9;93;2.0
1;59;872;883;11;93;2.0
1;60;883;891;8;93;2.0
1;61;891;893;2;93;2.0
1;62;893;903;10;93;2.0
1;63;903;904;1;93;2.0
1;64;904;909;5;93;2.0
1;65;909;913;4;93;2.0
1;66;913;915;2;93;2.0
1;67;915;920;5;93;2.0
1;68;920;928;8;93;2.0
1;69;928;932;4;93;2.0
1;70;932;934;2;93;2.0
1;71;934;943;9;93;2.0
1;72;943;951;8;93;2.0
1;73;951;964;13;93;2.0
1;74;964;969;5;93;2.0
1;75;969;973;4;93;2.0
1;76;973;975;2;93;2.0
1;77;975;980;5;93;2.0
1;78;980;1003;23;93;2.0
1;79;1003;1011;8;93;2.0
1;80;1011;1019;8;93;2.0
1;81;1019;1024;5;93;2.0
1;82;1024;1025;1;93;2.0
1;83;1025;1033;8;93;2.0
1;84;1033;1071;38;93;2.0
1;85;1071;1093;22;93;2.0
1;86;1093;1098;5;93;2.0
1;87;1098;1148;50;93;2.0
1;88;1148;1155;7;93;2.0
1;89;1155;1181;26;93;2.0
1;90;1181;1223;42;93;2.0
1;91;1223;1228;5;93;2.0
1;92;1228;1254;26;93;2.0
1;93;1254;1275;21;93;2.0
1;94;1275;1286;11;93;2.0
1;95;1286;1309;23;93;2.0
1;96;1309;1328;19;93;2.0
1;97;1328;1342;14;93;2.0
1;98;1342;1364;22;93;2.0
1;99;1364;1368;4;93;2.0
1;100;1368;1395;27;93;2.0
1;101;1395;1399;4;93;2.0
1;102;1399;1414;15;93;2.0
1;103;1414;1429;15;93;2.0
1;104;1429;1444;15;93;2.0
1;105;1444;1459;15;93;2.0
1;106;1459;1474;15;93;2.0
1;107;1474;1489;15;93;2.0
1;108;1489;1504;15;93;2.0
1;109;1504;1519;15;93;2.0
1;110;1519;1534;15;93;2.0
1;111;1534;1549;15;93;2.0
1;112;1549;1564;15;93;2.0
1;113;1564;1579;15;93;2.0
1;114;1579;1594;15;93;2.0
1;115;1594;1609;15;93;2.0
1;116;1609;1624;15;93;2.0
1;117;1624;1639;15;93;2.0
1;118;1639;1654;15;93;2.0
1;119;1654;1669;15;93;2.0
1;120;1669;1680;11;93;2.0
2;0;246;330;84;92;2.0
2;1;330;331;1;92;2.0
2;2;331;336;5;92;2.0
2;3;336;356;20;92;2.0
2;4;356;360;4;92;2.0
2;5;360;375;15;92;2.0
2;6;375;379;4;92;2.0
2;7;379;382;3;92;2.0
2;8;382;388;6;92;2.0
2;9;388;401;13;92;2.0
2;10;401;420;19;92;2.0
2;11;420;422;2;92;2.0
2;12;422;435;13;92;2.0
2;13;435;436;1;92;2.0
2;14;436;448;12;92;2.0
2;15;448;450;2;92;2.0
2;16;450;452;2;92;2.0
2;17;452;458;6;92;2.0
2;18;458;476;18;92;2.0
2;19;476;482;6;92;2.0
2;20;482;486;4;92;2.0
2;21;486;506;20;92;2.0
2;22;506;518;12;92;2.0
2;23;518;532;14;92;2.0
2;24;532;542;10;92;2.0
2;25;542;549;7;92;2.0
2;26;549;576;27;92;2.0
2;27;576;578;2;92;2.0
2;28;578;592;14;92;2.0
2;29;592;601;9;92;2.0
2;30;601;619;18;92;2.0
2;31;619;623;4;92;2.0
2;32;623;627;4;92;2.0
2;33;627;633;6;92;2.0
2;34;633;652;19;92;2.0
2;35;652;698;46;92;2.0
2;36;698;702;4;92;2.0
2;37;702;712;10;92;2.0
2;38;712;721;9;92;2.0
2;39;721;739;18;92;2.0
2;40;739;743;4;92;2.0
2;41;743;753;10;92;2.0
2;42;753;762;9;92;2.0
2;43;762;772;10;92;2.0
2;44;772;798;26;92;2.0
2;45;798;799;1;92;2.0
2;46;799;804;5;92;2.0
2;47;804;805;1;92;2.0
2;48;805;822;17;92;2.0
2;49;822;826;4;92;2.0
2;50;826;832;6;92;2.0
2;51;832;836;4;92;2.0
2;52;836;838;2;92;2.0
2;53;838;840;2;92;2.0
2;54;840;856;16;92;2.0
2;55;856;859;3;92;2.0
2;56;859;862;3;92;2.0
2;57;862;871;9;92;2.0
2;58;871;882;11;92;2.0
2;59;882;891;9;92;2.0
2;60;891;892;1;92;2.0
2;61;892;903;11;92;2.0
2;62;903;905;2;92;2.0
2;63;905;908;3;92;2.0
2;64;908;912;4;92;2.0
2;65;912;914;2;92;2.0
2;66;914;919;5;92;2.0
2;67;919;928;9;92;2.0
2;68;928;931;3;92;2.0
2;69;931;933;2;92;2.0
2;70;933;942;9;92;2.0
2;71;942;951;9;92;2.0
2;72;951;963;12;92;2.0
2;73;963;968;5;92;2.0
2;74;968;972;4;92;2.0
2;75;972;974;2;92;2.0
2;76;974;979;5;92;2.0
2;77;979;1002;23;92;2.0
2;78;1002;1004;2;92;2.0
2;79;1004;1011;7;92;2.0
2;80;1011;1018;7;92;2.0
2;81;1018;1023;5;92;2.0
2;82;1023;1024;1;92;2.0
2;83;1024;1034;10;92;2.0
2;84;1034;1071;37;92;2.0
2;85;1071;1093;22;92;2.0
2;86;1093;1097;4;92;2.0
2;87;1097;1147;50;92;2.0
2;88;1147;1154;7;92;2.0
2;89;1154;1155;1;92;2.0
2;90;1155;1180;25;92;2.0
2;91;1180;1223;43;92;2.0
2;92;1223;1227;4;92;2.0
2;93;1227;1256;29;92;2.0
2;94;1256;1275;19;92;2.0
2;95;1275;1285;10;92;2.0
2;96;1285;1309;24;92;2.0
2;97;1309;1330;21;92;2.0
2;98;1330;1341;11;92;2.0
2;99;1341;1366;25;92;2.0
2;100;1366;1368;2;92;2.0
2;101;1368;1395;27;92;2.0
2;102;1395;1398;3;92;2.0
2;103;1398;1413;15;92;2.0
2;104;1413;1428;15;92;2.0
2;105;1428;1443;15;92;2.0
2;106;1443;1458;15;92;2.0
2;107;1458;1473;15;92;2.0
2;108;1473;1488;15;92;2.0
2;109;1488;1503;15;92;2.0
2;110;1503;1518;15;92;2.0
2;111;1518;1533;15;92;2.0
2;112;1533;1548;15;92;2.0
2;113;1548;1563;15;92;2.0
2;114;1563;1578;15;92;2.0
2;115;1578;1593;15;92;2.0
2;116;1593;1608;15;92;2.0
2;117;1608;1623;15;92;2.0
2;118;1623;1638;15;92;2.0
2;119;1638;1653;15;92;2.0
2;120;1653;1668;15;92;2.0
2;121;1668;1680;12;92;2.0
3;0;248;327;79;77;2.0
3;1;327;333;6;77;2.0
3;2;333;338;5;77;2.0
3;3;338;356;18;77;2.0
3;4;356;363;7;77;2.0
3;5;363;375;12;77;2.0
3;6;375;378;3;77;2.0
3;7;378;388;10;77;2.0
3;8;388;400;12;77;2.0
3;9;400;418;18;77;2.0
3;10;418;423;5;77;2.0
3;11;423;435;12;77;2.0
3;12;435;448;13;77;2.0
3;13;448;453;5;77;2.0
3;14;453;460;7;77;2.0
3;15;460;476;16;77;2.0
3;16;476;478;2;77;2.0
3;17;478;480;2;77;2.0
3;18;480;485;5;77;2.0
3;19;485;505;20;77;2.0
3;20;505;518;13;77;2.0
3;21;518;532;14;77;2.0
3;22;532;538;6;77;2.0
3;23;538;549;11;77;2.0
3;24;549;572;23;77;2.0
3;25;572;578;6;77;2.0
3;26;578;592;14;77;2.0
3;27;592;600;8;77;2.0
3;28;600;619;19;77;2.0
3;29;619;623;4;77;2.0
3;30;623;625;2;77;2.0
3;31;625;633;8;77;2.0
3;32;633;652;19;77;2.0
3;33;652;698;46;77;2.0
3;34;698;712;14;77;2.0
3;35;712;720;8;77;2.0
3;36;720;739;19;77;2.0
3;37;739;745;6;77;2.0
3;38;745;753;8;77;2.0
3;39;753;758;5;77;2.0
3;40;758;772;14;77;2.0
3;41;772;798;26;77;2.0
3;42;798;799;1;77;2.0
3;43;799;804;5;77;2.0
3;44;804;808;4;77;2.0
3;45;808;818;10;77;2.0
3;46;818;825;7;77;2.0
3;47;825;832;7;77;2.0
3;48;832;836;4;77;2.0
3;49;836;838;2;77;2.0
3;50;838;843;5;77;2.0
3;51;843;852;9;77;2.0
3;52;852;859;7;77;2.0
3;53;859;862;3;77;2.0
3;54;862;871;9;77;2.0
3;55;871;878;7;77;2.0
3;56;878;890;12;77;2.0
3;57;890;892;2;77;2.0
3;58;892;903;11;77;2.0
3;59;903;908;5;77;2.0
3;60;908;914;6;77;2.0
3;61;914;919;5;77;2.0
3;62;919;930;11;77;2.0
3;63;930;931;1;77;2.0
3;64;931;933;2;77;2.0
3;65;933;938;5;77;2.0
3;66;938;950;12;77;2.0
3;67;950;963;13;77;2.0
3;68;963;968;5;77;2.0
3;69;968;974;6;77;2.0
3;70;974;979;5;77;2.0
3;71;979;998;19;77;2.0
3;72;998;1008;10;77;2.0
3;73;1008;1010;2;77;2.0
3;74;1010;1018;8;77;2.0
3;75;1018;1023;5;77;2.0
3;76;1023;1024;1;77;2.0
3;77;1024;1038;14;77;2.0
3;78;1038;1070;32;77;2.0
3;79;1070;1095;25;77;2.0
3;80;1095;1097;2;77;2.0
3;81;1097;1147;50;77;2.0
3;82;1147;1154;7;77;2.0
3;83;1154;1180;26;77;2.0
3;84;1180;1225;45;77;2.0
3;85;1225;1227;2;77;2.0
3;86;1227;1259;32;77;2.0
3;87;1259;1274;15;77;2.0
3;88;1274;1285;11;77;2.0
3;89;1285;1308;23;77;2.0
3;90;1308;1333;25;77;2.0
3;91;1333;1341;8;77;2.0
3;92;1341;1369;28;77;2.0
3;93;1369;1370;1;77;2.0
3;94;1370;1394;24;77;2.0
3;95;1394;1398;4;77;2.0
3;96;1398;1413;15;77;2.0
3;97;1413;1428;15;77;2.0
3;98;1428;1443;15;77;2.0
3;99;1443;1458;15;77;2.0
3;100;1458;1473;15;77;2.0
3;101;1473;1488;15;77;2.0
3;102;1488;1503;15;77;2.0
3;103;1503;1518;15;77;2.0
3;104;1518;1533;15;77;2.0
3;105;1533;1548;15;77;2.0
3;106;1548;1563;15;77;2.0
3;107;1563;1578;15;77;2.0
3;108;1578;1593;15;77;2.0
3;109;1593;1608;15;77;2.0
3;110;1608;1623;15;77;2.0
3;111;1623;1638;15;77;2.0
3;112;1638;1653;15;77;2.0
3;113;1653;1668;15;77;2.0
3;114;1668;1680;12;77;2.0
4;0;245;331;86;119;2.0
4;1;331;336;5;119;2.0
4;2;336;354;18;119;2.0
4;3;354;360;6;119;2.0
4;4;360;361;1;119;2.0
4;5;361;373;12;119;2.0
4;6;373;377;4;119;2.0
4;7;377;382;5;119;2.0
4;8;382;386;4;119;2.0
4;9;386;399;13;119;2.0
4;10;399;421;22;119;2.0
4;11;421;422;1;119;2.0
4;12;422;433;11;119;2.0
4;13;433;434;1;119;2.0
4;14;434;446;12;119;2.0
4;15;446;451;5;119;2.0
4;16;451;452;1;119;2.0
4;17;452;458;6;119;2.0
4;18;458;474;16;119;2.0
4;19;474;477;3;119;2.0
4;20;477;482;5;119;2.0
4;21;482;484;2;119;2.0
4;22;484;504;20;119;2.0
4;23;504;516;12;119;2.0
4;24;516;532;16;119;2.0
4;25;532;542;10;119;2.0
4;26;542;547;5;119;2.0
4;27;547;576;29;119;2.0
4;28;576;592;16;119;2.0
4;29;592;599;7;119;2.0
4;30;599;617;18;119;2.0
4;31;617;623;6;119;2.0
4;32;623;627;4;119;2.0
4;33;627;631;4;119;2.0
4;34;631;652;21;119;2.0
4;35;652;696;44;119;2.0
4;36;696;702;6;119;2.0
4;37;702;712;10;119;2.0
4;38;712;719;7;119;2.0
4;39;719;737;18;119;2.0
4;40;737;743;6;119;2.0
4;41;743;751;8;119;2.0
4;42;751;762;11;119;2.0
4;43;762;772;10;119;2.0
4;44;772;796;24;119;2.0
4;45;796;797;1;119;2.0
4;46;797;802;5;119;2.0
4;47;802;806;4;119;2.0
4;48;806;822;16;119;2.0
4;49;822;824;2;119;2.0
4;50;824;832;8;119;2.0
4;51;832;834;2;119;2.0
4;52;834;836;2;119;2.0
4;53;836;841;5;119;2.0
4;54;841;856;15;119;2.0
4;55;856;857;1;119;2.0
4;56;857;860;3;119;2.0
4;57;860;869;9;119;2.0
4;58;869;882;13;119;2.0
4;59;882;889;7;119;2.0
4;60;889;892;3;119;2.0
4;61;892;901;9;119;2.0
4;62;901;906;5;119;2.0
4;63;906;912;6;119;2.0
4;64;912;917;5;119;2.0
4;65;917;928;11;119;2.0
4;66;928;929;1;119;2.0
4;67;929;931;2;119;2.0
4;68;931;942;11;119;2.0
4;69;942;949;7;119;2.0
4;70;949;961;12;119;2.0
4;71;961;966;5;119;2.0
4;72;966;972;6;119;2.0
4;73;972;977;5;119;2.0
4;74;977;1002;25;119;2.0
4;75;1002;1005;3;119;2.0
4;76;1005;1009;4;119;2.0
4;77;1009;1016;7;119;2.0
4;78;1016;1021;5;119;2.0
4;79;1021;1022;1;119;2.0
4;80;1022;1035;13;119;2.0
4;81;1035;1069;34;119;2.0
4;82;1069;1093;24;119;2.0
4;83;1093;1095;2;119;2.0
4;84;1095;1145;50;119;2.0
4;85;1145;1152;7;119;2.0
4;86;1152;1153;1;119;2.0
4;87;1153;1178;25;119;2.0
4;88;1178;1223;45;119;2.0
4;89;1223;1225;2;119;2.0
4;90;1225;1257;32;119;2.0
4;91;1257;1273;16;119;2.0
4;92;1273;1283;10;119;2.0
4;93;1283;1307;24;119;2.0
4;94;1307;1331;24;119;2.0
4;95;1331;1339;8;119;2.0
4;96;1339;1367;28;119;2.0
4;97;1367;1393;26;119;2.0
4;98;1393;1396;3;119;2.0
4;99;1396;1411;15;119;2.0
4;100;1411;1426;15;119;2.0
4;101;1426;1441;15;119;2.0
4;102;1441;1456;15;119;2.0
4;103;1456;1471;15;119;2.0
4;104;1471;1486;15;119;2.0
4;105;1486;1501;15;119;2.0
4;106;1501;1516;15;119;2.0
4;107;1516;1531;15;119;2.0
4;108;1531;1546;15;119;2.0
4;109;1546;1561;15;119;2.0
4;110;1561;1576;15;119;2.0
4;111;1576;1591;15;119;2.0
4;112;1591;1606;15;119;2.0
4;113;1606;1621;15;119;2.0
4;114;1621;1636;15;119;2.0
4;115;1636;1651;15;119;2.0
4;116;1651;1666;15;119;2.0
4;117;1666;1680;14;119;2.0
5;0;243;330;87;96;2.0
5;1;330;333;3;96;2.0
5;2;333;334;1;96;2.0
5;3;334;356;22;96;2.0
5;4;356;360;4;96;2.0
5;5;360;362;2;96;2.0
5;6;362;374;12;96;2.0
5;7;374;379;5;96;2.0
5;8;379;384;5;96;2.0
5;9;384;387;3;96;2.0
5;10;387;401;14;96;2.0
5;11;401;420;19;96;2.0
5;12;420;424;4;96;2.0
5;13;424;434;10;96;2.0
5;14;434;436;2;96;2.0
5;15;436;447;11;96;2.0
5;16;447;450;3;96;2.0
5;17;450;454;4;96;2.0
5;18;454;456;2;96;2.0
5;19;456;475;19;96;2.0
5;20;475;476;1;96;2.0
5;21;476;484;8;96;2.0
5;22;484;486;2;96;2.0
5;23;486;506;20;96;2.0
5;24;506;517;11;96;2.0
5;25;517;534;17;96;2.0
5;26;534;544;10;96;2.0
5;27;544;549;5;96;2.0
5;28;549;577;28;96;2.0
5;29;577;578;1;96;2.0
5;30;578;594;16;96;2.0
5;31;594;601;7;96;2.0
5;32;601;618;17;96;2.0
5;33;618;621;3;96;2.0
5;34;621;629;8;96;2.0
5;35;629;632;3;96;2.0
5;36;632;654;22;96;2.0
5;37;654;697;43;96;2.0
5;38;697;704;7;96;2.0
5;39;704;714;10;96;2.0
5;40;714;721;7;96;2.0
5;41;721;738;17;96;2.0
5;42;738;741;3;96;2.0
5;43;741;752;11;96;2.0
5;44;752;764;12;96;2.0
5;45;764;774;10;96;2.0
5;46;774;797;23;96;2.0
5;47;797;798;1;96;2.0
5;48;798;803;5;96;2.0
5;49;803;805;2;96;2.0
5;50;805;824;19;96;2.0
5;51;824;826;2;96;2.0
5;52;826;834;8;96;2.0
5;53;834;835;1;96;2.0
5;54;835;838;3;96;2.0
5;55;838;840;2;96;2.0
5;56;840;858;18;96;2.0
5;57;858;861;3;96;2.0
5;58;861;871;10;96;2.0
5;59;871;884;13;96;2.0
5;60;884;891;7;96;2.0
5;61;891;894;3;96;2.0
5;62;894;902;8;96;2.0
5;63;902;905;3;96;2.0
5;64;905;907;2;96;2.0
5;65;907;913;6;96;2.0
5;66;913;914;1;96;2.0
5;67;914;918;4;96;2.0
5;68;918;926;8;96;2.0
5;69;926;931;5;96;2.0
5;70;931;932;1;96;2.0
5;71;932;944;12;96;2.0
5;72;944;951;7;96;2.0
5;73;951;962;11;96;2.0
5;74;962;967;5;96;2.0
5;75;967;973;6;96;2.0
5;76;973;974;1;96;2.0
5;77;974;978;4;96;2.0
5;78;978;1004;26;96;2.0
5;79;1004;1011;7;96;2.0
5;80;1011;1017;6;96;2.0
5;81;1017;1022;5;96;2.0
5;82;1022;1023;1;96;2.0
5;83;1023;1034;11;96;2.0
5;84;1034;1071;37;96;2.0
5;85;1071;1091;20;96;2.0
5;86;1091;1096;5;96;2.0
5;87;1096;1146;50;96;2.0
5;88;1146;1153;7;96;2.0
5;89;1153;1155;2;96;2.0
5;90;1155;1179;24;96;2.0
5;91;1179;1221;42;96;2.0
5;92;1221;1226;5;96;2.0
5;93;1226;1256;30;96;2.0
5;94;1256;1275;19;96;2.0
5;95;1275;1284;9;96;2.0
5;96;1284;1309;25;96;2.0
5;97;1309;1330;21;96;2.0
5;98;1330;1341;11;96;2.0
5;99;1341;1366;25;96;2.0
5;100;1366;1395;29;96;2.0
5;101;1395;1397;2;96;2.0
5;102;1397;1412;15;96;2.0
5;103;1412;1427;15;96;2.0
5;104;1427;1442;15;96;2.0
5;105;1442;1457;15;96;2.0
5;106;1457;1472;15;96;2.0
5;107;1472;1487;15;96;2.0
5;108;1487;1502;15;96;2.0
5;109;1502;1517;15;96;2.0
5;110;1517;1532;15;96;2.0
5;111;1532;1547;15;96;2.0
5;112;1547;1562;15;96;2.0
5;113;1562;1577;15;96;2.0
5;114;1577;1592;15;96;2.0
5;115;1592;1607;15;96;2.0
5;116;1607;1622;15;96;2.0
5;117;1622;1637;15;96;2.0
5;118;1637;1652;15;96;2.0
5;119;1652;1667;15;96;2.0
5;120;1667;1680;13;96;2.0
6;0;252;321;69;160;2.0
6;1;321;339;18;160;2.0
6;2;339;341;2;160;2.0
6;3;341;350;9;160;2.0
6;4;350;360;10;160;2.0
6;5;360;369;9;160;2.0
6;6;369;372;3;160;2.0
6;7;372;378;6;160;2.0
6;8;378;381;3;160;2.0
6;9;381;394;13;160;2.0
6;10;394;403;9;160;2.0
6;11;403;412;9;160;2.0
6;12;412;429;17;160;2.0
6;13;429;438;9;160;2.0
6;14;438;442;4;160;2.0
6;15;442;454;12;160;2.0
6;16;454;459;5;160;2.0
6;17;459;463;4;160;2.0
6;18;463;472;9;160;2.0
6;19;472;482;10;160;2.0
6;20;482;485;3;160;2.0
6;21;485;488;3;160;2.0
6;22;488;508;20;160;2.0
6;23;508;524;16;160;2.0
6;24;524;532;8;160;2.0
6;25;532;537;5;160;2.0
6;26;537;554;17;160;2.0
6;27;554;566;12;160;2.0
6;28;566;581;15;160;2.0
6;29;581;597;16;160;2.0
6;30;597;603;6;160;2.0
6;31;603;617;14;160;2.0
6;32;617;625;8;160;2.0
6;33;625;628;3;160;2.0
6;34;628;639;11;160;2.0
6;35;639;657;18;160;2.0
6;36;657;692;35;160;2.0
6;37;692;701;9;160;2.0
6;38;701;717;16;160;2.0
6;39;717;723;6;160;2.0
6;40;723;745;22;160;2.0
6;41;745;748;3;160;2.0
6;42;748;752;4;160;2.0
6;43;752;759;7;160;2.0
6;44;759;777;18;160;2.0
6;45;777;801;24;160;2.0
6;46;801;805;4;160;2.0
6;47;805;810;5;160;2.0
6;48;810;812;2;160;2.0
6;49;812;814;2;160;2.0
6;50;814;828;14;160;2.0
6;51;828;837;9;160;2.0
6;52;837;840;3;160;2.0
6;53;840;842;2;160;2.0
6;54;842;846;4;160;2.0
6;55;846;849;3;160;2.0
6;56;849;865;16;160;2.0
6;57;865;868;3;160;2.0
6;58;868;872;4;160;2.0
6;59;872;875;3;160;2.0
6;60;875;893;18;160;2.0
6;61;893;897;4;160;2.0
6;62;897;902;5;160;2.0
6;63;902;909;7;160;2.0
6;64;909;911;2;160;2.0
6;65;911;914;3;160;2.0
6;66;914;920;6;160;2.0
6;67;920;925;5;160;2.0
6;68;925;932;7;160;2.0
6;69;932;933;1;160;2.0
6;70;933;935;2;160;2.0
6;71;935;939;4;160;2.0
6;72;939;953;14;160;2.0
6;73;953;962;9;160;2.0
6;74;962;969;7;160;2.0
6;75;969;971;2;160;2.0
6;76;971;980;9;160;2.0
6;77;980;985;5;160;2.0
6;78;985;992;7;160;2.0
6;79;992;1013;21;160;2.0
6;80;1013;1021;8;160;2.0
6;81;1021;1029;8;160;2.0
6;82;1029;1030;1;160;2.0
6;83;1030;1043;13;160;2.0
6;84;1043;1073;30;160;2.0
6;85;1073;1098;25;160;2.0
6;86;1098;1103;5;160;2.0
6;87;1103;1150;47;160;2.0
6;88;1150;1157;7;160;2.0
6;89;1157;1160;3;160;2.0
6;90;1160;1186;26;160;2.0
6;91;1186;1228;42;160;2.0
6;92;1228;1233;5;160;2.0
6;93;1233;1265;32;160;2.0
6;94;1265;1277;12;160;2.0
6;95;1277;1291;14;160;2.0
6;96;1291;1311;20;160;2.0
6;97;1311;1339;28;160;2.0
6;98;1339;1345;6;160;2.0
6;99;1345;1375;30;160;2.0
6;100;1375;1397;22;160;2.0
6;101;1397;1404;7;160;2.0
6;102;1404;1419;15;160;2.0
6;103;1419;1434;15;160;2.0
6;104;1434;1449;15;160;2.0
6;105;1449;1464;15;160;2.0
6;106;1464;1479;15;160;2.0
6;107;1479;1494;15;160;2.0
6;108;1494;1509;15;160;2.0
6;109;1509;1524;15;160;2.0
6;110;1524;1539;15;160;2.0
6;111;1539;1554;15;160;2.0
6;112;1554;1569;15;160;2.0
6;113;1569;1584;15;160;2.0
6;114;1584;1599;15;160;2.0
6;115;1599;1614;15;160;2.0
6;116;1614;1629;15;160;2.0
6;117;1629;1644;15;160;2.0
6;118;1644;1659;15;160;2.0
6;119;1659;1680;21;160;2.0
7;0;250;328;78;1;2.0
7;1;328;338;10;1;2.0
7;2;338;339;1;1;2.0
7;3;339;357;18;1;2.0
7;4;357;358;1;1;2.0
7;5;358;368;10;1;2.0
7;6;368;376;8;1;2.0
7;7;376;378;2;1;2.0
7;8;378;379;1;1;2.0
7;9;379;392;13;1;2.0
7;10;392;399;7;1;2.0
7;11;399;419;20;1;2.0
7;12;419;428;9;1;2.0
7;13;428;435;7;1;2.0
7;14;435;436;1;1;2.0
7;15;436;449;13;1;2.0
7;16;449;452;3;1;2.0
7;17;452;458;6;1;2.0
7;18;458;461;3;1;2.0
7;19;461;479;18;1;2.0
7;20;479;480;1;1;2.0
7;21;480;484;4;1;2.0
7;22;484;485;1;1;2.0
7;23;485;505;20;1;2.0
7;24;505;522;17;1;2.0
7;25;522;537;15;1;2.0
7;26;537;539;2;1;2.0
7;27;539;553;14;1;2.0
7;28;553;573;20;1;2.0
7;29;573;579;6;1;2.0
7;30;579;597;18;1;2.0
7;31;597;600;3;1;2.0
7;32;600;623;23;1;2.0
7;33;623;624;1;1;2.0
7;34;624;626;2;1;2.0
7;35;626;637;11;1;2.0
7;36;637;657;20;1;2.0
7;37;657;699;42;1;2.0
7;38;699;717;18;1;2.0
7;39;717;720;3;1;2.0
7;40;720;743;23;1;2.0
7;41;743;746;3;1;2.0
7;42;746;757;11;1;2.0
7;43;757;759;2;1;2.0
7;44;759;777;18;1;2.0
7;45;777;799;22;1;2.0
7;46;799;803;4;1;2.0
7;47;803;808;5;1;2.0
7;48;808;813;5;1;2.0
7;49;813;819;6;1;2.0
7;50;819;825;6;1;2.0
7;51;825;837;12;1;2.0
7;52;837;840;3;1;2.0
7;53;840;848;8;1;2.0
7;54;848;853;5;1;2.0
7;55;853;863;10;1;2.0
7;56;863;866;3;1;2.0
7;57;866;873;7;1;2.0
7;58;873;879;6;1;2.0
7;59;879;890;11;1;2.0
7;60;890;897;7;1;2.0
7;61;897;907;10;1;2.0
7;62;907;909;2;1;2.0
7;63;909;913;4;1;2.0
7;64;913;918;5;1;2.0
7;65;918;923;5;1;2.0
7;66;923;931;8;1;2.0
7;67;931;933;2;1;2.0
7;68;933;937;4;1;2.0
7;69;937;939;2;1;2.0
7;70;939;950;11;1;2.0
7;71;950;967;17;1;2.0
7;72;967;969;2;1;2.0
7;73;969;978;9;1;2.0
7;74;978;983;5;1;2.0
7;75;983;999;16;1;2.0
7;76;999;1010;11;1;2.0
7;77;1010;1013;3;1;2.0
7;78;1013;1019;6;1;2.0
7;79;1019;1027;8;1;2.0
7;80;1027;1028;1;1;2.0
7;81;1028;1043;15;1;2.0
7;82;1043;1070;27;1;2.0
7;83;1070;1096;26;1;2.0
7;84;1096;1101;5;1;2.0
7;85;1101;1148;47;1;2.0
7;86;1148;1154;6;1;2.0
7;87;1154;1158;4;1;2.0
7;88;1158;1184;26;1;2.0
7;89;1184;1226;42;1;2.0
7;90;1226;1231;5;1;2.0
7;91;1231;1264;33;1;2.0
7;92;1264;1274;10;1;2.0
7;93;1274;1289;15;1;2.0
7;94;1289;1307;18;1;2.0
7;95;1307;1338;31;1;2.0
7;96;1338;1343;5;1;2.0
7;97;1343;1373;30;1;2.0
7;98;1373;1374;1;1;2.0
7;99;1374;1394;20;1;2.0
7;100;1394;1402;8;1;2.0
7;101;1402;1417;15;1;2.0
7;102;1417;1432;15;1;2.0
7;103;1432;1447;15;1;2.0
7;104;1447;1462;15;1;2.0
7;105;1462;1477;15;1;2.0
7;106;1477;1492;15;1;2.0
7;107;1492;1507;15;1;2.0
7;108;1507;1522;15;1;2.0
7;109;1522;1537;15;1;2.0
7;110;1537;1552;15;1;2.0
7;111;1552;1567;15;1;2.0
7;112;1567;1582;15;1;2.0
7;113;1582;1597;15;1;2.0
7;114;1597;1612;15;1;2.0
7;115;1612;1627;15;1;2.0
7;116;1627;1642;15;1;2.0
7;117;1642;1657;15;1;2.0
7;118;1657;1680;23;1;2.0
8;0;250;332;82;43;2.0
8;1;332;337;5;43;2.0
8;2;337;338;1;43;2.0
8;3;338;357;19;43;2.0
8;4;357;366;9;43;2.0
8;5;366;367;1;43;2.0
8;6;367;368;1;43;2.0
8;7;368;372;4;43;2.0
8;8;372;388;16;43;2.0
8;9;388;389;1;43;2.0
8;10;389;401;12;43;2.0
8;11;401;427;26;43;2.0
8;12;427;428;1;43;2.0
8;13;428;429;1;43;2.0
8;14;429;449;20;43;2.0
8;15;449;454;5;43;2.0
8;16;454;458;4;43;2.0
8;17;458;477;19;43;2.0
8;18;477;486;9;43;2.0
8;19;486;488;2;43;2.0
8;20;488;499;11;43;2.0
8;21;499;519;20;43;2.0
8;22;519;542;23;43;2.0
8;23;542;548;6;43;2.0
8;24;548;554;6;43;2.0
8;25;554;570;16;43;2.0
8;26;570;582;12;43;2.0
8;27;582;594;12;43;2.0
8;28;594;602;8;43;2.0
8;29;602;619;17;43;2.0
8;30;619;620;1;43;2.0
8;31;620;633;13;43;2.0
8;32;633;634;1;43;2.0
8;33;634;662;28;43;2.0
8;34;662;690;28;43;2.0
8;35;690;708;18;43;2.0
8;36;708;714;6;43;2.0
8;37;714;722;8;43;2.0
8;38;722;739;17;43;2.0
8;39;739;740;1;43;2.0
8;40;740;754;14;43;2.0
8;41;754;768;14;43;2.0
8;42;768;782;14;43;2.0
8;43;782;790;8;43;2.0
8;44;790;800;10;43;2.0
8;45;800;805;5;43;2.0
8;46;805;813;8;43;2.0
8;47;813;819;6;43;2.0
8;48;819;828;9;43;2.0
8;49;828;837;9;43;2.0
8;50;837;839;2;43;2.0
8;51;839;842;3;43;2.0
8;52;842;848;6;43;2.0
8;53;848;860;12;43;2.0
8;54;860;862;2;43;2.0
8;55;862;863;1;43;2.0
8;56;863;872;9;43;2.0
8;57;872;884;12;43;2.0
8;58;884;888;4;43;2.0
8;59;888;900;12;43;2.0
8;60;900;902;2;43;2.0
8;61;902;904;2;43;2.0
8;62;904;913;9;43;2.0
8;63;913;915;2;43;2.0
8;64;915;918;3;43;2.0
8;65;918;920;2;43;2.0
8;66;920;924;4;43;2.0
8;67;924;932;8;43;2.0
8;68;932;934;2;43;2.0
8;69;934;944;10;43;2.0
8;70;944;948;4;43;2.0
8;71;948;960;12;43;2.0
8;72;960;964;4;43;2.0
8;73;964;975;11;43;2.0
8;74;975;978;3;43;2.0
8;75;978;980;2;43;2.0
8;76;980;1004;24;43;2.0
8;77;1004;1008;4;43;2.0
8;78;1008;1010;2;43;2.0
8;79;1010;1014;4;43;2.0
8;80;1014;1024;10;43;2.0
8;81;1024;1025;1;43;2.0
8;82;1025;1044;19;43;2.0
8;83;1044;1064;20;43;2.0
8;84;1064;1089;25;43;2.0
8;85;1089;1098;9;43;2.0
8;86;1098;1139;41;43;2.0
8;87;1139;1148;9;43;2.0
8;88;1148;1155;7;43;2.0
8;89;1155;1181;26;43;2.0
8;90;1181;1219;38;43;2.0
8;91;1219;1228;9;43;2.0
8;92;1228;1264;36;43;2.0
8;93;1264;1268;4;43;2.0
8;94;1268;1286;18;43;2.0
8;95;1286;1309;23;43;2.0
8;96;1309;1338;29;43;2.0
8;97;1338;1342;4;43;2.0
8;98;1342;1373;31;43;2.0
8;99;1373;1374;1;43;2.0
8;100;1374;1388;14;43;2.0
8;101;1388;1399;11;43;2.0
8;102;1399;1414;15;43;2.0
8;103;1414;1429;15;43;2.0
8;104;1429;1444;15;43;2.0
8;105;1444;1459;15;43;2.0
8;106;1459;1474;15;43;2.0
8;107;1474;1489;15;43;2.0
8;108;1489;1504;15;43;2.0
8;109;1504;1519;15;43;2.0
8;110;1519;1534;15;43;2.0
8;111;1534;1549;15;43;2.0
8;112;1549;1564;15;43;2.0
8;113;1564;1579;15;43;2.0
8;114;1579;1594;15;43;2.0
8;115;1594;1609;15;43;2.0
8;116;1609;1624;15;43;2.0
8;117;1624;1639;15;43;2.0
8;118;1639;1654;15;43;2.0
8;119;1654;1669;15;43;2.0
8;120;1669;1680;11;43;2.0
9;0;250;328;78;4;2.0
9;1;328;337;9;4;2.0
9;2;337;338;1;4;2.0
9;3;338;357;19;4;2.0
9;4;357;368;11;4;2.0
9;5;368;375;7;4;2.0
9;6;375;376;1;4;2.0
9;7;376;379;3;4;2.0
9;8;379;390;11;4;2.0
9;9;390;397;7;4;2.0
9;10;397;419;22;4;2.0
9;11;419;428;9;4;2.0
9;12;428;433;5;4;2.0
9;13;433;435;2;4;2.0
9;14;435;449;14;4;2.0
9;15;449;450;1;4;2.0
9;16;450;458;8;4;2.0
9;17;458;459;1;4;2.0
9;18;459;478;19;4;2.0
9;19;478;479;1;4;2.0
9;20;479;482;3;4;2.0
9;21;482;485;3;4;2.0
9;22;485;503;18;4;2.0
9;23;503;520;17;4;2.0
9;24;520;537;17;4;2.0
9;25;537;539;2;4;2.0
9;26;539;552;13;4;2.0
9;27;552;573;21;4;2.0
9;28;573;578;5;4;2.0
9;29;578;597;19;4;2.0
9;30;597;598;1;4;2.0
9;31;598;621;23;4;2.0
9;32;621;624;3;4;2.0
9;33;624;635;11;4;2.0
9;34;635;657;22;4;2.0
9;35;657;698;41;4;2.0
9;36;698;699;1;4;2.0
9;37;699;717;18;4;2.0
9;38;717;718;1;4;2.0
9;39;718;741;23;4;2.0
9;40;741;744;3;4;2.0
9;41;744;755;11;4;2.0
9;42;755;759;4;4;2.0
9;43;759;777;18;4;2.0
9;44;777;798;21;4;2.0
9;45;798;801;3;4;2.0
9;46;801;806;5;4;2.0
9;47;806;813;7;4;2.0
9;48;813;819;6;4;2.0
9;49;819;823;4;4;2.0
9;50;823;835;12;4;2.0
9;51;835;837;2;4;2.0
9;52;837;838;1;4;2.0
9;53;838;848;10;4;2.0
9;54;848;853;5;4;2.0
9;55;853;861;8;4;2.0
9;56;861;864;3;4;2.0
9;57;864;872;8;4;2.0
9;58;872;879;7;4;2.0
9;59;879;888;9;4;2.0
9;60;888;897;9;4;2.0
9;61;897;905;8;4;2.0
9;62;905;908;3;4;2.0
9;63;908;909;1;4;2.0
9;64;909;913;4;4;2.0
9;65;913;916;3;4;2.0
9;66;916;921;5;4;2.0
9;67;921;929;8;4;2.0
9;68;929;932;3;4;2.0
9;69;932;935;3;4;2.0
9;70;935;939;4;4;2.0
9;71;939;948;9;4;2.0
9;72;948;965;17;4;2.0
9;73;965;968;3;4;2.0
9;74;968;969;1;4;2.0
9;75;969;976;7;4;2.0
9;76;976;981;5;4;2.0
9;77;981;999;18;4;2.0
9;78;999;1008;9;4;2.0
9;79;1008;1013;5;4;2.0
9;80;1013;1018;5;4;2.0
9;81;1018;1025;7;4;2.0
9;82;1025;1026;1;4;2.0
9;83;1026;1043;17;4;2.0
9;84;1043;1068;25;4;2.0
9;85;1068;1094;26;4;2.0
9;86;1094;1099;5;4;2.0
9;87;1099;1147;48;4;2.0
9;88;1147;1152;5;4;2.0
9;89;1152;1156;4;4;2.0
9;90;1156;1182;26;4;2.0
9;91;1182;1224;42;4;2.0
9;92;1224;1229;5;4;2.0
9;93;1229;1264;35;4;2.0
9;94;1264;1272;8;4;2.0
9;95;1272;1287;15;4;2.0
9;96;1287;1305;18;4;2.0
9;97;1305;1338;33;4;2.0
9;98;1338;1342;4;4;2.0
9;99;1342;1372;30;4;2.0
9;100;1372;1374;2;4;2.0
9;101;1374;1392;18;4;2.0
9;102;1392;1400;8;4;2.0
9;103;1400;1415;15;4;2.0
9;104;1415;1430;15;4;2.0
9;105;1430;1445;15;4;2.0
9;106;1445;1460;15;4;2.0
9;107;1460;1475;15;4;2.0
9;108;1475;1490;15;4;2.0
9;109;1490;1505;15;4;2.0
9;110;1505;1520;15;4;2.0
9;111;1520;1535;15;4;2.0
9;112;1535;1550;15;4;2.0
9;113;1550;1565;15;4;2.0
9;114;1565;1580;15;4;2.0
9;115;1580;1595;15;4;2.0
9;116;1595;1610;15;4;2.0
9;117;1610;1625;15;4;2.0
9;118;1625;1640;15;4;2.0
9;119;1640;1655;15;4;2.0
9;120;1655;1670;15;4;2.0
9;121;1670;1680;10;4;2.0
10;0;252;332;80;11;2.0
10;1;332;338;6;11;2.0
10;2;338;339;1;11;2.0
10;3;339;358;19;11;2.0
10;4;358;367;9;11;2.0
10;5;367;369;2;11;2.0
10;6;369;371;2;11;2.0
10;7;371;378;7;11;2.0
10;8;378;389;11;11;2.0
10;9;389;390;1;11;2.0
10;10;390;402;12;11;2.0
10;11;402;429;27;11;2.0
10;12;429;431;2;11;2.0
10;13;431;435;4;11;2.0
10;14;435;450;15;11;2.0
10;15;450;454;4;11;2.0
10;16;454;459;5;11;2.0
10;17;459;478;19;11;2.0
10;18;478;486;8;11;2.0
10;19;486;487;1;11;2.0
10;20;487;489;2;11;2.0
10;21;489;505;16;11;2.0
10;22;505;520;15;11;2.0
10;23;520;543;23;11;2.0
10;24;543;549;6;11;2.0
10;25;549;555;6;11;2.0
10;26;555;574;19;11;2.0
10;27;574;583;9;11;2.0
10;28;583;600;17;11;2.0
10;29;600;603;3;11;2.0
10;30;603;619;16;11;2.0
10;31;619;621;2;11;2.0
10;32;621;634;13;11;2.0
10;33;634;635;1;11;2.0
10;34;635;663;28;11;2.0
10;35;663;694;31;11;2.0
10;36;694;709;15;11;2.0
10;37;709;720;11;11;2.0
10;38;720;723;3;11;2.0
10;39;723;739;16;11;2.0
10;40;739;741;2;11;2.0
10;41;741;755;14;11;2.0
10;42;755;769;14;11;2.0
10;43;769;783;14;11;2.0
10;44;783;794;11;11;2.0
10;45;794;801;7;11;2.0
10;46;801;806;5;11;2.0
10;47;806;814;8;11;2.0
10;48;814;825;11;11;2.0
10;49;825;829;4;11;2.0
10;50;829;838;9;11;2.0
10;51;838;840;2;11;2.0
10;52;840;843;3;11;2.0
10;53;843;849;6;11;2.0
10;54;849;861;12;11;2.0
10;55;861;863;2;11;2.0
10;56;863;864;1;11;2.0
10;57;864;873;9;11;2.0
10;58;873;889;16;11;2.0
10;59;889;890;1;11;2.0
10;60;890;903;13;11;2.0
10;61;903;904;1;11;2.0
10;62;904;905;1;11;2.0
10;63;905;914;9;11;2.0
10;64;914;916;2;11;2.0
10;65;916;919;3;11;2.0
10;66;919;921;2;11;2.0
10;67;921;924;3;11;2.0
10;68;924;933;9;11;2.0
10;69;933;935;2;11;2.0
10;70;935;949;14;11;2.0
10;71;949;950;1;11;2.0
10;72;950;964;14;11;2.0
10;73;964;965;1;11;2.0
10;74;965;976;11;11;2.0
10;75;976;979;3;11;2.0
10;76;979;981;2;11;2.0
10;77;981;1009;28;11;2.0
10;78;1009;1010;1;11;2.0
10;79;1010;1014;4;11;2.0
10;80;1014;1025;11;11;2.0
10;81;1025;1026;1;11;2.0
10;82;1026;1044;18;11;2.0
10;83;1044;1070;26;11;2.0
10;84;1070;1089;19;11;2.0
10;85;1089;1099;10;11;2.0
10;86;1099;1143;44;11;2.0
10;87;1143;1154;11;11;2.0
10;88;1154;1156;2;11;2.0
10;89;1156;1182;26;11;2.0
10;90;1182;1219;37;11;2.0
10;91;1219;1229;10;11;2.0
10;92;1229;1265;36;11;2.0
10;93;1265;1274;9;11;2.0
10;94;1274;1287;13;11;2.0
10;95;1287;1310;23;11;2.0
10;96;1310;1339;29;11;2.0
10;97;1339;1343;4;11;2.0
10;98;1343;1374;31;11;2.0
10;99;1374;1375;1;11;2.0
10;100;1375;1394;19;11;2.0
10;101;1394;1400;6;11;2.0
10;102;1400;1415;15;11;2.0
10;103;1415;1430;15;11;2.0
10;104;1430;1445;15;11;2.0
10;105;1445;1460;15;11;2.0
10;106;1460;1475;15;11;2.0
10;107;1475;1490;15;11;2.0
10;108;1490;1505;15;11;2.0
10;109;1505;1520;15;11;2.0
10;110;1520;1535;15;11;2.0
10;111;1535;1550;15;11;2.0
10;112;1550;1565;15;11;2.0
10;113;1565;1580;15;11;2.0
10;114;1580;1595;15;11;2.0
10;115;1595;1610;15;11;2.0
10;116;1610;1625;15;11;2.0
10;117;1625;1640;15;11;2.0
10;118;1640;1655;15;11;2.0
10;119;1655;1680;25;11;2.0
11;0;250;334;84;87;2.0
11;1;334;335;1;87;2.0
11;2;335;341;6;87;2.0
11;3;341;364;23;87;2.0
11;4;364;381;17;87;2.0
11;5;381;386;5;87;2.0
11;6;386;394;8;87;2.0
11;7;394;408;14;87;2.0
11;8;408;424;16;87;2.0
11;9;424;426;2;87;2.0
11;10;426;441;15;87;2.0
11;11;441;443;2;87;2.0
11;12;443;454;11;87;2.0
11;13;454;456;2;87;2.0
11;14;456;463;7;87;2.0
11;15;463;480;17;87;2.0
11;16;480;482;2;87;2.0
11;17;482;486;4;87;2.0
11;18;486;493;7;87;2.0
11;19;493;513;20;87;2.0
11;20;513;524;11;87;2.0
11;21;524;540;16;87;2.0
11;22;540;546;6;87;2.0
11;23;546;557;11;87;2.0
11;24;557;580;23;87;2.0
11;25;580;584;4;87;2.0
11;26;584;600;16;87;2.0
11;27;600;608;8;87;2.0
11;28;608;625;17;87;2.0
11;29;625;628;3;87;2.0
11;30;628;631;3;87;2.0
11;31;631;639;8;87;2.0
11;32;639;660;21;87;2.0
11;33;660;704;44;87;2.0
11;34;704;706;2;87;2.0
11;35;706;720;14;87;2.0
11;36;720;728;8;87;2.0
11;37;728;745;17;87;2.0
11;38;745;748;3;87;2.0
11;39;748;759;11;87;2.0
11;40;759;766;7;87;2.0
11;41;766;780;14;87;2.0
11;42;780;804;24;87;2.0
11;43;804;805;1;87;2.0
11;44;805;809;4;87;2.0
11;45;809;810;1;87;2.0
11;46;810;826;16;87;2.0
11;47;826;833;7;87;2.0
11;48;833;840;7;87;2.0
11;49;840;842;2;87;2.0
11;50;842;844;2;87;2.0
11;51;844;846;2;87;2.0
11;52;846;860;14;87;2.0
11;53;860;865;5;87;2.0
11;54;865;868;3;87;2.0
11;55;868;879;11;87;2.0
11;56;879;886;7;87;2.0
11;57;886;898;12;87;2.0
11;58;898;900;2;87;2.0
11;59;900;909;9;87;2.0
11;60;909;914;5;87;2.0
11;61;914;916;2;87;2.0
11;62;916;920;4;87;2.0
11;63;920;925;5;87;2.0
11;64;925;933;8;87;2.0
11;65;933;939;6;87;2.0
11;66;939;946;7;87;2.0
11;67;946;958;12;87;2.0
11;68;958;969;11;87;2.0
11;69;969;974;5;87;2.0
11;70;974;976;2;87;2.0
11;71;976;980;4;87;2.0
11;72;980;985;5;87;2.0
11;73;985;1006;21;87;2.0
11;74;1006;1008;2;87;2.0
11;75;1008;1018;10;87;2.0
11;76;1018;1024;6;87;2.0
11;77;1024;1029;5;87;2.0
11;78;1029;1030;1;87;2.0
11;79;1030;1038;8;87;2.0
11;80;1038;1078;40;87;2.0
11;81;1078;1098;20;87;2.0
11;82;1098;1103;5;87;2.0
11;83;1103;1153;50;87;2.0
11;84;1153;1160;7;87;2.0
11;85;1160;1162;2;87;2.0
11;86;1162;1186;24;87;2.0
11;87;1186;1228;42;87;2.0
11;88;1228;1233;5;87;2.0
11;89;1233;1260;27;87;2.0
11;90;1260;1282;22;87;2.0
11;91;1282;1291;9;87;2.0
11;92;1291;1316;25;87;2.0
11;93;1316;1334;18;87;2.0
11;94;1334;1349;15;87;2.0
11;95;1349;1370;21;87;2.0
11;96;1370;1373;3;87;2.0
11;97;1373;1402;29;87;2.0
11;98;1402;1404;2;87;2.0
11;99;1404;1419;15;87;2.0
11;100;1419;1434;15;87;2.0
11;101;1434;1449;15;87;2.0
11;102;1449;1464;15;87;2.0
11;103;1464;1479;15;87;2.0
11;104;1479;1494;15;87;2.0
11;105;1494;1509;15;87;2.0
11;106;1509;1524;15;87;2.0
11;107;1524;1539;15;87;2.0
11;108;1539;1554;15;87;2.0
11;109;1554;1569;15;87;2.0
11;110;1569;1584;15;87;2.0
11;111;1584;1599;15;87;2.0
11;112;1599;1614;15;87;2.0
11;113;1614;1629;15;87;2.0
11;114;1629;1644;15;87;2.0
11;115;1644;1659;15;87;2.0
11;116;1659;1680;21;87;2.0
12;0;246;330;84;72;2.0
12;1;330;331;1;72;2.0
12;2;331;337;6;72;2.0
12;3;337;358;21;72;2.0
12;4;358;360;2;72;2.0
12;5;360;376;16;72;2.0
12;6;376;380;4;72;2.0
12;7;380;382;2;72;2.0
12;8;382;389;7;72;2.0
12;9;389;402;13;72;2.0
12;10;402;420;18;72;2.0
12;11;420;422;2;72;2.0
12;12;422;436;14;72;2.0
12;13;436;437;1;72;2.0
12;14;437;449;12;72;2.0
12;15;449;450;1;72;2.0
12;16;450;452;2;72;2.0
12;17;452;459;7;72;2.0
12;18;459;475;16;72;2.0
12;19;475;477;2;72;2.0
12;20;477;482;5;72;2.0
12;21;482;487;5;72;2.0
12;22;487;507;20;72;2.0
12;23;507;519;12;72;2.0
12;24;519;532;13;72;2.0
12;25;532;542;10;72;2.0
12;26;542;550;8;72;2.0
12;27;550;576;26;72;2.0
12;28;576;579;3;72;2.0
12;29;579;592;13;72;2.0
12;30;592;602;10;72;2.0
12;31;602;620;18;72;2.0
12;32;620;624;4;72;2.0
12;33;624;627;3;72;2.0
12;34;627;634;7;72;2.0
12;35;634;652;18;72;2.0
12;36;652;699;47;72;2.0
12;37;699;702;3;72;2.0
12;38;702;712;10;72;2.0
12;39;712;722;10;72;2.0
12;40;722;740;18;72;2.0
12;41;740;744;4;72;2.0
12;42;744;754;10;72;2.0
12;43;754;762;8;72;2.0
12;44;762;772;10;72;2.0
12;45;772;799;27;72;2.0
12;46;799;800;1;72;2.0
12;47;800;805;5;72;2.0
12;48;805;822;17;72;2.0
12;49;822;827;5;72;2.0
12;50;827;832;5;72;2.0
12;51;832;837;5;72;2.0
12;52;837;840;3;72;2.0
12;53;840;856;16;72;2.0
12;54;856;860;4;72;2.0
12;55;860;863;3;72;2.0
12;56;863;873;10;72;2.0
12;57;873;882;9;72;2.0
12;58;882;892;10;72;2.0
12;59;892;904;12;72;2.0
12;60;904;905;1;72;2.0
12;61;905;909;4;72;2.0
12;62;909;912;3;72;2.0
12;63;912;915;3;72;2.0
12;64;915;920;5;72;2.0
12;65;920;929;9;72;2.0
12;66;929;933;4;72;2.0
12;67;933;934;1;72;2.0
12;68;934;942;8;72;2.0
12;69;942;952;10;72;2.0
12;70;952;964;12;72;2.0
12;71;964;969;5;72;2.0
12;72;969;972;3;72;2.0
12;73;972;975;3;72;2.0
12;74;975;980;5;72;2.0
12;75;980;1002;22;72;2.0
12;76;1002;1003;1;72;2.0
12;77;1003;1012;9;72;2.0
12;78;1012;1019;7;72;2.0
12;79;1019;1024;5;72;2.0
12;80;1024;1025;1;72;2.0
12;81;1025;1033;8;72;2.0
12;82;1033;1072;39;72;2.0
12;83;1072;1094;22;72;2.0
12;84;1094;1098;4;72;2.0
12;85;1098;1148;50;72;2.0
12;86;1148;1155;7;72;2.0
12;87;1155;1156;1;72;2.0
12;88;1156;1181;25;72;2.0
12;89;1181;1224;43;72;2.0
12;90;1224;1228;4;72;2.0
12;91;1228;1256;28;72;2.0
12;92;1256;1276;20;72;2.0
12;93;1276;1286;10;72;2.0
12;94;1286;1310;24;72;2.0
12;95;1310;1330;20;72;2.0
12;96;1330;1343;13;72;2.0
12;97;1343;1366;23;72;2.0
12;98;1366;1369;3;72;2.0
12;99;1369;1396;27;72;2.0
12;100;1396;1399;3;72;2.0
12;101;1399;1414;15;72;2.0
12;102;1414;1429;15;72;2.0
12;103;1429;1444;15;72;2.0
12;104;1444;1459;15;72;2.0
12;105;1459;1474;15;72;2.0
12;106;1474;1489;15;72;2.0
12;107;1489;1504;15;72;2.0
12;108;1504;1519;15;72;2.0
12;109;1519;1534;15;72;2.0
12;110;1534;1549;15;72;2.0
12;111;1549;1564;15;72;2.0
12;112;1564;1579;15;72;2.0
12;113;1579;1594;15;72;2.0
12;114;1594;1609;15;72;2.0
12;115;1609;1624;15;72;2.0
12;116;1624;1639;15;72;2.0
12;117;1639;1654;15;72;2.0
12;118;1654;1669;15;72;2.0
12;119;1669;1680;11;72;2.0
13;0;249;326;77;58;2.0
13;1;326;337;11;58;2.0
13;2;337;338;1;58;2.0
13;3;338;355;17;58;2.0
13;4;355;358;3;58;2.0
13;5;358;367;9;58;2.0
13;6;367;376;9;58;2.0
13;7;376;377;1;58;2.0
13;8;377;391;14;58;2.0
13;9;391;399;8;58;2.0
13;10;399;417;18;58;2.0
13;11;417;427;10;58;2.0
13;12;427;434;7;58;2.0
13;13;434;436;2;58;2.0
13;14;436;447;11;58;2.0
13;15;447;451;4;58;2.0
13;16;451;457;6;58;2.0
13;17;457;460;3;58;2.0
13;18;460;477;17;58;2.0
13;19;477;479;2;58;2.0
13;20;479;484;5;58;2.0
13;21;484;504;20;58;2.0
13;22;504;521;17;58;2.0
13;23;521;536;15;58;2.0
13;24;536;537;1;58;2.0
13;25;537;552;15;58;2.0
13;26;552;571;19;58;2.0
13;27;571;579;8;58;2.0
13;28;579;596;17;58;2.0
13;29;596;599;3;58;2.0
13;30;599;622;23;58;2.0
13;31;622;625;3;58;2.0
13;32;625;636;11;58;2.0
13;33;636;656;20;58;2.0
13;34;656;697;41;58;2.0
13;35;697;699;2;58;2.0
13;36;699;716;17;58;2.0
13;37;716;719;3;58;2.0
13;38;719;742;23;58;2.0
13;39;742;745;3;58;2.0
13;40;745;756;11;58;2.0
13;41;756;757;1;58;2.0
13;42;757;776;19;58;2.0
13;43;776;799;23;58;2.0
13;44;799;802;3;58;2.0
13;45;802;807;5;58;2.0
13;46;807;812;5;58;2.0
13;47;812;817;5;58;2.0
13;48;817;824;7;58;2.0
13;49;824;836;12;58;2.0
13;50;836;837;1;58;2.0
13;51;837;839;2;58;2.0
13;52;839;847;8;58;2.0
13;53;847;851;4;58;2.0
13;54;851;862;11;58;2.0
13;55;862;865;3;58;2.0
13;56;865;873;8;58;2.0
13;57;873;877;4;58;2.0
13;58;877;889;12;58;2.0
13;59;889;896;7;58;2.0
13;60;896;906;10;58;2.0
13;61;906;907;1;58;2.0
13;62;907;909;2;58;2.0
13;63;909;912;3;58;2.0
13;64;912;917;5;58;2.0
13;65;917;922;5;58;2.0
13;66;922;930;8;58;2.0
13;67;930;933;3;58;2.0
13;68;933;936;3;58;2.0
13;69;936;937;1;58;2.0
13;70;937;949;12;58;2.0
13;71;949;966;17;58;2.0
13;72;966;967;1;58;2.0
13;73;967;969;2;58;2.0
13;74;969;977;8;58;2.0
13;75;977;982;5;58;2.0
13;76;982;997;15;58;2.0
13;77;997;1009;12;58;2.0
13;78;1009;1012;3;58;2.0
13;79;1012;1019;7;58;2.0
13;80;1019;1026;7;58;2.0
13;81;1026;1027;1;58;2.0
13;82;1027;1042;15;58;2.0
13;83;1042;1069;27;58;2.0
13;84;1069;1095;26;58;2.0
13;85;1095;1100;5;58;2.0
13;86;1100;1148;48;58;2.0
13;87;1148;1153;5;58;2.0
13;88;1153;1157;4;58;2.0
13;89;1157;1183;26;58;2.0
13;90;1183;1225;42;58;2.0
13;91;1225;1230;5;58;2.0
13;92;1230;1263;33;58;2.0
13;93;1263;1273;10;58;2.0
13;94;1273;1288;15;58;2.0
13;95;1288;1307;19;58;2.0
13;96;1307;1337;30;58;2.0
13;97;1337;1343;6;58;2.0
13;98;1343;1372;29;58;2.0
13;99;1372;1373;1;58;2.0
13;100;1373;1393;20;58;2.0
13;101;1393;1401;8;58;2.0
13;102;1401;1416;15;58;2.0
13;103;1416;1431;15;58;2.0
13;104;1431;1446;15;58;2.0
13;105;1446;1461;15;58;2.0
13;106;1461;1476;15;58;2.0
13;107;1476;1491;15;58;2.0
13;108;1491;1506;15;58;2.0
13;109;1506;1521;15;58;2.0
13;110;1521;1536;15;58;2.0
13;111;1536;1551;15;58;2.0
13;112;1551;1566;15;58;2.0
13;113;1566;1581;15;58;2.0
13;114;1581;1596;15;58;2.0
13;115;1596;1611;15;58;2.0
13;116;1611;1626;15;58;2.0
13;117;1626;1641;15;58;2.0
13;118;1641;1656;15;58;2.0
13;119;1656;1680;24;58;2.0
14;0;257;336;79;115;2.0
14;1;336;340;4;115;2.0
14;2;340;343;3;115;2.0
14;3;343;364;21;115;2.0
14;4;364;370;6;115;2.0
14;5;370;372;2;115;2.0
14;6;372;378;6;115;2.0
14;7;378;384;6;115;2.0
14;8;384;394;10;115;2.0
14;9;394;396;2;115;2.0
14;10;396;408;12;115;2.0
14;11;408;430;22;115;2.0
14;12;430;434;4;115;2.0
14;13;434;438;4;115;2.0
14;14;438;441;3;115;2.0
14;15;441;456;15;115;2.0
14;16;456;458;2;115;2.0
14;17;458;460;2;115;2.0
14;18;460;464;4;115;2.0
14;19;464;484;20;115;2.0
14;20;484;488;4;115;2.0
14;21;488;493;5;115;2.0
14;22;493;494;1;115;2.0
14;23;494;511;17;115;2.0
14;24;511;526;15;115;2.0
14;25;526;546;20;115;2.0
14;26;546;554;8;115;2.0
14;27;554;560;6;115;2.0
14;28;560;581;21;115;2.0
14;29;581;588;7;115;2.0
14;30;588;606;18;115;2.0
14;31;606;623;17;115;2.0
14;32;623;627;4;115;2.0
14;33;627;639;12;115;2.0
14;34;639;641;2;115;2.0
14;35;641;666;25;115;2.0
14;36;666;701;35;115;2.0
14;37;701;714;13;115;2.0
14;38;714;726;12;115;2.0
14;39;726;743;17;115;2.0
14;40;743;747;4;115;2.0
14;41;747;761;14;115;2.0
14;42;761;774;13;115;2.0
14;43;774;786;12;115;2.0
14;44;786;801;15;115;2.0
14;45;801;807;6;115;2.0
14;46;807;812;5;115;2.0
14;47;812;815;3;115;2.0
14;48;815;831;16;115;2.0
14;49;831;834;3;115;2.0
14;50;834;844;10;115;2.0
14;51;844;846;2;115;2.0
14;52;846;850;4;115;2.0
14;53;850;867;17;115;2.0
14;54;867;868;1;115;2.0
14;55;868;870;2;115;2.0
14;56;870;879;9;115;2.0
14;57;879;894;15;115;2.0
14;58;894;896;2;115;2.0
14;59;896;906;10;115;2.0
14;60;906;911;5;115;2.0
14;61;911;915;4;115;2.0
14;62;915;922;7;115;2.0
14;63;922;924;2;115;2.0
14;64;924;927;3;115;2.0
14;65;927;928;1;115;2.0
14;66;928;939;11;115;2.0
14;67;939;941;2;115;2.0
14;68;941;954;13;115;2.0
14;69;954;956;2;115;2.0
14;70;956;971;15;115;2.0
14;71;971;982;11;115;2.0
14;72;982;984;2;115;2.0
14;73;984;987;3;115;2.0
14;74;987;1014;27;115;2.0
14;75;1014;1016;2;115;2.0
14;76;1016;1021;5;115;2.0
14;77;1021;1031;10;115;2.0
14;78;1031;1032;1;115;2.0
14;79;1032;1046;14;115;2.0
14;80;1046;1076;30;115;2.0
14;81;1076;1093;17;115;2.0
14;82;1093;1105;12;115;2.0
14;83;1105;1150;45;115;2.0
14;84;1150;1160;10;115;2.0
14;85;1160;1162;2;115;2.0
14;86;1162;1188;26;115;2.0
14;87;1188;1223;35;115;2.0
14;88;1223;1235;12;115;2.0
14;89;1235;1266;31;115;2.0
14;90;1266;1280;14;115;2.0
14;91;1280;1293;13;115;2.0
14;92;1293;1316;23;115;2.0
14;93;1316;1340;24;115;2.0
14;94;1340;1349;9;115;2.0
14;95;1349;1375;26;115;2.0
14;96;1375;1376;1;115;2.0
14;97;1376;1400;24;115;2.0
14;98;1400;1406;6;115;2.0
14;99;1406;1421;15;115;2.0
14;100;1421;1436;15;115;2.0
14;101;1436;1451;15;115;2.0
14;102;1451;1466;15;115;2.0
14;103;1466;1481;15;115;2.0
14;104;1481;1496;15;115;2.0
14;105;1496;1511;15;115;2.0
14;106;1511;1526;15;115;2.0
14;107;1526;1541;15;115;2.0
14;108;1541;1556;15;115;2.0
14;109;1556;1571;15;115;2.0
14;110;1571;1586;15;115;2.0
14;111;1586;1601;15;115;2.0
14;112;1601;1616;15;115;2.0
14;113;1616;1631;15;115;2.0
14;114;1631;1646;15;115;2.0
14;115;1646;1661;15;115;2.0
14;116;1661;1680;19;115;2.0
15;0;260;344;84;159;2.0
15;1;344;347;3;159;2.0
15;2;347;358;11;159;2.0
15;3;358;365;7;159;2.0
15;4;365;373;8;159;2.0
15;5;373;377;4;159;2.0
15;6;377;381;4;159;2.0
15;7;381;395;14;159;2.0
15;8;395;398;3;159;2.0
15;9;398;406;8;159;2.0
15;10;406;415;9;159;2.0
15;11;415;435;20;159;2.0
15;12;435;437;2;159;2.0
15;13;437;441;4;159;2.0
15;14;441;458;17;159;2.0
15;15;458;465;7;159;2.0
15;16;465;466;1;159;2.0
15;17;466;467;1;159;2.0
15;18;467;485;18;159;2.0
15;19;485;486;1;159;2.0
15;20;486;491;5;159;2.0
15;21;491;495;4;159;2.0
15;22;495;528;33;159;2.0
15;23;528;550;22;159;2.0
15;24;550;555;5;159;2.0
15;25;555;562;7;159;2.0
15;26;562;580;18;159;2.0
15;27;580;584;4;159;2.0
15;28;584;589;5;159;2.0
15;29;589;610;21;159;2.0
15;30;610;629;19;159;2.0
15;31;629;631;2;159;2.0
15;32;631;640;9;159;2.0
15;33;640;643;3;159;2.0
15;34;643;670;27;159;2.0
15;35;670;700;30;159;2.0
15;36;700;704;4;159;2.0
15;37;704;715;11;159;2.0
15;38;715;730;15;159;2.0
15;39;730;749;19;159;2.0
15;40;749;751;2;159;2.0
15;41;751;763;12;159;2.0
15;42;763;775;12;159;2.0
15;43;775;790;15;159;2.0
15;44;790;804;14;159;2.0
15;45;804;805;1;159;2.0
15;46;805;809;4;159;2.0
15;47;809;814;5;159;2.0
15;48;814;822;8;159;2.0
15;49;822;835;13;159;2.0
15;50;835;844;9;159;2.0
15;51;844;846;2;159;2.0
15;52;846;850;4;159;2.0
15;53;850;857;7;159;2.0
15;54;857;869;12;159;2.0
15;55;869;870;1;159;2.0
15;56;870;872;2;159;2.0
15;57;872;880;8;159;2.0
15;58;880;895;15;159;2.0
15;59;895;910;15;159;2.0
15;60;910;913;3;159;2.0
15;61;913;914;1;159;2.0
15;62;914;922;8;159;2.0
15;63;922;924;2;159;2.0
15;64;924;925;1;159;2.0
15;65;925;929;4;159;2.0
15;66;929;930;1;159;2.0
15;67;930;936;6;159;2.0
15;68;936;940;4;159;2.0
15;69;940;943;3;159;2.0
15;70;943;955;12;159;2.0
15;71;955;973;18;159;2.0
15;72;973;974;1;159;2.0
15;73;974;984;10;159;2.0
15;74;984;985;1;159;2.0
15;75;985;989;4;159;2.0
15;76;989;990;1;159;2.0
15;77;990;1015;25;159;2.0
15;78;1015;1023;8;159;2.0
15;79;1023;1024;1;159;2.0
15;80;1024;1033;9;159;2.0
15;81;1033;1034;1;159;2.0
15;82;1034;1050;16;159;2.0
15;83;1050;1053;3;159;2.0
15;84;1053;1101;48;159;2.0
15;85;1101;1107;6;159;2.0
15;86;1107;1134;27;159;2.0
15;87;1134;1153;19;159;2.0
15;88;1153;1164;11;159;2.0
15;89;1164;1190;26;159;2.0
15;90;1190;1231;41;159;2.0
15;91;1231;1237;6;159;2.0
15;92;1237;1254;17;159;2.0
15;93;1254;1273;19;159;2.0
15;94;1273;1295;22;159;2.0
15;95;1295;1314;19;159;2.0
15;96;1314;1347;33;159;2.0
15;97;1347;1350;3;159;2.0
15;98;1350;1374;24;159;2.0
15;99;1374;1382;8;159;2.0
15;100;1382;1383;1;159;2.0
15;101;1383;1408;25;159;2.0
15;102;1408;1423;15;159;2.0
15;103;1423;1438;15;159;2.0
15;104;1438;1453;15;159;2.0
15;105;1453;1468;15;159;2.0
15;106;1468;1483;15;159;2.0
15;107;1483;1498;15;159;2.0
15;108;1498;1513;15;159;2.0
15;109;1513;1528;15;159;2.0
15;110;1528;1543;15;159;2.0
15;111;1543;1558;15;159;2.0
15;112;1558;1573;15;159;2.0
15;113;1573;1588;15;159;2.0
15;114;1588;1603;15;159;2.0
15;115;1603;1618;15;159;2.0
15;116;1618;1633;15;159;2.0
15;117;1633;1648;15;159;2.0
15;118;1648;1680;32;159;2.0
16;0;247;325;78;14;2.0
16;1;325;335;10;14;2.0
16;2;335;336;1;14;2.0
16;3;336;356;20;14;2.0
16;4;356;365;9;14;2.0
16;5;365;370;5;14;2.0
16;6;370;376;6;14;2.0
16;7;376;387;11;14;2.0
16;8;387;388;1;14;2.0
16;9;388;400;12;14;2.0
16;10;400;425;25;14;2.0
16;11;425;427;2;14;2.0
16;12;427;430;3;14;2.0
16;13;430;433;3;14;2.0
16;14;433;447;14;14;2.0
16;15;447;448;1;14;2.0
16;16;448;455;7;14;2.0
16;17;455;457;2;14;2.0
16;18;457;476;19;14;2.0
16;19;476;483;7;14;2.0
16;20;483;485;2;14;2.0
16;21;485;487;2;14;2.0
16;22;487;503;16;14;2.0
16;23;503;518;15;14;2.0
16;24;518;541;23;14;2.0
16;25;541;547;6;14;2.0
16;26;547;553;6;14;2.0
16;27;553;573;20;14;2.0
16;28;573;581;8;14;2.0
16;29;581;598;17;14;2.0
16;30;598;601;3;14;2.0
16;31;601;612;11;14;2.0
16;32;612;619;7;14;2.0
16;33;619;632;13;14;2.0
16;34;632;633;1;14;2.0
16;35;633;661;28;14;2.0
16;36;661;693;32;14;2.0
16;37;693;707;14;14;2.0
16;38;707;718;11;14;2.0
16;39;718;721;3;14;2.0
16;40;721;732;11;14;2.0
16;41;732;739;7;14;2.0
16;42;739;753;14;14;2.0
16;43;753;767;14;14;2.0
16;44;767;781;14;14;2.0
16;45;781;793;12;14;2.0
16;46;793;799;6;14;2.0
16;47;799;804;5;14;2.0
16;48;804;810;6;14;2.0
16;49;810;823;13;14;2.0
16;50;823;827;4;14;2.0
16;51;827;836;9;14;2.0
16;52;836;837;1;14;2.0
16;53;837;841;4;14;2.0
16;54;841;845;4;14;2.0
16;55;845;859;14;14;2.0
16;56;859;861;2;14;2.0
16;57;861;862;1;14;2.0
16;58;862;871;9;14;2.0
16;59;871;887;16;14;2.0
16;60;887;888;1;14;2.0
16;61;888;901;13;14;2.0
16;62;901;903;2;14;2.0
16;63;903;910;7;14;2.0
16;64;910;914;4;14;2.0
16;65;914;917;3;14;2.0
16;66;917;919;2;14;2.0
16;67;919;931;12;14;2.0
16;68;931;933;2;14;2.0
16;69;933;947;14;14;2.0
16;70;947;948;1;14;2.0
16;71;948;963;15;14;2.0
16;72;963;974;11;14;2.0
16;73;974;977;3;14;2.0
16;74;977;979;2;14;2.0
16;75;979;1007;28;14;2.0
16;76;1007;1008;1;14;2.0
16;77;1008;1011;3;14;2.0
16;78;1011;1013;2;14;2.0
16;79;1013;1023;10;14;2.0
16;80;1023;1024;1;14;2.0
16;81;1024;1041;17;14;2.0
16;82;1041;1068;27;14;2.0
16;83;1068;1082;14;14;2.0
16;84;1082;1097;15;14;2.0
16;85;1097;1142;45;14;2.0
16;86;1142;1152;10;14;2.0
16;87;1152;1154;2;14;2.0
16;88;1154;1180;26;14;2.0
16;89;1180;1212;32;14;2.0
16;90;1212;1227;15;14;2.0
16;91;1227;1261;34;14;2.0
16;92;1261;1272;11;14;2.0
16;93;1272;1285;13;14;2.0
16;94;1285;1308;23;14;2.0
16;95;1308;1335;27;14;2.0
16;96;1335;1341;6;14;2.0
16;97;1341;1370;29;14;2.0
16;98;1370;1371;1;14;2.0
16;99;1371;1392;21;14;2.0
16;100;1392;1398;6;14;2.0
16;101;1398;1413;15;14;2.0
16;102;1413;1428;15;14;2.0
16;103;1428;1443;15;14;2.0
16;104;1443;1458;15;14;2.0
16;105;1458;1473;15;14;2.0
16;106;1473;1488;15;14;2.0
16;107;1488;1503;15;14;2.0
16;108;1503;1518;15;14;2.0
16;109;1518;1533;15;14;2.0
16;110;1533;1548;15;14;2.0
16;111;1548;1563;15;14;2.0
16;112;1563;1578;15;14;2.0
16;113;1578;1593;15;14;2.0
16;114;1593;1608;15;14;2.0
16;115;1608;1623;15;14;2.0
16;116;1623;1638;15;14;2.0
16;117;1638;1653;15;14;2.0
16;118;1653;1668;15;14;2.0
16;119;1668;1680;12;14;2.0
17;0;252;333;81;99;2.0
17;1;333;339;6;99;2.0
17;2;339;340;1;99;2.0
17;3;340;359;19;99;2.0
17;4;359;361;2;99;2.0
17;5;361;368;7;99;2.0
17;6;368;370;2;99;2.0
17;7;370;378;8;99;2.0
17;8;378;390;12;99;2.0
17;9;390;391;1;99;2.0
17;10;391;403;12;99;2.0
17;11;403;421;18;99;2.0
17;12;421;430;9;99;2.0
17;13;430;435;5;99;2.0
17;14;435;451;16;99;2.0
17;15;451;455;4;99;2.0
17;16;455;460;5;99;2.0
17;17;460;479;19;99;2.0
17;18;479;487;8;99;2.0
17;19;487;488;1;99;2.0
17;20;488;490;2;99;2.0
17;21;490;505;15;99;2.0
17;22;505;521;16;99;2.0
17;23;521;544;23;99;2.0
17;24;544;550;6;99;2.0
17;25;550;556;6;99;2.0
17;26;556;564;8;99;2.0
17;27;564;584;20;99;2.0
17;28;584;600;16;99;2.0
17;29;600;604;4;99;2.0
17;30;604;620;16;99;2.0
17;31;620;622;2;99;2.0
17;32;622;635;13;99;2.0
17;33;635;636;1;99;2.0
17;34;636;664;28;99;2.0
17;35;664;684;20;99;2.0
17;36;684;710;26;99;2.0
17;37;710;720;10;99;2.0
17;38;720;724;4;99;2.0
17;39;724;740;16;99;2.0
17;40;740;742;2;99;2.0
17;41;742;756;14;99;2.0
17;42;756;770;14;99;2.0
17;43;770;784;14;99;2.0
17;44;784;802;18;99;2.0
17;45;802;807;5;99;2.0
17;46;807;815;8;99;2.0
17;47;815;825;10;99;2.0
17;48;825;830;5;99;2.0
17;49;830;839;9;99;2.0
17;50;839;840;1;99;2.0
17;51;840;844;4;99;2.0
17;52;844;850;6;99;2.0
17;53;850;862;12;99;2.0
17;54;862;864;2;99;2.0
17;55;864;865;1;99;2.0
17;56;865;874;9;99;2.0
17;57;874;890;16;99;2.0
17;58;890;894;4;99;2.0
17;59;894;904;10;99;2.0
17;60;904;906;2;99;2.0
17;61;906;914;8;99;2.0
17;62;914;917;3;99;2.0
17;63;917;920;3;99;2.0
17;64;920;922;2;99;2.0
17;65;922;925;3;99;2.0
17;66;925;934;9;99;2.0
17;67;934;936;2;99;2.0
17;68;936;950;14;99;2.0
17;69;950;954;4;99;2.0
17;70;954;966;12;99;2.0
17;71;966;977;11;99;2.0
17;72;977;980;3;99;2.0
17;73;980;982;2;99;2.0
17;74;982;1004;22;99;2.0
17;75;1004;1010;6;99;2.0
17;76;1010;1015;5;99;2.0
17;77;1015;1026;11;99;2.0
17;78;1026;1027;1;99;2.0
17;79;1027;1045;18;99;2.0
17;80;1045;1070;25;99;2.0
17;81;1070;1090;20;99;2.0
17;82;1090;1100;10;99;2.0
17;83;1100;1133;33;99;2.0
17;84;1133;1154;21;99;2.0
17;85;1154;1157;3;99;2.0
17;86;1157;1183;26;99;2.0
17;87;1183;1220;37;99;2.0
17;88;1220;1230;10;99;2.0
17;89;1230;1266;36;99;2.0
17;90;1266;1274;8;99;2.0
17;91;1274;1288;14;99;2.0
17;92;1288;1311;23;99;2.0
17;93;1311;1340;29;99;2.0
17;94;1340;1344;4;99;2.0
17;95;1344;1375;31;99;2.0
17;96;1375;1376;1;99;2.0
17;97;1376;1394;18;99;2.0
17;98;1394;1401;7;99;2.0
17;99;1401;1416;15;99;2.0
17;100;1416;1431;15;99;2.0
17;101;1431;1446;15;99;2.0
17;102;1446;1461;15;99;2.0
17;103;1461;1476;15;99;2.0
17;104;1476;1491;15;99;2.0
17;105;1491;1506;15;99;2.0
17;106;1506;1521;15;99;2.0
17;107;1521;1536;15;99;2.0
17;108;1536;1551;15;99;2.0
17;109;1551;1566;15;99;2.0
17;110;1566;1581;15;99;2.0
17;111;1581;1596;15;99;2.0
17;112;1596;1611;15;99;2.0
17;113;1611;1626;15;99;2.0
17;114;1626;1641;15;99;2.0
17;115;1641;1656;15;99;2.0
17;116;1656;1680;24;99;2.0
18;0;246;331;85;501;2.0
18;1;331;332;1;501;2.0
18;2;332;337;5;501;2.0
18;3;337;356;19;501;2.0
18;4;356;360;4;501;2.0
18;5;360;362;2;501;2.0
18;6;362;375;13;501;2.0
18;7;375;378;3;501;2.0
18;8;378;382;4;501;2.0
18;9;382;388;6;501;2.0
18;10;388;401;13;501;2.0
18;11;401;422;21;501;2.0
18;12;422;435;13;501;2.0
18;13;435;448;13;501;2.0
18;14;448;452;4;501;2.0
18;15;452;459;7;501;2.0
18;16;459;476;17;501;2.0
18;17;476;478;2;501;2.0
18;18;478;482;4;501;2.0
18;19;482;486;4;501;2.0
18;20;486;505;19;501;2.0
18;21;505;518;13;501;2.0
18;22;518;529;11;501;2.0
18;23;529;542;13;501;2.0
18;24;542;549;7;501;2.0
18;25;549;576;27;501;2.0
18;26;576;578;2;501;2.0
18;27;578;589;11;501;2.0
18;28;589;600;11;501;2.0
18;29;600;619;19;501;2.0
18;30;619;624;5;501;2.0
18;31;624;627;3;501;2.0
18;32;627;633;6;501;2.0
18;33;633;649;16;501;2.0
18;34;649;698;49;501;2.0
18;35;698;702;4;501;2.0
18;36;702;709;7;501;2.0
18;37;709;720;11;501;2.0
18;38;720;739;19;501;2.0
18;39;739;744;5;501;2.0
18;40;744;753;9;501;2.0
18;41;753;762;9;501;2.0
18;42;762;769;7;501;2.0
18;43;769;798;29;501;2.0
18;44;798;799;1;501;2.0
18;45;799;804;5;501;2.0
18;46;804;807;3;501;2.0
18;47;807;822;15;501;2.0
18;48;822;825;3;501;2.0
18;49;825;829;4;501;2.0
18;50;829;836;7;501;2.0
18;51;836;838;2;501;2.0
18;52;838;842;4;501;2.0
18;53;842;856;14;501;2.0
18;54;856;859;3;501;2.0
18;55;859;862;3;501;2.0
18;56;862;871;9;501;2.0
18;57;871;882;11;501;2.0
18;58;882;889;7;501;2.0
18;59;889;890;1;501;2.0
18;60;890;903;13;501;2.0
18;61;903;907;4;501;2.0
18;62;907;908;1;501;2.0
18;63;908;912;4;501;2.0
18;64;912;914;2;501;2.0
18;65;914;919;5;501;2.0
18;66;919;929;10;501;2.0
18;67;929;931;2;501;2.0
18;68;931;933;2;501;2.0
18;69;933;942;9;501;2.0
18;70;942;950;8;501;2.0
18;71;950;963;13;501;2.0
18;72;963;968;5;501;2.0
18;73;968;972;4;501;2.0
18;74;972;974;2;501;2.0
18;75;974;979;5;501;2.0
18;76;979;1002;23;501;2.0
18;77;1002;1006;4;501;2.0
18;78;1006;1010;4;501;2.0
18;79;1010;1018;8;501;2.0
18;80;1018;1023;5;501;2.0
18;81;1023;1024;1;501;2.0
18;82;1024;1036;12;501;2.0
18;83;1036;1070;34;501;2.0
18;84;1070;1094;24;501;2.0
18;85;1094;1097;3;501;2.0
18;86;1097;1147;50;501;2.0
18;87;1147;1154;7;501;2.0
18;88;1154;1180;26;501;2.0
18;89;1180;1224;44;501;2.0
18;90;1224;1227;3;501;2.0
18;91;1227;1258;31;501;2.0
18;92;1258;1274;16;501;2.0
18;93;1274;1285;11;501;2.0
18;94;1285;1309;24;501;2.0
18;95;1309;1332;23;501;2.0
18;96;1332;1341;9;501;2.0
18;97;1341;1368;27;501;2.0
18;98;1368;1369;1;501;2.0
18;99;1369;1394;25;501;2.0
18;100;1394;1398;4;501;2.0
18;101;1398;1413;15;501;2.0
18;102;1413;1428;15;501;2.0
18;103;1428;1443;15;501;2.0
18;104;1443;1458;15;501;2.0
18;105;1458;1473;15;501;2.0
18;106;1473;1488;15;501;2.0
18;107;1488;1503;15;501;2.0
18;108;1503;1518;15;501;2.0
18;109;1518;1533;15;501;2.0
18;110;1533;1548;15;501;2.0
18;111;1548;1563;15;501;2.0
18;112;1563;1578;15;501;2.0
18;113;1578;1593;15;501;2.0
18;114;1593;1608;15;501;2.0
18;115;1608;1623;15;501;2.0
18;116;1623;1638;15;501;2.0
18;117;1638;1653;15;501;2.0
18;118;1653;1668;15;501;2.0
18;119;1668;1680;12;501;2.0
19;0;250;320;70;66;2.0
19;1;320;340;20;66;2.0
19;2;340;341;1;66;2.0
19;3;341;350;9;66;2.0
19;4;350;363;13;66;2.0
19;5;363;369;6;66;2.0
19;6;369;380;11;66;2.0
19;7;380;385;5;66;2.0
19;8;385;391;6;66;2.0
19;9;391;394;3;66;2.0
19;10;394;408;14;66;2.0
19;11;408;410;2;66;2.0
19;12;410;431;21;66;2.0
19;13;431;440;9;66;2.0
19;14;440;442;2;66;2.0
19;15;442;454;12;66;2.0
19;16;454;461;7;66;2.0
19;17;461;463;2;66;2.0
19;18;463;481;18;66;2.0
19;19;481;482;1;66;2.0
19;20;482;491;9;66;2.0
19;21;491;493;2;66;2.0
19;22;493;512;19;66;2.0
19;23;512;524;12;66;2.0
19;24;524;541;17;66;2.0
19;25;541;551;10;66;2.0
19;26;551;557;6;66;2.0
19;27;557;583;26;66;2.0
19;28;583;585;2;66;2.0
19;29;585;601;16;66;2.0
19;30;601;607;6;66;2.0
19;31;607;625;18;66;2.0
19;32;625;628;3;66;2.0
19;33;628;636;8;66;2.0
19;34;636;639;3;66;2.0
19;35;639;661;22;66;2.0
19;36;661;703;42;66;2.0
19;37;703;711;8;66;2.0
19;38;711;721;10;66;2.0
19;39;721;727;6;66;2.0
19;40;727;745;18;66;2.0
19;41;745;748;3;66;2.0
19;42;748;759;11;66;2.0
19;43;759;771;12;66;2.0
19;44;771;781;10;66;2.0
19;45;781;795;14;66;2.0
19;46;795;803;8;66;2.0
19;47;803;805;2;66;2.0
19;48;805;810;5;66;2.0
19;49;810;830;20;66;2.0
19;50;830;831;1;66;2.0
19;51;831;832;1;66;2.0
19;52;832;841;9;66;2.0
19;53;841;842;1;66;2.0
19;54;842;846;4;66;2.0
19;55;846;865;19;66;2.0
19;56;865;868;3;66;2.0
19;57;868;878;10;66;2.0
19;58;878;891;13;66;2.0
19;59;891;896;5;66;2.0
19;60;896;897;1;66;2.0
19;61;897;901;4;66;2.0
19;62;901;909;8;66;2.0
19;63;909;913;4;66;2.0
19;64;913;920;7;66;2.0
19;65;920;921;1;66;2.0
19;66;921;925;4;66;2.0
19;67;925;933;8;66;2.0
19;68;933;938;5;66;2.0
19;69;938;939;1;66;2.0
19;70;939;951;12;66;2.0
19;71;951;957;6;66;2.0
19;72;957;969;12;66;2.0
19;73;969;973;4;66;2.0
19;74;973;980;7;66;2.0
19;75;980;981;1;66;2.0
19;76;981;985;4;66;2.0
19;77;985;1009;24;66;2.0
19;78;1009;1011;2;66;2.0
19;79;1011;1017;6;66;2.0
19;80;1017;1023;6;66;2.0
19;81;1023;1029;6;66;2.0
19;82;1029;1030;1;66;2.0
19;83;1030;1039;9;66;2.0
19;84;1039;1077;38;66;2.0
19;85;1077;1098;21;66;2.0
19;86;1098;1103;5;66;2.0
19;87;1103;1152;49;66;2.0
19;88;1152;1160;8;66;2.0
19;89;1160;1161;1;66;2.0
19;90;1161;1186;25;66;2.0
19;91;1186;1228;42;66;2.0
19;92;1228;1233;5;66;2.0
19;93;1233;1246;13;66;2.0
19;94;1246;1281;35;66;2.0
19;95;1281;1291;10;66;2.0
19;96;1291;1316;25;66;2.0
19;97;1316;1320;4;66;2.0
19;98;1320;1348;28;66;2.0
19;99;1348;1356;8;66;2.0
19;100;1356;1372;16;66;2.0
19;101;1372;1401;29;66;2.0
19;102;1401;1404;3;66;2.0
19;103;1404;1419;15;66;2.0
19;104;1419;1434;15;66;2.0
19;105;1434;1449;15;66;2.0
19;106;1449;1464;15;66;2.0
19;107;1464;1479;15;66;2.0
19;108;1479;1494;15;66;2.0
19;109;1494;1509;15;66;2.0
19;110;1509;1524;15;66;2.0
19;111;1524;1539;15;66;2.0
19;112;1539;1554;15;66;2.0
19;113;1554;1569;15;66;2.0
19;114;1569;1584;15;66;2.0
19;115;1584;1599;15;66;2.0
19;116;1599;1614;15;66;2.0
19;117;1614;1629;15;66;2.0
19;118;1629;1644;15;66;2.0
19;119;1644;1659;15;66;2.0
19;120;1659;1680;21;66;2.0
20;0;252;323;71;63;2.0
20;1;323;342;19;63;2.0
20;2;342;343;1;63;2.0
20;3;343;353;10;63;2.0
20;4;353;365;12;63;2.0
20;5;365;371;6;63;2.0
20;6;371;382;11;63;2.0
20;7;382;387;5;63;2.0
20;8;387;393;6;63;2.0
20;9;393;396;3;63;2.0
20;10;396;410;14;63;2.0
20;11;410;413;3;63;2.0
20;12;413;433;20;63;2.0
20;13;433;442;9;63;2.0
20;14;442;443;1;63;2.0
20;15;443;444;1;63;2.0
20;16;444;456;12;63;2.0
20;17;456;463;7;63;2.0
20;18;463;465;2;63;2.0
20;19;465;483;18;63;2.0
20;20;483;484;1;63;2.0
20;21;484;493;9;63;2.0
20;22;493;495;2;63;2.0
20;23;495;514;19;63;2.0
20;24;514;526;12;63;2.0
20;25;526;543;17;63;2.0
20;26;543;553;10;63;2.0
20;27;553;559;6;63;2.0
20;28;559;585;26;63;2.0
20;29;585;587;2;63;2.0
20;30;587;603;16;63;2.0
20;31;603;609;6;63;2.0
20;32;609;627;18;63;2.0
20;33;627;630;3;63;2.0
20;34;630;638;8;63;2.0
20;35;638;641;3;63;2.0
20;36;641;663;22;63;2.0
20;37;663;705;42;63;2.0
20;38;705;713;8;63;2.0
20;39;713;723;10;63;2.0
20;40;723;729;6;63;2.0
20;41;729;747;18;63;2.0
20;42;747;750;3;63;2.0
20;43;750;761;11;63;2.0
20;44;761;773;12;63;2.0
20;45;773;783;10;63;2.0
20;46;783;798;15;63;2.0
20;47;798;805;7;63;2.0
20;48;805;807;2;63;2.0
20;49;807;812;5;63;2.0
20;50;812;833;21;63;2.0
20;51;833;834;1;63;2.0
20;52;834;843;9;63;2.0
20;53;843;844;1;63;2.0
20;54;844;848;4;63;2.0
20;55;848;867;19;63;2.0
20;56;867;870;3;63;2.0
20;57;870;880;10;63;2.0
20;58;880;893;13;63;2.0
20;59;893;899;6;63;2.0
20;60;899;903;4;63;2.0
20;61;903;911;8;63;2.0
20;62;911;915;4;63;2.0
20;63;915;922;7;63;2.0
20;64;922;923;1;63;2.0
20;65;923;927;4;63;2.0
20;66;927;935;8;63;2.0
20;67;935;940;5;63;2.0
20;68;940;941;1;63;2.0
20;69;941;953;12;63;2.0
20;70;953;959;6;63;2.0
20;71;959;971;12;63;2.0
20;72;971;975;4;63;2.0
20;73;975;982;7;63;2.0
20;74;982;983;1;63;2.0
20;75;983;987;4;63;2.0
20;76;987;1011;24;63;2.0
20;77;1011;1013;2;63;2.0
20;78;1013;1019;6;63;2.0
20;79;1019;1025;6;63;2.0
20;80;1025;1031;6;63;2.0
20;81;1031;1032;1;63;2.0
20;82;1032;1041;9;63;2.0
20;83;1041;1079;38;63;2.0
20;84;1079;1100;21;63;2.0
20;85;1100;1105;5;63;2.0
20;86;1105;1154;49;63;2.0
20;87;1154;1162;8;63;2.0
20;88;1162;1163;1;63;2.0
20;89;1163;1188;25;63;2.0
20;90;1188;1230;42;63;2.0
20;91;1230;1235;5;63;2.0
20;92;1235;1249;14;63;2.0
20;93;1249;1283;34;63;2.0
20;94;1283;1293;10;63;2.0
20;95;1293;1318;25;63;2.0
20;96;1318;1323;5;63;2.0
20;97;1323;1350;27;63;2.0
20;98;1350;1359;9;63;2.0
20;99;1359;1374;15;63;2.0
20;100;1374;1403;29;63;2.0
20;101;1403;1406;3;63;2.0
20;102;1406;1421;15;63;2.0
20;103;1421;1436;15;63;2.0
20;104;1436;1451;15;63;2.0
20;105;1451;1466;15;63;2.0
20;106;1466;1481;15;63;2.0
20;107;1481;1496;15;63;2.0
20;108;1496;1511;15;63;2.0
20;109;1511;1526;15;63;2.0
20;110;1526;1541;15;63;2.0
20;111;1541;1556;15;63;2.0
20;112;1556;1571;15;63;2.0
20;113;1571;1586;15;63;2.0
20;114;1586;1601;15;63;2.0
20;115;1601;1616;15;63;2.0
20;116;1616;1631;15;63;2.0
20;117;1631;1646;15;63;2.0
20;118;1646;1661;15;63;2.0
20;119;1661;1680;19;63;2.0
21;0;249;333;84;114;2.0
21;1;333;335;2;114;2.0
21;2;335;337;2;114;2.0
21;3;337;356;19;114;2.0
21;4;356;362;6;114;2.0
21;5;362;367;5;114;2.0
21;6;367;372;5;114;2.0
21;7;372;373;1;114;2.0
21;8;373;384;11;114;2.0
21;9;384;389;5;114;2.0
21;10;389;394;5;114;2.0
21;11;394;424;30;114;2.0
21;12;424;427;3;114;2.0
21;13;427;430;3;114;2.0
21;14;430;432;2;114;2.0
21;15;432;449;17;114;2.0
21;16;449;454;5;114;2.0
21;17;454;457;3;114;2.0
21;18;457;477;20;114;2.0
21;19;477;479;2;114;2.0
21;20;479;484;5;114;2.0
21;21;484;500;16;114;2.0
21;22;500;519;19;114;2.0
21;23;519;539;20;114;2.0
21;24;539;544;5;114;2.0
21;25;544;552;8;114;2.0
21;26;552;575;23;114;2.0
21;27;575;578;3;114;2.0
21;28;578;595;17;114;2.0
21;29;595;599;4;114;2.0
21;30;599;620;21;114;2.0
21;31;620;622;2;114;2.0
21;32;622;629;7;114;2.0
21;33;629;634;5;114;2.0
21;34;634;659;25;114;2.0
21;35;659;695;36;114;2.0
21;36;695;704;9;114;2.0
21;37;704;715;11;114;2.0
21;38;715;719;4;114;2.0
21;39;719;740;21;114;2.0
21;40;740;742;2;114;2.0
21;41;742;754;12;114;2.0
21;42;754;764;10;114;2.0
21;43;764;779;15;114;2.0
21;44;779;795;16;114;2.0
21;45;795;800;5;114;2.0
21;46;800;805;5;114;2.0
21;47;805;812;7;114;2.0
21;48;812;820;8;114;2.0
21;49;820;824;4;114;2.0
21;50;824;829;5;114;2.0
21;51;829;837;8;114;2.0
21;52;837;839;2;114;2.0
21;53;839;847;8;114;2.0
21;54;847;858;11;114;2.0
21;55;858;860;2;114;2.0
21;56;860;863;3;114;2.0
21;57;863;871;8;114;2.0
21;58;871;884;13;114;2.0
21;59;884;885;1;114;2.0
21;60;885;899;14;114;2.0
21;61;899;904;5;114;2.0
21;62;904;905;1;114;2.0
21;63;905;912;7;114;2.0
21;64;912;914;2;114;2.0
21;65;914;915;1;114;2.0
21;66;915;920;5;114;2.0
21;67;920;927;7;114;2.0
21;68;927;931;4;114;2.0
21;69;931;934;3;114;2.0
21;70;934;944;10;114;2.0
21;71;944;945;1;114;2.0
21;72;945;964;19;114;2.0
21;73;964;965;1;114;2.0
21;74;965;974;9;114;2.0
21;75;974;975;1;114;2.0
21;76;975;980;5;114;2.0
21;77;980;1004;24;114;2.0
21;78;1004;1005;1;114;2.0
21;79;1005;1012;7;114;2.0
21;80;1012;1015;3;114;2.0
21;81;1015;1024;9;114;2.0
21;82;1024;1025;1;114;2.0
21;83;1025;1042;17;114;2.0
21;84;1042;1065;23;114;2.0
21;85;1065;1092;27;114;2.0
21;86;1092;1098;6;114;2.0
21;87;1098;1144;46;114;2.0
21;88;1144;1149;5;114;2.0
21;89;1149;1155;6;114;2.0
21;90;1155;1181;26;114;2.0
21;91;1181;1222;41;114;2.0
21;92;1222;1228;6;114;2.0
21;93;1228;1263;35;114;2.0
21;94;1263;1269;6;114;2.0
21;95;1269;1286;17;114;2.0
21;96;1286;1302;16;114;2.0
21;97;1302;1337;35;114;2.0
21;98;1337;1341;4;114;2.0
21;99;1341;1372;31;114;2.0
21;100;1372;1373;1;114;2.0
21;101;1373;1389;16;114;2.0
21;102;1389;1399;10;114;2.0
21;103;1399;1414;15;114;2.0
21;104;1414;1429;15;114;2.0
21;105;1429;1444;15;114;2.0
21;106;1444;1459;15;114;2.0
21;107;1459;1474;15;114;2.0
21;108;1474;1489;15;114;2.0
21;109;1489;1504;15;114;2.0
21;110;1504;1519;15;114;2.0
21;111;1519;1534;15;114;2.0
21;112;1534;1549;15;114;2.0
21;113;1549;1564;15;114;2.0
21;114;1564;1579;15;114;2.0
21;115;1579;1594;15;114;2.0
21;116;1594;1609;15;114;2.0
21;117;1609;1624;15;114;2.0
21;118;1624;1639;15;114;2.0
21;119;1639;1654;15;114;2.0
21;120;1654;1669;15;114;2.0
21;121;1669;1680;11;114;2.0
22;0;243;332;89;42;2.0
22;1;332;352;20;42;2.0
22;2;352;361;9;42;2.0
22;3;361;362;1;42;2.0
22;4;362;369;7;42;2.0
22;5;369;374;5;42;2.0
22;6;374;383;9;42;2.0
22;7;383;398;15;42;2.0
22;8;398;422;24;42;2.0
22;9;422;423;1;42;2.0
22;10;423;429;6;42;2.0
22;11;429;431;2;42;2.0
22;12;431;443;12;42;2.0
22;13;443;452;9;42;2.0
22;14;452;453;1;42;2.0
22;15;453;454;1;42;2.0
22;16;454;471;17;42;2.0
22;17;471;480;9;42;2.0
22;18;480;483;3;42;2.0
22;19;483;501;18;42;2.0
22;20;501;513;12;42;2.0
22;21;513;536;23;42;2.0
22;22;536;543;7;42;2.0
22;23;543;548;5;42;2.0
22;24;548;572;24;42;2.0
22;25;572;577;5;42;2.0
22;26;577;596;19;42;2.0
22;27;596;614;18;42;2.0
22;28;614;619;5;42;2.0
22;29;619;628;9;42;2.0
22;30;628;656;28;42;2.0
22;31;656;692;36;42;2.0
22;32;692;703;11;42;2.0
22;33;703;716;13;42;2.0
22;34;716;734;18;42;2.0
22;35;734;739;5;42;2.0
22;36;739;748;9;42;2.0
22;37;748;763;15;42;2.0
22;38;763;776;13;42;2.0
22;39;776;792;16;42;2.0
22;40;792;794;2;42;2.0
22;41;794;799;5;42;2.0
22;42;799;807;8;42;2.0
22;43;807;821;14;42;2.0
22;44;821;823;2;42;2.0
22;45;823;831;8;42;2.0
22;46;831;836;5;42;2.0
22;47;836;842;6;42;2.0
22;48;842;854;12;42;2.0
22;49;854;857;3;42;2.0
22;50;857;867;10;42;2.0
22;51;867;883;16;42;2.0
22;52;883;886;3;42;2.0
22;53;886;896;10;42;2.0
22;54;896;898;2;42;2.0
22;55;898;902;4;42;2.0
22;56;902;907;5;42;2.0
22;57;907;909;2;42;2.0
22;58;909;913;4;42;2.0
22;59;913;914;1;42;2.0
22;60;914;924;10;42;2.0
22;61;924;927;3;42;2.0
22;62;927;928;1;42;2.0
22;63;928;943;15;42;2.0
22;64;943;946;3;42;2.0
22;65;946;958;12;42;2.0
22;66;958;962;4;42;2.0
22;67;962;969;7;42;2.0
22;68;969;973;4;42;2.0
22;69;973;974;1;42;2.0
22;70;974;1003;29;42;2.0
22;71;1003;1006;3;42;2.0
22;72;1006;1008;2;42;2.0
22;73;1008;1012;4;42;2.0
22;74;1012;1018;6;42;2.0
22;75;1018;1019;1;42;2.0
22;76;1019;1038;19;42;2.0
22;77;1038;1066;28;42;2.0
22;78;1066;1089;23;42;2.0
22;79;1089;1092;3;42;2.0
22;80;1092;1141;49;42;2.0
22;81;1141;1149;8;42;2.0
22;82;1149;1150;1;42;2.0
22;83;1150;1175;25;42;2.0
22;84;1175;1219;44;42;2.0
22;85;1219;1222;3;42;2.0
22;86;1222;1258;36;42;2.0
22;87;1258;1270;12;42;2.0
22;88;1270;1280;10;42;2.0
22;89;1280;1306;26;42;2.0
22;90;1306;1332;26;42;2.0
22;91;1332;1337;5;42;2.0
22;92;1337;1367;30;42;2.0
22;93;1367;1368;1;42;2.0
22;94;1368;1390;22;42;2.0
22;95;1390;1393;3;42;2.0
22;96;1393;1408;15;42;2.0
22;97;1408;1423;15;42;2.0
22;98;1423;1438;15;42;2.0
22;99;1438;1453;15;42;2.0
22;100;1453;1468;15;42;2.0
22;101;1468;1483;15;42;2.0
22;102;1483;1498;15;42;2.0
22;103;1498;1513;15;42;2.0
22;104;1513;1528;15;42;2.0
22;105;1528;1543;15;42;2.0
22;106;1543;1558;15;42;2.0
22;107;1558;1573;15;42;2.0
22;108;1573;1588;15;42;2.0
22;109;1588;1603;15;42;2.0
22;110;1603;1618;15;42;2.0
22;111;1618;1633;15;42;2.0
22;112;1633;1648;15;42;2.0
22;113;1648;1663;15;42;2.0
22;114;1663;1680;17;42;2.0
23;0;245;332;87;25;2.0
23;1;332;333;1;25;2.0
23;2;333;351;18;25;2.0
23;3;351;361;10;25;2.0
23;4;361;363;2;25;2.0
23;5;363;369;6;25;2.0
23;6;369;374;5;25;2.0
23;7;374;383;9;25;2.0
23;8;383;384;1;25;2.0
23;9;384;398;14;25;2.0
23;10;398;423;25;25;2.0
23;11;423;429;6;25;2.0
23;12;429;431;2;25;2.0
23;13;431;444;13;25;2.0
23;14;444;453;9;25;2.0
23;15;453;454;1;25;2.0
23;16;454;472;18;25;2.0
23;17;472;480;8;25;2.0
23;18;480;483;3;25;2.0
23;19;483;501;18;25;2.0
23;20;501;514;13;25;2.0
23;21;514;536;22;25;2.0
23;22;536;543;7;25;2.0
23;23;543;548;5;25;2.0
23;24;548;572;24;25;2.0
23;25;572;577;5;25;2.0
23;26;577;596;19;25;2.0
23;27;596;615;19;25;2.0
23;28;615;619;4;25;2.0
23;29;619;628;9;25;2.0
23;30;628;629;1;25;2.0
23;31;629;656;27;25;2.0
23;32;656;692;36;25;2.0
23;33;692;703;11;25;2.0
23;34;703;716;13;25;2.0
23;35;716;735;19;25;2.0
23;36;735;739;4;25;2.0
23;37;739;749;10;25;2.0
23;38;749;763;14;25;2.0
23;39;763;776;13;25;2.0
23;40;776;792;16;25;2.0
23;41;792;795;3;25;2.0
23;42;795;800;5;25;2.0
23;43;800;808;8;25;2.0
23;44;808;821;13;25;2.0
23;45;821;823;2;25;2.0
23;46;823;832;9;25;2.0
23;47;832;835;3;25;2.0
23;48;835;836;1;25;2.0
23;49;836;843;7;25;2.0
23;50;843;855;12;25;2.0
23;51;855;857;2;25;2.0
23;52;857;858;1;25;2.0
23;53;858;866;8;25;2.0
23;54;866;883;17;25;2.0
23;55;883;886;3;25;2.0
23;56;886;896;10;25;2.0
23;57;896;899;3;25;2.0
23;58;899;902;3;25;2.0
23;59;902;908;6;25;2.0
23;60;908;910;2;25;2.0
23;61;910;913;3;25;2.0
23;62;913;915;2;25;2.0
23;63;915;924;9;25;2.0
23;64;924;926;2;25;2.0
23;65;926;929;3;25;2.0
23;66;929;943;14;25;2.0
23;67;943;946;3;25;2.0
23;68;946;959;13;25;2.0
23;69;959;962;3;25;2.0
23;70;962;970;8;25;2.0
23;71;970;973;3;25;2.0
23;72;973;975;2;25;2.0
23;73;975;1003;28;25;2.0
23;74;1003;1006;3;25;2.0
23;75;1006;1008;2;25;2.0
23;76;1008;1012;4;25;2.0
23;77;1012;1019;7;25;2.0
23;78;1019;1020;1;25;2.0
23;79;1020;1038;18;25;2.0
23;80;1038;1066;28;25;2.0
23;81;1066;1089;23;25;2.0
23;82;1089;1093;4;25;2.0
23;83;1093;1141;48;25;2.0
23;84;1141;1150;9;25;2.0
23;85;1150;1176;26;25;2.0
23;86;1176;1219;43;25;2.0
23;87;1219;1223;4;25;2.0
23;88;1223;1259;36;25;2.0
23;89;1259;1270;11;25;2.0
23;90;1270;1281;11;25;2.0
23;91;1281;1306;25;25;2.0
23;92;1306;1333;27;25;2.0
23;93;1333;1336;3;25;2.0
23;94;1336;1368;32;25;2.0
23;95;1368;1369;1;25;2.0
23;96;1369;1390;21;25;2.0
23;97;1390;1394;4;25;2.0
23;98;1394;1409;15;25;2.0
23;99;1409;1424;15;25;2.0
23;100;1424;1439;15;25;2.0
23;101;1439;1454;15;25;2.0
23;102;1454;1469;15;25;2.0
23;103;1469;1484;15;25;2.0
23;104;1484;1499;15;25;2.0
23;105;1499;1514;15;25;2.0
23;106;1514;1529;15;25;2.0
23;107;1529;1544;15;25;2.0
23;108;1544;1559;15;25;2.0
23;109;1559;1574;15;25;2.0
23;110;1574;1589;15;25;2.0
23;111;1589;1604;15;25;2.0
23;112;1604;1619;15;25;2.0
23;113;1619;1634;15;25;2.0
23;114;1634;1649;15;25;2.0
23;115;1649;1664;15;25;2.0
23;116;1664;1680;16;25;2.0
24;0;240;330;90;0;0.83
24;1;330;333;3;0;0.83
24;2;333;355;22;0;0.83
24;3;355;360;5;0;0.83
24;4;360;362;2;0;0.83
24;5;362;372;10;0;0.83
24;6;372;378;6;0;0.83
24;7;378;384;6;0;0.83
24;8;384;386;2;0;0.83
24;9;386;400;14;0;0.83
24;10;400;420;20;0;0.83
24;11;420;424;4;0;0.83
24;12;424;432;8;0;0.83
24;13;432;435;3;0;0.83
24;14;435;446;11;0;0.83
24;15;446;450;4;0;0.83
24;16;450;454;4;0;0.83
24;17;454;455;1;0;0.83
24;18;455;474;19;0;0.83
24;19;474;477;3;0;0.83
24;20;477;484;7;0;0.83
24;21;484;485;1;0;0.83
24;22;485;505;20;0;0.83
24;23;505;516;11;0;0.83
24;24;516;536;20;0;0.83
24;25;536;544;8;0;0.83
24;26;544;548;4;0;0.83
24;27;548;575;27;0;0.83
24;28;575;578;3;0;0.83
24;29;578;596;18;0;0.83
24;30;596;600;4;0;0.83
24;31;600;617;17;0;0.83
24;32;617;620;3;0;0.83
24;33;620;629;9;0;0.83
24;34;629;631;2;0;0.83
24;35;631;656;25;0;0.83
24;36;656;695;39;0;0.83
24;37;695;704;9;0;0.83
24;38;704;716;12;0;0.83
24;39;716;720;4;0;0.83
24;40;720;737;17;0;0.83
24;41;737;740;3;0;0.83
24;42;740;751;11;0;0.83
24;43;751;764;13;0;0.83
24;44;764;776;12;0;0.83
24;45;776;795;19;0;0.83
24;46;795;797;2;0;0.83
24;47;797;802;5;0;0.83
24;48;802;805;3;0;0.83
24;49;805;824;19;0;0.83
24;50;824;825;1;0;0.83
24;51;825;834;9;0;0.83
24;52;834;836;2;0;0.83
24;53;836;838;2;0;0.83
24;54;838;840;2;0;0.83
24;55;840;857;17;0;0.83
24;56;857;858;1;0;0.83
24;57;858;860;2;0;0.83
24;58;860;870;10;0;0.83
24;59;870;884;14;0;0.83
24;60;884;890;6;0;0.83
24;61;890;896;6;0;0.83
24;62;896;901;5;0;0.83
24;63;901;905;4;0;0.83
24;64;905;912;7;0;0.83
24;65;912;914;2;0;0.83
24;66;914;917;3;0;0.83
24;67;917;925;8;0;0.83
24;68;925;930;5;0;0.83
24;69;930;931;1;0;0.83
24;70;931;944;13;0;0.83
24;71;944;950;6;0;0.83
24;72;950;961;11;0;0.83
24;73;961;965;4;0;0.83
24;74;965;972;7;0;0.83
24;75;972;974;2;0;0.83
24;76;974;977;3;0;0.83
24;77;977;1004;27;0;0.83
24;78;1004;1005;1;0;0.83
24;79;1005;1010;5;0;0.83
24;80;1010;1015;5;0;0.83
24;81;1015;1021;6;0;0.83
24;82;1021;1022;1;0;0.83
24;83;1022;1035;13;0;0.83
24;84;1035;1070;35;0;0.83
24;85;1070;1090;20;0;0.83
24;86;1090;1095;5;0;0.83
24;87;1095;1144;49;0;0.83
24;88;1144;1152;8;0;0.83
24;89;1152;1154;2;0;0.83
24;90;1154;1178;24;0;0.83
24;91;1178;1220;42;0;0.83
24;92;1220;1225;5;0;0.83
24;93;1225;1256;31;0;0.83
24;94;1256;1274;18;0;0.83
24;95;1274;1283;9;0;0.83
24;96;1283;1308;25;0;0.83
24;97;1308;1330;22;0;0.83
24;98;1330;1340;10;0;0.83
24;99;1340;1365;25;0;0.83
24;100;1365;1366;1;0;0.83
24;101;1366;1394;28;0;0.83
24;102;1394;1396;2;0;0.83
24;103;1396;1411;15;0;0.83
24;104;1411;1426;15;0;0.83
24;105;1426;1441;15;0;0.83
24;106;1441;1456;15;0;0.83
24;107;1456;1471;15;0;0.83
24;108;1471;1486;15;0;0.83
24;109;1486;1501;15;0;0.83
24;110;1501;1516;15;0;0.83
24;111;1516;1531;15;0;0.83
24;112;1531;1546;15;0;0.83
24;113;1546;1561;15;0;0.83
24;114;1561;1576;15;0;0.83
24;115;1576;1591;15;0;0.83
24;116;1591;1606;15;0;0.83
24;117;1606;1621;15;0;0.83
24;118;1621;1636;15;0;0.83
24;119;1636;1651;15;0;0.83
24;120;1651;1666;15;0;0.83
24;121;1666;1680;14;0;0.83
25;0;240;330;90;0;0.83
25;1;330;333;3;0;0.83
25;2;333;355;22;0;0.83
25;3;355;360;5;0;0.83
25;4;360;362;2;0;0.83
25;5;362;372;10;0;0.83
25;6;372;378;6;0;0.83
25;7;378;384;6;0;0.83
25;8;384;386;2;0;0.83
25;9;386;400;14;0;0.83
25;10;400;420;20;0;0.83
25;11;420;424;4;0;0.83
25;12;424;432;8;0;0.83
25;13;432;435;3;0;0.83
25;14;435;446;11;0;0.83
25;15;446;450;4;0;0.83
25;16;450;454;4;0;0.83
25;17;454;455;1;0;0.83
25;18;455;474;19;0;0.83
25;19;474;477;3;0;0.83
25;20;477;484;7;0;0.83
25;21;484;485;1;0;0.83
25;22;485;505;20;0;0.83
25;23;505;516;11;0;0.83
25;24;516;536;20;0;0.83
25;25;536;544;8;0;0.83
25;26;544;548;4;0;0.83
25;27;548;575;27;0;0.83
25;28;575;578;3;0;0.83
25;29;578;596;18;0;0.83
25;30;596;600;4;0;0.83
25;31;600;617;17;0;0.83
25;32;617;620;3;0;0.83
25;33;620;629;9;0;0.83
25;34;629;631;2;0;0.83
25;35;631;656;25;0;0.83
25;36;656;695;39;0;0.83
25;37;695;704;9;0;0.83
25;38;704;716;12;0;0.83
25;39;716;720;4;0;0.83
25;40;720;737;17;0;0.83
25;41;737;740;3;0;0.83
25;42;740;751;11;0;0.83
25;43;751;764;13;0;0.83
25;44;764;776;12;0;0.83
25;45;776;795;19;0;0.83
25;46;795;797;2;0;0.83
25;47;797;802;5;0;0.83
25;48;802;805;3;0;0.83
25;49;805;824;19;0;0.83
25;50;824;825;1;0;0.83
25;51;825;834;9;0;0.83
25;52;834;836;2;0;0.83
25;53;836;838;2;0;0.83
25;54;838;840;2;0;0.83
25;55;840;857;17;0;0.83
25;56;857;858;1;0;0.83
25;57;858;860;2;0;0.83
25;58;860;870;10;0;0.83
25;59;870;884;14;0;0.83
25;60;884;890;6;0;0.83
25;61;890;896;6;0;0.83
25;62;896;901;5;0;0.83
25;63;901;905;4;0;0.83
25;64;905;912;7;0;0.83
25;65;912;914;2;0;0.83
25;66;914;917;3;0;0.83
25;67;917;925;8;0;0.83
25;68;925;930;5;0;0.83
25;69;930;931;1;0;0.83
25;70;931;944;13;0;0.83
25;71;944;950;6;0;0.83
25;72;950;961;11;0;0.83
25;73;961;965;4;0;0.83
25;74;965;972;7;0;0.83
25;75;972;974;2;0;0.83
25;76;974;977;3;0;0.83
25;77;977;1004;27;0;0.83
25;78;1004;1005;1;0;0.83
25;79;1005;1010;5;0;0.83
25;80;1010;1015;5;0;0.83
25;81;1015;1021;6;0;0.83
25;82;1021;1022;1;0;0.83
25;83;1022;1035;13;0;0.83
25;84;1035;1070;35;0;0.83
25;85;1070;1090;20;0;0.83
25;86;1090;1095;5;0;0.83
25;87;1095;1144;49;0;0.83
25;88;1144;1152;8;0;0.83
25;89;1152;1154;2;0;0.83
25;90;1154;1178;24;0;0.83
25;91;1178;1220;42;0;0.83
25;92;1220;1225;5;0;0.83
25;93;1225;1256;31;0;0.83
25;94;1256;1274;18;0;0.83
25;95;1274;1283;9;0;0.83
25;96;1283;1308;25;0;0.83
25;97;1308;1330;22;0;0.83
25;98;1330;1340;10;0;0.83
25;99;1340;1365;25;0;0.83
25;100;1365;1366;1;0;0.83
25;101;1366;1394;28;0;0.83
25;102;1394;1396;2;0;0.83
25;103;1396;1411;15;0;0.83
25;104;1411;1426;15;0;0.83
25;105;1426;1441;15;0;0.83
25;106;1441;1456;15;0;0.83
25;107;1456;1471;15;0;0.83
25;108;1471;1486;15;0;0.83
25;109;1486;1501;15;0;0.83
25;110;1501;1516;15;0;0.83
25;111;1516;1531;15;0;0.83
25;112;1531;1546;15;0;0.83
25;113;1546;1561;15;0;0.83
25;114;1561;1576;15;0;0.83
25;115;1576;1591;15;0;0.83
25;116;1591;1606;15;0;0.83
25;117;1606;1621;15;0;0.83
25;118;1621;1636;15;0;0.83
25;119;1636;1651;15;0;0.83
25;120;1651;1666;15;0;0.83
25;121;1666;1680;14;0;0.83
26;0;240;330;90;0;0.83
26;1;330;333;3;0;0.83
26;2;333;355;22;0;0.83
26;3;355;360;5;0;0.83
26;4;360;362;2;0;0.83
26;5;362;372;10;0;0.83
26;6;372;378;6;0;0.83
26;7;378;384;6;0;0.83
26;8;384;386;2;0;0.83
26;9;386;400;14;0;0.83
26;10;400;420;20;0;0.83
26;11;420;424;4;0;0.83
26;12;424;432;8;0;0.83
26;13;432;435;3;0;0.83
26;14;435;446;11;0;0.83
26;15;446;450;4;0;0.83
26;16;450;454;4;0;0.83
26;17;454;455;1;0;0.83
26;18;455;474;19;0;0.83
26;19;474;477;3;0;0.83
26;20;477;484;7;0;0.83
26;21;484;485;1;0;0.83
26;22;485;505;20;0;0.83
26;23;505;516;11;0;0.83
26;24;516;536;20;0;0.83
26;25;536;544;8;0;0.83
26;26;544;548;4;0;0.83
26;27;548;575;27;0;0.83
26;28;575;578;3;0;0.83
26;29;578;596;18;0;0.83
26;30;596;600;4;0;0.83
26;31;600;617;17;0;0.83
26;32;617;620;3;0;0.83
26;33;620;629;9;0;0.83
26;34;629;631;2;0;0.83
26;35;631;656;25;0;0.83
26;36;656;695;39;0;0.83
26;37;695;704;9;0;0.83
26;38;704;716;12;0;0.83
26;39;716;720;4;0;0.83
26;40;720;737;17;0;0.83
26;41;737;740;3;0;0.83
26;42;740;751;11;0;0.83
26;43;751;764;13;0;0.83
26;44;764;776;12;0;0.83
26;45;776;795;19;0;0.83
26;46;795;797;2;0;0.83
26;47;797;802;5;0;0.83
26;48;802;805;3;0;0.83
26;49;805;824;19;0;0.83
26;50;824;825;1;0;0.83
26;51;825;834;9;0;0.83
26;52;834;836;2;0;0.83
26;53;836;838;2;0;0.83
26;54;838;840;2;0;0.83
26;55;840;857;17;0;0.83
26;56;857;858;1;0;0.83
26;57;858;860;2;0;0.83
26;58;860;870;10;0;0.83
26;59;870;884;14;0;0.83
26;60;884;890;6;0;0.83
26;61;890;896;6;0;0.83
26;62;896;901;5;0;0.83
26;63;901;905;4;0;0.83
26;64;905;912;7;0;0.83
26;65;912;914;2;0;0.83
26;66;914;917;3;0;0.83
26;67;917;925;8;0;0.83
26;68;925;930;5;0;0.83
26;69;930;931;1;0;0.83
26;70;931;944;13;0;0.83
26;71;944;950;6;0;0.83
26;72;950;961;11;0;0.83
26;73;961;965;4;0;0.83
26;74;965;972;7;0;0.83
26;75;972;974;2;0;0.83
26;76;974;977;3;0;0.83
26;77;977;1004;27;0;0.83
26;78;1004;1005;1;0;0.83
26;79;1005;1010;5;0;0.83
26;80;1010;1015;5;0;0.83
26;81;1015;1021;6;0;0.83
26;82;1021;1022;1;0;0.83
26;83;1022;1035;13;0;0.83
26;84;1035;1070;35;0;0.83
26;85;1070;1090;20;0;0.83
26;86;1090;1095;5;0;0.83
26;87;1095;1144;49;0;0.83
26;88;1144;1152;8;0;0.83
26;89;1152;1154;2;0;0.83
26;90;1154;1178;24;0;0.83
26;91;1178;1220;42;0;0.83
26;92;1220;1225;5;0;0.83
26;93;1225;1256;31;0;0.83
26;94;1256;1274;18;0;0.83
26;95;1274;1283;9;0;0.83
26;96;1283;1308;25;0;0.83
26;97;1308;1330;22;0;0.83
26;98;1330;1340;10;0;0.83
26;99;1340;1365;25;0;0.83
26;100;1365;1366;1;0;0.83
26;101;1366;1394;28;0;0.83
26;102;1394;1396;2;0;0.83
26;103;1396;1411;15;0;0.83
26;104;1411;1426;15;0;0.83
26;105;1426;1441;15;0;0.83
26;106;1441;1456;15;0;0.83
26;107;1456;1471;15;0;0.83
26;108;1471;1486;15;0;0.83
26;109;1486;1501;15;0;0.83
26;110;1501;1516;15;0;0.83
26;111;1516;1531;15;0;0.83
26;112;1531;1546;15;0;0.83
26;113;1546;1561;15;0;0.83
26;114;1561;1576;15;0;0.83
26;115;1576;1591;15;0;0.83
26;116;1591;1606;15;0;0.83
26;117;1606;1621;15;0;0.83
26;118;1621;1636;15;0;0.83
26;119;1636;1651;15;0;0.83
26;120;1651;1666;15;0;0.83
26;121;1666;1680;14;0;0.83
27;0;240;330;90;0;0.83
27;1;330;333;3;0;0.83
27;2;333;355;22;0;0.83
27;3;355;360;5;0;0.83
27;4;360;362;2;0;0.83
27;5;362;372;10;0;0.83
27;6;372;378;6;0;0.83
27;7;378;384;6;0;0.83
27;8;384;386;2;0;0.83
27;9;386;400;14;0;0.83
27;10;400;420;20;0;0.83
27;11;420;424;4;0;0.83
27;12;424;432;8;0;0.83
27;13;432;435;3;0;0.83
27;14;435;446;11;0;0.83
27;15;446;450;4;0;0.83
27;16;450;454;4;0;0.83
27;17;454;455;1;0;0.83
27;18;455;474;19;0;0.83
27;19;474;477;3;0;0.83
27;20;477;484;7;0;0.83
27;21;484;485;1;0;0.83
27;22;485;505;20;0;0.83
27;23;505;516;11;0;0.83
27;24;516;536;20;0;0.83
27;25;536;544;8;0;0.83
27;26;544;548;4;0;0.83
27;27;548;575;27;0;0.83
27;28;575;578;3;0;0.83
27;29;578;596;18;0;0.83
27;30;596;600;4;0;0.83
27;31;600;617;17;0;0.83
27;32;617;620;3;0;0.83
27;33;620;629;9;0;0.83
27;34;629;631;2;0;0.83
27;35;631;656;25;0;0.83
27;36;656;695;39;0;0.83
27;37;695;704;9;0;0.83
27;38;704;716;12;0;0.83
27;39;716;720;4;0;0.83
27;40;720;737;17;0;0.83
27;41;737;740;3;0;0.83
27;42;740;751;11;0;0.83
27;43;751;764;13;0;0.83
27;44;764;776;12;0;0.83
27;45;776;795;19;0;0.83
27;46;795;797;2;0;0.83
27;47;797;802;5;0;0.83
27;48;802;805;3;0;0.83
27;49;805;824;19;0;0.83
27;50;824;825;1;0;0.83
27;51;825;834;9;0;0.83
27;52;834;836;2;0;0.83
27;53;836;838;2;0;0.83
27;54;838;840;2;0;0.83
27;55;840;857;17;0;0.83
27;56;857;858;1;0;0.83
27;57;858;860;2;0;0.83
27;58;860;870;10;0;0.83
27;59;870;884;14;0;0.83
27;60;884;890;6;0;0.83
27;61;890;896;6;0;0.83
27;62;896;901;5;0;0.83
27;63;901;905;4;0;0.83
27;64;905;912;7;0;0.83
27;65;912;914;2;0;0.83
27;66;914;917;3;0;0.83
27;67;917;925;8;0;0.83
27;68;925;930;5;0;0.83
27;69;930;931;1;0;0.83
27;70;931;944;13;0;0.83
27;71;944;950;6;0;0.83
27;72;950;961;11;0;0.83
27;73;961;965;4;0;0.83
27;74;965;972;7;0;0.83
27;75;972;974;2;0;0.83
27;76;974;977;3;0;0.83
27;77;977;1004;27;0;0.83
27;78;1004;1005;1;0;0.83
27;79;1005;1010;5;0;0.83
27;80;1010;1015;5;0;0.83
27;81;1015;1021;6;0;0.83
27;82;1021;1022;1;0;0.83
27;83;1022;1035;13;0;0.83
27;84;1035;1070;35;0;0.83
27;85;1070;1090;20;0;0.83
27;86;1090;1095;5;0;0.83
27;87;1095;1144;49;0;0.83
27;88;1144;1152;8;0;0.83
27;89;1152;1154;2;0;0.83
27;90;1154;1178;24;0;0.83
27;91;1178;1220;42;0;0.83
27;92;1220;1225;5;0;0.83
27;93;1225;1256;31;0;0.83
27;94;1256;1274;18;0;0.83
27;95;1274;1283;9;0;0.83
27;96;1283;1308;25;0;0.83
27;97;1308;1330;22;0;0.83
27;98;1330;1340;10;0;0.83
27;99;1340;1365;25;0;0.83
27;100;1365;1366;1;0;0.83
27;101;1366;1394;28;0;0.83
27;102;1394;1396;2;0;0.83
27;103;1396;1411;15;0;0.83
27;104;1411;1426;15;0;0.83
27;105;1426;1441;15;0;0.83
27;106;1441;1456;15;0;0.83
27;107;1456;1471;15;0;0.83
27;108;1471;1486;15;0;0.83
27;109;1486;1501;15;0;0.83
27;110;1501;1516;15;0;0.83
27;111;1516;1531;15;0;0.83
27;112;1531;1546;15;0;0.83
27;113;1546;1561;15;0;0.83
27;114;1561;1576;15;0;0.83
27;115;1576;1591;15;0;0.83
27;116;1591;1606;15;0;0.83
27;117;1606;1621;15;0;0.83
27;118;1621;1636;15;0;0.83
27;119;1636;1651;15;0;0.83
27;120;1651;1666;15;0;0.83
27;121;1666;1680;14;0;0.83
28;0;240;330;90;0;0.83
28;1;330;333;3;0;0.83
28;2;333;355;22;0;0.83
28;3;355;360;5;0;0.83
28;4;360;362;2;0;0.83
28;5;362;372;10;0;0.83
28;6;372;378;6;0;0.83
28;7;378;384;6;0;0.83
28;8;384;386;2;0;0.83
28;9;386;400;14;0;0.83
28;10;400;420;20;0;0.83
28;11;420;424;4;0;0.83
28;12;424;432;8;0;0.83
28;13;432;435;3;0;0.83
28;14;435;446;11;0;0.83
28;15;446;450;4;0;0.83
28;16;450;454;4;0;0.83
28;17;454;455;1;0;0.83
28;18;455;474;19;0;0.83
28;19;474;477;3;0;0.83
28;20;477;484;7;0;0.83
28;21;484;485;1;0;0.83
28;22;485;505;20;0;0.83
28;23;505;516;11;0;0.83
28;24;516;536;20;0;0.83
28;25;536;544;8;0;0.83
28;26;544;548;4;0;0.83
28;27;548;575;27;0;0.83
28;28;575;578;3;0;0.83
28;29;578;596;18;0;0.83
28;30;596;600;4;0;0.83
28;31;600;617;17;0;0.83
28;32;617;620;3;0;0.83
28;33;620;629;9;0;0.83
28;34;629;631;2;0;0.83
28;35;631;656;25;0;0.83
28;36;656;695;39;0;0.83
28;37;695;704;9;0;0.83
28;38;704;716;12;0;0.83
28;39;716;720;4;0;0.83
28;40;720;737;17;0;0.83
28;41;737;740;3;0;0.83
28;42;740;751;11;0;0.83
28;43;751;764;13;0;0.83
28;44;764;776;12;0;0.83
28;45;776;795;19;0;0.83
28;46;795;797;2;0;0.83
28;47;797;802;5;0;0.83
28;48;802;805;3;0;0.83
28;49;805;824;19;0;0.83
28;50;824;825;1;0;0.83
28;51;825;834;9;0;0.83
28;52;834;836;2;0;0.83
28;53;836;838;2;0;0.83
28;54;838;840;2;0;0.83
28;55;840;857;17;0;0.83
28;56;857;858;1;0;0.83
28;57;858;860;2;0;0.83
28;58;860;870;10;0;0.83
28;59;870;884;14;0;0.83
28;60;884;890;6;0;0.83
28;61;890;896;6;0;0.83
28;62;896;901;5;0;0.83
28;63;901;905;4;0;0.83
28;64;905;912;7;0;0.83
28;65;912;914;2;0;0.83
28;66;914;917;3;0;0.83
28;67;917;925;8;0;0.83
28;68;925;930;5;0;0.83
28;69;930;931;1;0;0.83
28;70;931;944;13;0;0.83
28;71;944;950;6;0;0.83
28;72;950;961;11;0;0.83
28;73;961;965;4;0;0.83
28;74;965;972;7;0;0.83
28;75;972;974;2;0;0.83
28;76;974;977;3;0;0.83
28;77;977;1004;27;0;0.83
28;78;1004;1005;1;0;0.83
28;79;1005;1010;5;0;0.83
28;80;1010;1015;5;0;0.83
28;81;1015;1021;6;0;0.83
28;82;1021;1022;1;0;0.83
28;83;1022;1035;13;0;0.83
28;84;1035;1070;35;0;0.83
28;85;1070;1090;20;0;0.83
28;86;1090;1095;5;0;0.83
28;87;1095;1144;49;0;0.83
28;88;1144;1152;8;0;0.83
28;89;1152;1154;2;0;0.83
28;90;1154;1178;24;0;0.83
28;91;1178;1220;42;0;0.83
28;92;1220;1225;5;0;0.83
28;93;1225;1256;31;0;0.83
28;94;1256;1274;18;0;0.83
28;95;1274;1283;9;0;0.83
28;96;1283;1308;25;0;0.83
28;97;1308;1330;22;0;0.83
28;98;1330;1340;10;0;0.83
28;99;1340;1365;25;0;0.83
28;100;1365;1366;1;0;0.83
28;101;1366;1394;28;0;0.83
28;102;1394;1396;2;0;0.83
28;103;1396;1411;15;0;0.83
28;104;1411;1426;15;0;0.83
28;105;1426;1441;15;0;0.83
28;106;1441;1456;15;0;0.83
28;107;1456;1471;15;0;0.83
28;108;1471;1486;15;0;0.83
28;109;1486;1501;15;0;0.83
28;110;1501;1516;15;0;0.83
28;111;1516;1531;15;0;0.83
28;112;1531;1546;15;0;0.83
28;113;1546;1561;15;0;0.83
28;114;1561;1576;15;0;0.83
28;115;1576;1591;15;0;0.83
28;116;1591;1606;15;0;0.83
28;117;1606;1621;15;0;0.83
28;118;1621;1636;15;0;0.83
28;119;1636;1651;15;0;0.83
28;120;1651;1666;15;0;0.83
28;121;1666;1680;14;0;0.83
29;0;240;330;90;0;2.0
29;1;330;333;3;0;2.0
29;2;333;355;22;0;2.0
29;3;355;360;5;0;2.0
29;4;360;362;2;0;2.0
29;5;362;372;10;0;2.0
29;6;372;378;6;0;2.0
29;7;378;384;6;0;2.0
29;8;384;386;2;0;2.0
29;9;386;400;14;0;2.0
29;10;400;420;20;0;2.0
29;11;420;424;4;0;2.0
29;12;424;432;8;0;2.0
29;13;432;435;3;0;2.0
29;14;435;446;11;0;2.0
29;15;446;450;4;0;2.0
29;16;450;454;4;0;2.0
29;17;454;455;1;0;2.0
29;18;455;474;19;0;2.0
29;19;474;477;3;0;2.0
29;20;477;484;7;0;2.0
29;21;484;485;1;0;2.0
29;22;485;505;20;0;2.0
29;23;505;516;11;0;2.0
29;24;516;536;20;0;2.0
29;25;536;544;8;0;2.0
29;26;544;548;4;0;2.0
29;27;548;575;27;0;2.0
29;28;575;578;3;0;2.0
29;29;578;596;18;0;2.0
29;30;596;600;4;0;2.0
29;31;600;617;17;0;2.0
29;32;617;620;3;0;2.0
29;33;620;629;9;0;2.0
29;34;629;631;2;0;2.0
29;35;631;656;25;0;2.0
29;36;656;695;39;0;2.0
29;37;695;704;9;0;2.0
29;38;704;716;12;0;2.0
29;39;716;720;4;0;2.0
29;40;720;737;17;0;2.0
29;41;737;740;3;0;2.0
29;42;740;751;11;0;2.0
29;43;751;764;13;0;2.0
29;44;764;776;12;0;2.0
29;45;776;795;19;0;2.0
29;46;795;797;2;0;2.0
29;47;797;802;5;0;2.0
29;48;802;805;3;0;2.0
29;49;805;824;19;0;2.0
29;50;824;825;1;0;2.0
29;51;825;834;9;0;2.0
29;52;834;836;2;0;2.0
29;53;836;838;2;0;2.0
29;54;838;840;2;0;2.0
29;55;840;857;17;0;2.0
29;56;857;858;1;0;2.0
29;57;858;860;2;0;2.0
29;58;860;870;10;0;2.0
29;59;870;884;14;0;2.0
29;60;884;890;6;0;2.0
29;61;890;896;6;0;2.0
29;62;896;901;5;0;2.0
29;63;901;905;4;0;2.0
29;64;905;912;7;0;2.0
29;65;912;914;2;0;2.0
29;66;914;917;3;0;2.0
29;67;917;925;8;0;2.0
29;68;925;930;5;0;2.0
29;69;930;931;1;0;2.0
29;70;931;944;13;0;2.0
29;71;944;950;6;0;2.0
29;72;950;961;11;0;2.0
29;73;961;965;4;0;2.0
29;74;965;972;7;0;2.0
29;75;972;974;2;0;2.0
29;76;974;977;3;0;2.0
29;77;977;1004;27;0;2.0
29;78;1004;1005;1;0;2.0
29;79;1005;1010;5;0;2.0
29;80;1010;1015;5;0;2.0
29;81;1015;1021;6;0;2.0
29;82;1021;1022;1;0;2.0
29;83;1022;1035;13;0;2.0
29;84;1035;1070;35;0;2.0
29;85;1070;1090;20;0;2.0
29;86;1090;1095;5;0;2.0
29;87;1095;1144;49;0;2.0
29;88;1144;1152;8;0;2.0
29;89;1152;1154;2;0;2.0
29;90;1154;1178;24;0;2.0
29;91;1178;1220;42;0;2.0
29;92;1220;1225;5;0;2.0
29;93;1225;1256;31;0;2.0
29;94;1256;1274;18;0;2.0
29;95;1274;1283;9;0;2.0
29;96;1283;1308;25;0;2.0
29;97;1308;1330;22;0;2.0
29;98;1330;1340;10;0;2.0
29;99;1340;1365;25;0;2.0
29;100;1365;1366;1;0;2.0
29;101;1366;1394;28;0;2.0
29;102;1394;1396;2;0;2.0
29;103;1396;1411;15;0;2.0
29;104;1411;1426;15;0;2.0
29;105;1426;1441;15;0;2.0
29;106;1441;1456;15;0;2.0
29;107;1456;1471;15;0;2.0
29;108;1471;1486;15;0;2.0
29;109;1486;1501;15;0;2.0
29;110;1501;1516;15;0;2.0
29;111;1516;1531;15;0;2.0
29;112;1531;1546;15;0;2.0
29;113;1546;1561;15;0;2.0
29;114;1561;1576;15;0;2.0
29;115;1576;1591;15;0;2.0
29;116;1591;1606;15;0;2.0
29;117;1606;1621;15;0;2.0
29;118;1621;1636;15;0;2.0
29;119;1636;1651;15;0;2.0
29;120;1651;1666;15;0;2.0
29;121;1666;1680;14;0;2.0
30;0;240;330;90;0;2.0
30;1;330;333;3;0;2.0
30;2;333;355;22;0;2.0
30;3;355;360;5;0;2.0
30;4;360;362;2;0;2.0
30;5;362;372;10;0;2.0
30;6;372;378;6;0;2.0
30;7;378;384;6;0;2.0
30;8;384;386;2;0;2.0
30;9;386;400;14;0;2.0
30;10;400;420;20;0;2.0
30;11;420;424;4;0;2.0
30;12;424;432;8;0;2.0
30;13;432;435;3;0;2.0
30;14;435;446;11;0;2.0
30;15;446;450;4;0;2.0
30;16;450;454;4;0;2.0
30;17;454;455;1;0;2.0
30;18;455;474;19;0;2.0
30;19;474;477;3;0;2.0
30;20;477;484;7;0;2.0
30;21;484;485;1;0;2.0
30;22;485;505;20;0;2.0
30;23;505;516;11;0;2.0
30;24;516;536;20;0;2.0
30;25;536;544;8;0;2.0
30;26;544;548;4;0;2.0
30;27;548;575;27;0;2.0
30;28;575;578;3;0;2.0
30;29;578;596;18;0;2.0
30;30;596;600;4;0;2.0
30;31;600;617;17;0;2.0
30;32;617;620;3;0;2.0
30;33;620;629;9;0;2.0
30;34;629;631;2;0;2.0
30;35;631;656;25;0;2.0
30;36;656;695;39;0;2.0
30;37;695;704;9;0;2.0
30;38;704;716;12;0;2.0
30;39;716;720;4;0;2.0
30;40;720;737;17;0;2.0
30;41;737;740;3;0;2.0
30;42;740;751;11;0;2.0
30;43;751;764;13;0;2.0
30;44;764;776;12;0;2.0
30;45;776;795;19;0;2.0
30;46;795;797;2;0;2.0
30;47;797;802;5;0;2.0
30;48;802;805;3;0;2.0
30;49;805;824;19;0;2.0
30;50;824;825;1;0;2.0
30;51;825;834;9;0;2.0
30;52;834;836;2;0;2.0
30;53;836;838;2;0;2.0
30;54;838;840;2;0;2.0
30;55;840;857;17;0;2.0
30;56;857;858;1;0;2.0
30;57;858;860;2;0;2.0
30;58;860;870;10;0;2.0
30;59;870;884;14;0;2.0
30;60;884;890;6;0;2.0
30;61;890;896;6;0;2.0
30;62;896;901;5;0;2.0
30;63;901;905;4;0;2.0
30;64;905;912;7;0;2.0
30;65;912;914;2;0;2.0
30;66;914;917;3;0;2.0
30;67;917;925;8;0;2.0
30;68;925;930;5;0;2.0
30;69;930;931;1;0;2.0
30;70;931;944;13;0;2.0
30;71;944;950;6;0;2.0
30;72;950;961;11;0;2.0
30;73;961;965;4;0;2.0
30;74;965;972;7;0;2.0
30;75;972;974;2;0;2.0
30;76;974;977;3;0;2.0
30;77;977;1004;27;0;2.0
30;78;1004;1005;1;0;2.0
30;79;1005;1010;5;0;2.0
30;80;1010;1015;5;0;2.0
30;81;1015;1021;6;0;2.0
30;82;1021;1022;1;0;2.0
30;83;1022;1035;13;0;2.0
30;84;1035;1070;35;0;2.0
30;85;1070;1090;20;0;2.0
30;86;1090;1095;5;0;2.0
30;87;1095;1144;49;0;2.0
30;88;1144;1152;8;0;2.0
30;89;1152;1154;2;0;2.0
30;90;1154;1178;24;0;2.0
30;91;1178;1220;42;0;2.0
30;92;1220;1225;5;0;2.0
30;93;1225;1256;31;0;2.0
30;94;1256;1274;18;0;2.0
30;95;1274;1283;9;0;2.0
30;96;1283;1308;25;0;2.0
30;97;1308;1330;22;0;2.0
30;98;1330;1340;10;0;2.0
30;99;1340;1365;25;0;2.0
30;100;1365;1366;1;0;2.0
30;101;1366;1394;28;0;2.0
30;102;1394;1396;2;0;2.0
30;103;1396;1411;15;0;2.0
30;104;1411;1426;15;0;2.0
30;105;1426;1441;15;0;2.0
30;106;1441;1456;15;0;2.0
30;107;1456;1471;15;0;2.0
30;108;1471;1486;15;0;2.0
30;109;1486;1501;15;0;2.0
30;110;1501;1516;15;0;2.0
30;111;1516;1531;15;0;2.0
30;112;1531;1546;15;0;2.0
30;113;1546;1561;15;0;2.0
30;114;1561;1576;15;0;2.0
30;115;1576;1591;15;0;2.0
30;116;1591;1606;15;0;2.0
30;117;1606;1621;15;0;2.0
30;118;1621;1636;15;0;2.0
30;119;1636;1651;15;0;2.0
30;120;1651;1666;15;0;2.0
30;121;1666;1680;14;0;2.0
