Index Nabijacky;Index Udalosti;Cas Zaciatku;Cas Konca;CasTrvania;Miesto;Rychlost nabijania
0;0;249;332;83;112;2.0
0;1;332;336;4;112;2.0
0;2;336;337;1;112;2.0
0;3;337;339;2;112;2.0
0;4;339;341;2;112;2.0
0;5;341;342;1;112;2.0
0;6;342;344;2;112;2.0
0;7;344;345;1;112;2.0
0;8;345;348;3;112;2.0
0;9;348;352;4;112;2.0
0;10;352;353;1;112;2.0
0;11;353;354;1;112;2.0
0;12;354;357;3;112;2.0
0;13;357;358;1;112;2.0
0;14;358;359;1;112;2.0
0;15;359;360;1;112;2.0
0;16;360;362;2;112;2.0
0;17;362;366;4;112;2.0
0;18;366;367;1;112;2.0
0;19;367;372;5;112;2.0
0;20;372;373;1;112;2.0
0;21;373;374;1;112;2.0
0;22;374;381;7;112;2.0
0;23;381;382;1;112;2.0
0;24;382;383;1;112;2.0
0;25;383;385;2;112;2.0
0;26;385;387;2;112;2.0
0;27;387;388;1;112;2.0
0;28;388;389;1;112;2.0
0;29;389;391;2;112;2.0
0;30;391;394;3;112;2.0
0;31;394;395;1;112;2.0
0;32;395;397;2;112;2.0
0;33;397;401;4;112;2.0
0;34;401;403;2;112;2.0
0;35;403;405;2;112;2.0
0;36;405;406;1;112;2.0
0;37;406;407;1;112;2.0
0;38;407;409;2;112;2.0
0;39;409;411;2;112;2.0
0;40;411;412;1;112;2.0
0;41;412;414;2;112;2.0
0;42;414;415;1;112;2.0
0;43;415;417;2;112;2.0
0;44;417;418;1;112;2.0
0;45;418;419;1;112;2.0
0;46;419;421;2;112;2.0
0;47;421;422;1;112;2.0
0;48;422;423;1;112;2.0
0;49;423;425;2;112;2.0
0;50;425;426;1;112;2.0
0;51;426;427;1;112;2.0
0;52;427;431;4;112;2.0
0;53;431;432;1;112;2.0
0;54;432;434;2;112;2.0
0;55;434;435;1;112;2.0
0;56;435;436;1;112;2.0
0;57;436;437;1;112;2.0
0;58;437;439;2;112;2.0
0;59;439;441;2;112;2.0
0;60;441;443;2;112;2.0
0;61;443;445;2;112;2.0
0;62;445;447;2;112;2.0
0;63;447;448;1;112;2.0
0;64;448;449;1;112;2.0
0;65;449;451;2;112;2.0
0;66;451;454;3;112;2.0
0;67;454;455;1;112;2.0
0;68;455;457;2;112;2.0
0;69;457;461;4;112;2.0
0;70;461;462;1;112;2.0
0;71;462;463;1;112;2.0
0;72;463;465;2;112;2.0
0;73;465;466;1;112;2.0
0;74;466;467;1;112;2.0
0;75;467;469;2;112;2.0
0;76;469;471;2;112;2.0
0;77;471;472;1;112;2.0
0;78;472;474;2;112;2.0
0;79;474;475;1;112;2.0
0;80;475;477;2;112;2.0
0;81;477;478;1;112;2.0
0;82;478;479;1;112;2.0
0;83;479;481;2;112;2.0
0;84;481;482;1;112;2.0
0;85;482;483;1;112;2.0
0;86;483;485;2;112;2.0
0;87;485;486;1;112;2.0
0;88;486;487;1;112;2.0
0;89;487;489;2;112;2.0
0;90;489;491;2;112;2.0
0;91;491;494;3;112;2.0
0;92;494;495;1;112;2.0
0;93;495;496;1;112;2.0
0;94;496;497;1;112;2.0
0;95;497;502;5;112;2.0
0;96;502;503;1;112;2.0
0;97;503;507;4;112;2.0
0;98;507;509;2;112;2.0
0;99;509;510;1;112;2.0
0;100;510;511;1;112;2.0
0;101;511;514;3;112;2.0
0;102;514;517;3;112;2.0
0;103;517;522;5;112;2.0
0;104;522;523;1;112;2.0
0;105;523;527;4;112;2.0
0;106;527;531;4;112;2.0
0;107;531;534;3;112;2.0
0;108;534;538;4;112;2.0
0;109;538;543;5;112;2.0
0;110;543;545;2;112;2.0
0;111;545;547;2;112;2.0
0;112;547;551;4;112;2.0
0;113;551;554;3;112;2.0
0;114;554;555;1;112;2.0
0;115;555;562;7;112;2.0
0;116;562;563;1;112;2.0
0;117;563;565;2;112;2.0
0;118;565;567;2;112;2.0
0;119;567;569;2;112;2.0
0;120;569;571;2;112;2.0
0;121;571;574;3;112;2.0
0;122;574;583;9;112;2.0
0;123;583;585;2;112;2.0
0;124;585;587;2;112;2.0
0;125;587;591;4;112;2.0
0;126;591;594;3;112;2.0
0;127;594;598;4;112;2.0
0;128;598;602;4;112;2.0
0;129;602;603;1;112;2.0
0;130;603;605;2;112;2.0
0;131;605;607;2;112;2.0
0;132;607;611;4;112;2.0
0;133;611;614;3;112;2.0
0;134;614;615;1;112;2.0
0;135;615;623;8;112;2.0
0;136;623;625;2;112;2.0
0;137;625;627;2;112;2.0
0;138;627;629;2;112;2.0
0;139;629;631;2;112;2.0
0;140;631;634;3;112;2.0
0;141;634;643;9;112;2.0
0;142;643;645;2;112;2.0
0;143;645;647;2;112;2.0
0;144;647;651;4;112;2.0
0;145;651;654;3;112;2.0
0;146;654;658;4;112;2.0
0;147;658;662;4;112;2.0
0;148;662;663;1;112;2.0
0;149;663;665;2;112;2.0
0;150;665;667;2;112;2.0
0;151;667;671;4;112;2.0
0;152;671;674;3;112;2.0
0;153;674;683;9;112;2.0
0;154;683;685;2;112;2.0
0;155;685;687;2;112;2.0
0;156;687;689;2;112;2.0
0;157;689;691;2;112;2.0
0;158;691;694;3;112;2.0
0;159;694;703;9;112;2.0
0;160;703;705;2;112;2.0
0;161;705;707;2;112;2.0
0;162;707;711;4;112;2.0
0;163;711;714;3;112;2.0
0;164;714;718;4;112;2.0
0;165;718;722;4;112;2.0
0;166;722;723;1;112;2.0
0;167;723;725;2;112;2.0
0;168;725;727;2;112;2.0
0;169;727;731;4;112;2.0
0;170;731;734;3;112;2.0
0;171;734;743;9;112;2.0
0;172;743;745;2;112;2.0
0;173;745;747;2;112;2.0
0;174;747;749;2;112;2.0
0;175;749;751;2;112;2.0
0;176;751;754;3;112;2.0
0;177;754;763;9;112;2.0
0;178;763;765;2;112;2.0
0;179;765;767;2;112;2.0
0;180;767;771;4;112;2.0
0;181;771;774;3;112;2.0
0;182;774;778;4;112;2.0
0;183;778;782;4;112;2.0
0;184;782;783;1;112;2.0
0;185;783;785;2;112;2.0
0;186;785;787;2;112;2.0
0;187;787;791;4;112;2.0
0;188;791;794;3;112;2.0
0;189;794;795;1;112;2.0
0;190;795;801;6;112;2.0
0;191;801;803;2;112;2.0
0;192;803;805;2;112;2.0
0;193;805;807;2;112;2.0
0;194;807;809;2;112;2.0
0;195;809;811;2;112;2.0
0;196;811;814;3;112;2.0
0;197;814;818;4;112;2.0
0;198;818;821;3;112;2.0
0;199;821;822;1;112;2.0
0;200;822;823;1;112;2.0
0;201;823;825;2;112;2.0
0;202;825;826;1;112;2.0
0;203;826;827;1;112;2.0
0;204;827;831;4;112;2.0
0;205;831;834;3;112;2.0
0;206;834;838;4;112;2.0
0;207;838;841;3;112;2.0
0;208;841;842;1;112;2.0
0;209;842;843;1;112;2.0
0;210;843;845;2;112;2.0
0;211;845;846;1;112;2.0
0;212;846;847;1;112;2.0
0;213;847;851;4;112;2.0
0;214;851;852;1;112;2.0
0;215;852;853;1;112;2.0
0;216;853;854;1;112;2.0
0;217;854;855;1;112;2.0
0;218;855;861;6;112;2.0
0;219;861;863;2;112;2.0
0;220;863;865;2;112;2.0
0;221;865;866;1;112;2.0
0;222;866;867;1;112;2.0
0;223;867;869;2;112;2.0
0;224;869;871;2;112;2.0
0;225;871;874;3;112;2.0
0;226;874;875;1;112;2.0
0;227;875;877;2;112;2.0
0;228;877;878;1;112;2.0
0;229;878;881;3;112;2.0
0;230;881;883;2;112;2.0
0;231;883;884;1;112;2.0
0;232;884;885;1;112;2.0
0;233;885;886;1;112;2.0
0;234;886;887;1;112;2.0
0;235;887;891;4;112;2.0
0;236;891;894;3;112;2.0
0;237;894;895;1;112;2.0
0;238;895;897;2;112;2.0
0;239;897;898;1;112;2.0
0;240;898;901;3;112;2.0
0;241;901;902;1;112;2.0
0;242;902;903;1;112;2.0
0;243;903;905;2;112;2.0
0;244;905;906;1;112;2.0
0;245;906;907;1;112;2.0
0;246;907;909;2;112;2.0
0;247;909;911;2;112;2.0
0;248;911;913;2;112;2.0
0;249;913;914;1;112;2.0
0;250;914;915;1;112;2.0
0;251;915;917;2;112;2.0
0;252;917;921;4;112;2.0
0;253;921;923;2;112;2.0
0;254;923;925;2;112;2.0
0;255;925;926;1;112;2.0
0;256;926;927;1;112;2.0
0;257;927;929;2;112;2.0
0;258;929;931;2;112;2.0
0;259;931;934;3;112;2.0
0;260;934;935;1;112;2.0
0;261;935;937;2;112;2.0
0;262;937;938;1;112;2.0
0;263;938;941;3;112;2.0
0;264;941;943;2;112;2.0
0;265;943;944;1;112;2.0
0;266;944;945;1;112;2.0
0;267;945;946;1;112;2.0
0;268;946;947;1;112;2.0
0;269;947;951;4;112;2.0
0;270;951;954;3;112;2.0
0;271;954;955;1;112;2.0
0;272;955;957;2;112;2.0
0;273;957;958;1;112;2.0
0;274;958;961;3;112;2.0
0;275;961;962;1;112;2.0
0;276;962;963;1;112;2.0
0;277;963;965;2;112;2.0
0;278;965;966;1;112;2.0
0;279;966;967;1;112;2.0
0;280;967;969;2;112;2.0
0;281;969;971;2;112;2.0
0;282;971;973;2;112;2.0
0;283;973;974;1;112;2.0
0;284;974;975;1;112;2.0
0;285;975;977;2;112;2.0
0;286;977;981;4;112;2.0
0;287;981;983;2;112;2.0
0;288;983;985;2;112;2.0
0;289;985;986;1;112;2.0
0;290;986;987;1;112;2.0
0;291;987;991;4;112;2.0
0;292;991;992;1;112;2.0
0;293;992;994;2;112;2.0
0;294;994;995;1;112;2.0
0;295;995;997;2;112;2.0
0;296;997;1001;4;112;2.0
0;297;1001;1003;2;112;2.0
0;298;1003;1004;1;112;2.0
0;299;1004;1005;1;112;2.0
0;300;1005;1006;1;112;2.0
0;301;1006;1007;1;112;2.0
0;302;1007;1011;4;112;2.0
0;303;1011;1013;2;112;2.0
0;304;1013;1014;1;112;2.0
0;305;1014;1015;1;112;2.0
0;306;1015;1021;6;112;2.0
0;307;1021;1022;1;112;2.0
0;308;1022;1023;1;112;2.0
0;309;1023;1026;3;112;2.0
0;310;1026;1030;4;112;2.0
0;311;1030;1033;3;112;2.0
0;312;1033;1034;1;112;2.0
0;313;1034;1036;2;112;2.0
0;314;1036;1037;1;112;2.0
0;315;1037;1043;6;112;2.0
0;316;1043;1044;1;112;2.0
0;317;1044;1045;1;112;2.0
0;318;1045;1046;1;112;2.0
0;319;1046;1051;5;112;2.0
0;320;1051;1052;1;112;2.0
0;321;1052;1054;2;112;2.0
0;322;1054;1060;6;112;2.0
0;323;1060;1063;3;112;2.0
0;324;1063;1064;1;112;2.0
0;325;1064;1066;2;112;2.0
0;326;1066;1067;1;112;2.0
0;327;1067;1074;7;112;2.0
0;328;1074;1075;1;112;2.0
0;329;1075;1077;2;112;2.0
0;330;1077;1081;4;112;2.0
0;331;1081;1082;1;112;2.0
0;332;1082;1083;1;112;2.0
0;333;1083;1086;3;112;2.0
0;334;1086;1090;4;112;2.0
0;335;1090;1094;4;112;2.0
0;336;1094;1096;2;112;2.0
0;337;1096;1097;1;112;2.0
0;338;1097;1105;8;112;2.0
0;339;1105;1106;1;112;2.0
0;340;1106;1109;3;112;2.0
0;341;1109;1111;2;112;2.0
0;342;1111;1112;1;112;2.0
0;343;1112;1113;1;112;2.0
0;344;1113;1114;1;112;2.0
0;345;1114;1116;2;112;2.0
0;346;1116;1120;4;112;2.0
0;347;1120;1123;3;112;2.0
0;348;1123;1124;1;112;2.0
0;349;1124;1125;1;112;2.0
0;350;1125;1132;7;112;2.0
0;351;1132;1134;2;112;2.0
0;352;1134;1136;2;112;2.0
0;353;1136;1138;2;112;2.0
0;354;1138;1144;6;112;2.0
0;355;1144;1146;2;112;2.0
0;356;1146;1147;1;112;2.0
0;357;1147;1151;4;112;2.0
0;358;1151;1153;2;112;2.0
0;359;1153;1154;1;112;2.0
0;360;1154;1156;2;112;2.0
0;361;1156;1158;2;112;2.0
0;362;1158;1162;4;112;2.0
0;363;1162;1164;2;112;2.0
0;364;1164;1167;3;112;2.0
0;365;1167;1168;1;112;2.0
0;366;1168;1174;6;112;2.0
0;367;1174;1176;2;112;2.0
0;368;1176;1181;5;112;2.0
0;369;1181;1182;1;112;2.0
0;370;1182;1183;1;112;2.0
0;371;1183;1184;1;112;2.0
0;372;1184;1188;4;112;2.0
0;373;1188;1194;6;112;2.0
0;374;1194;1199;5;112;2.0
0;375;1199;1202;3;112;2.0
0;376;1202;1203;1;112;2.0
0;377;1203;1204;1;112;2.0
0;378;1204;1206;2;112;2.0
0;379;1206;1208;2;112;2.0
0;380;1208;1216;8;112;2.0
0;381;1216;1219;3;112;2.0
0;382;1219;1222;3;112;2.0
0;383;1222;1227;5;112;2.0
0;384;1227;1229;2;112;2.0
0;385;1229;1233;4;112;2.0
0;386;1233;1238;5;112;2.0
0;387;1238;1241;3;112;2.0
0;388;1241;1242;1;112;2.0
0;389;1242;1244;2;112;2.0
0;390;1244;1254;10;112;2.0
0;391;1254;1258;4;112;2.0
0;392;1258;1267;9;112;2.0
0;393;1267;1269;2;112;2.0
0;394;1269;1274;5;112;2.0
0;395;1274;1276;2;112;2.0
0;396;1276;1278;2;112;2.0
0;397;1278;1279;1;112;2.0
0;398;1279;1283;4;112;2.0
0;399;1283;1291;8;112;2.0
0;400;1291;1292;1;112;2.0
0;401;1292;1296;4;112;2.0
0;402;1296;1302;6;112;2.0
0;403;1302;1304;2;112;2.0
0;404;1304;1308;4;112;2.0
0;405;1308;1311;3;112;2.0
0;406;1311;1316;5;112;2.0
0;407;1316;1317;1;112;2.0
0;408;1317;1318;1;112;2.0
0;409;1318;1324;6;112;2.0
0;410;1324;1328;4;112;2.0
0;411;1328;1334;6;112;2.0
0;412;1334;1341;7;112;2.0
0;413;1341;1342;1;112;2.0
0;414;1342;1346;4;112;2.0
0;415;1346;1348;2;112;2.0
0;416;1348;1353;5;112;2.0
0;417;1353;1354;1;112;2.0
0;418;1354;1369;15;112;2.0
0;419;1369;1370;1;112;2.0
0;420;1370;1379;9;112;2.0
0;421;1379;1387;8;112;2.0
0;422;1387;1402;15;112;2.0
0;423;1402;1417;15;112;2.0
0;424;1417;1432;15;112;2.0
0;425;1432;1447;15;112;2.0
0;426;1447;1462;15;112;2.0
0;427;1462;1477;15;112;2.0
0;428;1477;1492;15;112;2.0
0;429;1492;1507;15;112;2.0
0;430;1507;1522;15;112;2.0
0;431;1522;1537;15;112;2.0
0;432;1537;1552;15;112;2.0
0;433;1552;1567;15;112;2.0
0;434;1567;1582;15;112;2.0
0;435;1582;1597;15;112;2.0
0;436;1597;1612;15;112;2.0
0;437;1612;1627;15;112;2.0
0;438;1627;1642;15;112;2.0
0;439;1642;1657;15;112;2.0
0;440;1657;1680;23;112;2.0
1;0;245;324;79;93;2.0
1;1;324;330;6;93;2.0
1;2;330;336;6;93;2.0
1;3;336;337;1;93;2.0
1;4;337;340;3;93;2.0
1;5;340;343;3;93;2.0
1;6;343;345;2;93;2.0
1;7;345;346;1;93;2.0
1;8;346;347;1;93;2.0
1;9;347;348;1;93;2.0
1;10;348;351;3;93;2.0
1;11;351;352;1;93;2.0
1;12;352;353;1;93;2.0
1;13;353;354;1;93;2.0
1;14;354;355;1;93;2.0
1;15;355;356;1;93;2.0
1;16;356;360;4;93;2.0
1;17;360;365;5;93;2.0
1;18;365;366;1;93;2.0
1;19;366;367;1;93;2.0
1;20;367;370;3;93;2.0
1;21;370;373;3;93;2.0
1;22;373;374;1;93;2.0
1;23;374;377;3;93;2.0
1;24;377;381;4;93;2.0
1;25;381;383;2;93;2.0
1;26;383;384;1;93;2.0
1;27;384;385;1;93;2.0
1;28;385;387;2;93;2.0
1;29;387;394;7;93;2.0
1;30;394;395;1;93;2.0
1;31;395;396;1;93;2.0
1;32;396;397;1;93;2.0
1;33;397;398;1;93;2.0
1;34;398;401;3;93;2.0
1;35;401;404;3;93;2.0
1;36;404;405;1;93;2.0
1;37;405;407;2;93;2.0
1;38;407;413;6;93;2.0
1;39;413;414;1;93;2.0
1;40;414;415;1;93;2.0
1;41;415;416;1;93;2.0
1;42;416;417;1;93;2.0
1;43;417;421;4;93;2.0
1;44;421;423;2;93;2.0
1;45;423;424;1;93;2.0
1;46;424;425;1;93;2.0
1;47;425;426;1;93;2.0
1;48;426;427;1;93;2.0
1;49;427;433;6;93;2.0
1;50;433;434;1;93;2.0
1;51;434;435;1;93;2.0
1;52;435;437;2;93;2.0
1;53;437;441;4;93;2.0
1;54;441;443;2;93;2.0
1;55;443;444;1;93;2.0
1;56;444;445;1;93;2.0
1;57;445;446;1;93;2.0
1;58;446;447;1;93;2.0
1;59;447;454;7;93;2.0
1;60;454;455;1;93;2.0
1;61;455;456;1;93;2.0
1;62;456;457;1;93;2.0
1;63;457;458;1;93;2.0
1;64;458;461;3;93;2.0
1;65;461;464;3;93;2.0
1;66;464;465;1;93;2.0
1;67;465;467;2;93;2.0
1;68;467;473;6;93;2.0
1;69;473;474;1;93;2.0
1;70;474;475;1;93;2.0
1;71;475;476;1;93;2.0
1;72;476;477;1;93;2.0
1;73;477;481;4;93;2.0
1;74;481;483;2;93;2.0
1;75;483;484;1;93;2.0
1;76;484;485;1;93;2.0
1;77;485;486;1;93;2.0
1;78;486;487;1;93;2.0
1;79;487;493;6;93;2.0
1;80;493;494;1;93;2.0
1;81;494;495;1;93;2.0
1;82;495;496;1;93;2.0
1;83;496;501;5;93;2.0
1;84;501;502;1;93;2.0
1;85;502;503;1;93;2.0
1;86;503;504;1;93;2.0
1;87;504;505;1;93;2.0
1;88;505;507;2;93;2.0
1;89;507;514;7;93;2.0
1;90;514;515;1;93;2.0
1;91;515;516;1;93;2.0
1;92;516;519;3;93;2.0
1;93;519;521;2;93;2.0
1;94;521;524;3;93;2.0
1;95;524;525;1;93;2.0
1;96;525;527;2;93;2.0
1;97;527;530;3;93;2.0
1;98;530;533;3;93;2.0
1;99;533;537;4;93;2.0
1;100;537;541;4;93;2.0
1;101;541;544;3;93;2.0
1;102;544;545;1;93;2.0
1;103;545;547;2;93;2.0
1;104;547;554;7;93;2.0
1;105;554;557;3;93;2.0
1;106;557;561;4;93;2.0
1;107;561;563;2;93;2.0
1;108;563;564;1;93;2.0
1;109;564;565;1;93;2.0
1;110;565;567;2;93;2.0
1;111;567;570;3;93;2.0
1;112;570;576;6;93;2.0
1;113;576;577;1;93;2.0
1;114;577;581;4;93;2.0
1;115;581;584;3;93;2.0
1;116;584;585;1;93;2.0
1;117;585;587;2;93;2.0
1;118;587;593;6;93;2.0
1;119;593;594;1;93;2.0
1;120;594;597;3;93;2.0
1;121;597;601;4;93;2.0
1;122;601;604;3;93;2.0
1;123;604;605;1;93;2.0
1;124;605;607;2;93;2.0
1;125;607;610;3;93;2.0
1;126;610;617;7;93;2.0
1;127;617;621;4;93;2.0
1;128;621;623;2;93;2.0
1;129;623;624;1;93;2.0
1;130;624;625;1;93;2.0
1;131;625;627;2;93;2.0
1;132;627;630;3;93;2.0
1;133;630;636;6;93;2.0
1;134;636;637;1;93;2.0
1;135;637;641;4;93;2.0
1;136;641;644;3;93;2.0
1;137;644;645;1;93;2.0
1;138;645;647;2;93;2.0
1;139;647;653;6;93;2.0
1;140;653;654;1;93;2.0
1;141;654;657;3;93;2.0
1;142;657;661;4;93;2.0
1;143;661;664;3;93;2.0
1;144;664;665;1;93;2.0
1;145;665;667;2;93;2.0
1;146;667;670;3;93;2.0
1;147;670;677;7;93;2.0
1;148;677;681;4;93;2.0
1;149;681;684;3;93;2.0
1;150;684;685;1;93;2.0
1;151;685;687;2;93;2.0
1;152;687;690;3;93;2.0
1;153;690;696;6;93;2.0
1;154;696;697;1;93;2.0
1;155;697;701;4;93;2.0
1;156;701;704;3;93;2.0
1;157;704;705;1;93;2.0
1;158;705;707;2;93;2.0
1;159;707;713;6;93;2.0
1;160;713;714;1;93;2.0
1;161;714;717;3;93;2.0
1;162;717;721;4;93;2.0
1;163;721;724;3;93;2.0
1;164;724;725;1;93;2.0
1;165;725;727;2;93;2.0
1;166;727;730;3;93;2.0
1;167;730;737;7;93;2.0
1;168;737;741;4;93;2.0
1;169;741;744;3;93;2.0
1;170;744;745;1;93;2.0
1;171;745;747;2;93;2.0
1;172;747;750;3;93;2.0
1;173;750;756;6;93;2.0
1;174;756;757;1;93;2.0
1;175;757;761;4;93;2.0
1;176;761;764;3;93;2.0
1;177;764;765;1;93;2.0
1;178;765;767;2;93;2.0
1;179;767;773;6;93;2.0
1;180;773;774;1;93;2.0
1;181;774;777;3;93;2.0
1;182;777;781;4;93;2.0
1;183;781;784;3;93;2.0
1;184;784;785;1;93;2.0
1;185;785;787;2;93;2.0
1;186;787;790;3;93;2.0
1;187;790;794;4;93;2.0
1;188;794;797;3;93;2.0
1;189;797;801;4;93;2.0
1;190;801;803;2;93;2.0
1;191;803;804;1;93;2.0
1;192;804;805;1;93;2.0
1;193;805;807;2;93;2.0
1;194;807;813;6;93;2.0
1;195;813;814;1;93;2.0
1;196;814;816;2;93;2.0
1;197;816;817;1;93;2.0
1;198;817;821;4;93;2.0
1;199;821;824;3;93;2.0
1;200;824;825;1;93;2.0
1;201;825;827;2;93;2.0
1;202;827;833;6;93;2.0
1;203;833;834;1;93;2.0
1;204;834;837;3;93;2.0
1;205;837;841;4;93;2.0
1;206;841;844;3;93;2.0
1;207;844;845;1;93;2.0
1;208;845;847;2;93;2.0
1;209;847;848;1;93;2.0
1;210;848;850;2;93;2.0
1;211;850;853;3;93;2.0
1;212;853;854;1;93;2.0
1;213;854;857;3;93;2.0
1;214;857;859;2;93;2.0
1;215;859;861;2;93;2.0
1;216;861;863;2;93;2.0
1;217;863;864;1;93;2.0
1;218;864;865;1;93;2.0
1;219;865;867;2;93;2.0
1;220;867;870;3;93;2.0
1;221;870;873;3;93;2.0
1;222;873;874;1;93;2.0
1;223;874;875;1;93;2.0
1;224;875;876;1;93;2.0
1;225;876;877;1;93;2.0
1;226;877;881;4;93;2.0
1;227;881;884;3;93;2.0
1;228;884;885;1;93;2.0
1;229;885;887;2;93;2.0
1;230;887;891;4;93;2.0
1;231;891;893;2;93;2.0
1;232;893;894;1;93;2.0
1;233;894;895;1;93;2.0
1;234;895;897;2;93;2.0
1;235;897;901;4;93;2.0
1;236;901;904;3;93;2.0
1;237;904;905;1;93;2.0
1;238;905;907;2;93;2.0
1;239;907;908;1;93;2.0
1;240;908;910;2;93;2.0
1;241;910;913;3;93;2.0
1;242;913;914;1;93;2.0
1;243;914;915;1;93;2.0
1;244;915;916;1;93;2.0
1;245;916;917;1;93;2.0
1;246;917;921;4;93;2.0
1;247;921;923;2;93;2.0
1;248;923;924;1;93;2.0
1;249;924;925;1;93;2.0
1;250;925;927;2;93;2.0
1;251;927;930;3;93;2.0
1;252;930;933;3;93;2.0
1;253;933;934;1;93;2.0
1;254;934;935;1;93;2.0
1;255;935;936;1;93;2.0
1;256;936;937;1;93;2.0
1;257;937;941;4;93;2.0
1;258;941;944;3;93;2.0
1;259;944;945;1;93;2.0
1;260;945;947;2;93;2.0
1;261;947;951;4;93;2.0
1;262;951;953;2;93;2.0
1;263;953;954;1;93;2.0
1;264;954;955;1;93;2.0
1;265;955;957;2;93;2.0
1;266;957;961;4;93;2.0
1;267;961;964;3;93;2.0
1;268;964;965;1;93;2.0
1;269;965;967;2;93;2.0
1;270;967;968;1;93;2.0
1;271;968;970;2;93;2.0
1;272;970;973;3;93;2.0
1;273;973;974;1;93;2.0
1;274;974;975;1;93;2.0
1;275;975;976;1;93;2.0
1;276;976;977;1;93;2.0
1;277;977;981;4;93;2.0
1;278;981;983;2;93;2.0
1;279;983;984;1;93;2.0
1;280;984;985;1;93;2.0
1;281;985;987;2;93;2.0
1;282;987;990;3;93;2.0
1;283;990;993;3;93;2.0
1;284;993;994;1;93;2.0
1;285;994;995;1;93;2.0
1;286;995;997;2;93;2.0
1;287;997;999;2;93;2.0
1;288;999;1001;2;93;2.0
1;289;1001;1004;3;93;2.0
1;290;1004;1005;1;93;2.0
1;291;1005;1007;2;93;2.0
1;292;1007;1008;1;93;2.0
1;293;1008;1011;3;93;2.0
1;294;1011;1013;2;93;2.0
1;295;1013;1014;1;93;2.0
1;296;1014;1020;6;93;2.0
1;297;1020;1021;1;93;2.0
1;298;1021;1022;1;93;2.0
1;299;1022;1027;5;93;2.0
1;300;1027;1028;1;93;2.0
1;301;1028;1029;1;93;2.0
1;302;1029;1030;1;93;2.0
1;303;1030;1033;3;93;2.0
1;304;1033;1035;2;93;2.0
1;305;1035;1037;2;93;2.0
1;306;1037;1041;4;93;2.0
1;307;1041;1044;3;93;2.0
1;308;1044;1047;3;93;2.0
1;309;1047;1050;3;93;2.0
1;310;1050;1051;1;93;2.0
1;311;1051;1052;1;93;2.0
1;312;1052;1053;1;93;2.0
1;313;1053;1059;6;93;2.0
1;314;1059;1061;2;93;2.0
1;315;1061;1065;4;93;2.0
1;316;1065;1067;2;93;2.0
1;317;1067;1071;4;93;2.0
1;318;1071;1072;1;93;2.0
1;319;1072;1073;1;93;2.0
1;320;1073;1074;1;93;2.0
1;321;1074;1080;6;93;2.0
1;322;1080;1081;1;93;2.0
1;323;1081;1082;1;93;2.0
1;324;1082;1087;5;93;2.0
1;325;1087;1089;2;93;2.0
1;326;1089;1090;1;93;2.0
1;327;1090;1093;3;93;2.0
1;328;1093;1095;2;93;2.0
1;329;1095;1097;2;93;2.0
1;330;1097;1101;4;93;2.0
1;331;1101;1104;3;93;2.0
1;332;1104;1109;5;93;2.0
1;333;1109;1110;1;93;2.0
1;334;1110;1112;2;93;2.0
1;335;1112;1113;1;93;2.0
1;336;1113;1116;3;93;2.0
1;337;1116;1121;5;93;2.0
1;338;1121;1122;1;93;2.0
1;339;1122;1124;2;93;2.0
1;340;1124;1129;5;93;2.0
1;341;1129;1131;2;93;2.0
1;342;1131;1132;1;93;2.0
1;343;1132;1134;2;93;2.0
1;344;1134;1138;4;93;2.0
1;345;1138;1139;1;93;2.0
1;346;1139;1141;2;93;2.0
1;347;1141;1142;1;93;2.0
1;348;1142;1144;2;93;2.0
1;349;1144;1146;2;93;2.0
1;350;1146;1154;8;93;2.0
1;351;1154;1161;7;93;2.0
1;352;1161;1162;1;93;2.0
1;353;1162;1169;7;93;2.0
1;354;1169;1174;5;93;2.0
1;355;1174;1179;5;93;2.0
1;356;1179;1181;2;93;2.0
1;357;1181;1182;1;93;2.0
1;358;1182;1189;7;93;2.0
1;359;1189;1194;5;93;2.0
1;360;1194;1196;2;93;2.0
1;361;1196;1201;5;93;2.0
1;362;1201;1202;1;93;2.0
1;363;1202;1204;2;93;2.0
1;364;1204;1206;2;93;2.0
1;365;1206;1208;2;93;2.0
1;366;1208;1214;6;93;2.0
1;367;1214;1226;12;93;2.0
1;368;1226;1227;1;93;2.0
1;369;1227;1229;2;93;2.0
1;370;1229;1231;2;93;2.0
1;371;1231;1234;3;93;2.0
1;372;1234;1239;5;93;2.0
1;373;1239;1251;12;93;2.0
1;374;1251;1252;1;93;2.0
1;375;1252;1254;2;93;2.0
1;376;1254;1259;5;93;2.0
1;377;1259;1269;10;93;2.0
1;378;1269;1271;2;93;2.0
1;379;1271;1274;3;93;2.0
1;380;1274;1276;2;93;2.0
1;381;1276;1277;1;93;2.0
1;382;1277;1283;6;93;2.0
1;383;1283;1284;1;93;2.0
1;384;1284;1301;17;93;2.0
1;385;1301;1302;1;93;2.0
1;386;1302;1303;1;93;2.0
1;387;1303;1308;5;93;2.0
1;388;1308;1309;1;93;2.0
1;389;1309;1311;2;93;2.0
1;390;1311;1321;10;93;2.0
1;391;1321;1331;10;93;2.0
1;392;1331;1332;1;93;2.0
1;393;1332;1333;1;93;2.0
1;394;1333;1334;1;93;2.0
1;395;1334;1341;7;93;2.0
1;396;1341;1346;5;93;2.0
1;397;1346;1347;1;93;2.0
1;398;1347;1352;5;93;2.0
1;399;1352;1361;9;93;2.0
1;400;1361;1362;1;93;2.0
1;401;1362;1367;5;93;2.0
1;402;1367;1379;12;93;2.0
1;403;1379;1386;7;93;2.0
1;404;1386;1401;15;93;2.0
1;405;1401;1416;15;93;2.0
1;406;1416;1431;15;93;2.0
1;407;1431;1446;15;93;2.0
1;408;1446;1461;15;93;2.0
1;409;1461;1476;15;93;2.0
1;410;1476;1491;15;93;2.0
1;411;1491;1506;15;93;2.0
1;412;1506;1521;15;93;2.0
1;413;1521;1536;15;93;2.0
1;414;1536;1551;15;93;2.0
1;415;1551;1566;15;93;2.0
1;416;1566;1581;15;93;2.0
1;417;1581;1596;15;93;2.0
1;418;1596;1611;15;93;2.0
1;419;1611;1626;15;93;2.0
1;420;1626;1641;15;93;2.0
1;421;1641;1656;15;93;2.0
1;422;1656;1671;15;93;2.0
1;423;1671;1680;9;93;2.0
2;0;246;325;79;92;2.0
2;1;325;329;4;92;2.0
2;2;329;337;8;92;2.0
2;3;337;338;1;92;2.0
2;4;338;343;5;92;2.0
2;5;343;344;1;92;2.0
2;6;344;346;2;92;2.0
2;7;346;348;2;92;2.0
2;8;348;349;1;92;2.0
2;9;349;352;3;92;2.0
2;10;352;353;1;92;2.0
2;11;353;355;2;92;2.0
2;12;355;356;1;92;2.0
2;13;356;359;3;92;2.0
2;14;359;366;7;92;2.0
2;15;366;368;2;92;2.0
2;16;368;373;5;92;2.0
2;17;373;375;2;92;2.0
2;18;375;378;3;92;2.0
2;19;378;379;1;92;2.0
2;20;379;381;2;92;2.0
2;21;381;383;2;92;2.0
2;22;383;386;3;92;2.0
2;23;386;388;2;92;2.0
2;24;388;393;5;92;2.0
2;25;393;396;3;92;2.0
2;26;396;398;2;92;2.0
2;27;398;399;1;92;2.0
2;28;399;403;4;92;2.0
2;29;403;405;2;92;2.0
2;30;405;406;1;92;2.0
2;31;406;408;2;92;2.0
2;32;408;413;5;92;2.0
2;33;413;415;2;92;2.0
2;34;415;416;1;92;2.0
2;35;416;418;2;92;2.0
2;36;418;419;1;92;2.0
2;37;419;423;4;92;2.0
2;38;423;425;2;92;2.0
2;39;425;426;1;92;2.0
2;40;426;428;2;92;2.0
2;41;428;433;5;92;2.0
2;42;433;438;5;92;2.0
2;43;438;439;1;92;2.0
2;44;439;443;4;92;2.0
2;45;443;446;3;92;2.0
2;46;446;448;2;92;2.0
2;47;448;453;5;92;2.0
2;48;453;455;2;92;2.0
2;49;455;456;1;92;2.0
2;50;456;458;2;92;2.0
2;51;458;459;1;92;2.0
2;52;459;461;2;92;2.0
2;53;461;463;2;92;2.0
2;54;463;465;2;92;2.0
2;55;465;466;1;92;2.0
2;56;466;468;2;92;2.0
2;57;468;473;5;92;2.0
2;58;473;475;2;92;2.0
2;59;475;476;1;92;2.0
2;60;476;478;2;92;2.0
2;61;478;479;1;92;2.0
2;62;479;483;4;92;2.0
2;63;483;486;3;92;2.0
2;64;486;488;2;92;2.0
2;65;488;492;4;92;2.0
2;66;492;493;1;92;2.0
2;67;493;495;2;92;2.0
2;68;495;496;1;92;2.0
2;69;496;499;3;92;2.0
2;70;499;503;4;92;2.0
2;71;503;506;3;92;2.0
2;72;506;513;7;92;2.0
2;73;513;515;2;92;2.0
2;74;515;516;1;92;2.0
2;75;516;519;3;92;2.0
2;76;519;520;1;92;2.0
2;77;520;521;1;92;2.0
2;78;521;523;2;92;2.0
2;79;523;526;3;92;2.0
2;80;526;530;4;92;2.0
2;81;530;533;3;92;2.0
2;82;533;538;5;92;2.0
2;83;538;539;1;92;2.0
2;84;539;541;2;92;2.0
2;85;541;543;2;92;2.0
2;86;543;546;3;92;2.0
2;87;546;555;9;92;2.0
2;88;555;558;3;92;2.0
2;89;558;559;1;92;2.0
2;90;559;561;2;92;2.0
2;91;561;563;2;92;2.0
2;92;563;566;3;92;2.0
2;93;566;570;4;92;2.0
2;94;570;576;6;92;2.0
2;95;576;578;2;92;2.0
2;96;578;579;1;92;2.0
2;97;579;581;2;92;2.0
2;98;581;583;2;92;2.0
2;99;583;586;3;92;2.0
2;100;586;593;7;92;2.0
2;101;593;595;2;92;2.0
2;102;595;598;3;92;2.0
2;103;598;599;1;92;2.0
2;104;599;601;2;92;2.0
2;105;601;603;2;92;2.0
2;106;603;606;3;92;2.0
2;107;606;610;4;92;2.0
2;108;610;618;8;92;2.0
2;109;618;619;1;92;2.0
2;110;619;621;2;92;2.0
2;111;621;623;2;92;2.0
2;112;623;626;3;92;2.0
2;113;626;630;4;92;2.0
2;114;630;636;6;92;2.0
2;115;636;638;2;92;2.0
2;116;638;639;1;92;2.0
2;117;639;641;2;92;2.0
2;118;641;643;2;92;2.0
2;119;643;646;3;92;2.0
2;120;646;653;7;92;2.0
2;121;653;655;2;92;2.0
2;122;655;658;3;92;2.0
2;123;658;659;1;92;2.0
2;124;659;661;2;92;2.0
2;125;661;663;2;92;2.0
2;126;663;666;3;92;2.0
2;127;666;670;4;92;2.0
2;128;670;678;8;92;2.0
2;129;678;679;1;92;2.0
2;130;679;681;2;92;2.0
2;131;681;683;2;92;2.0
2;132;683;686;3;92;2.0
2;133;686;690;4;92;2.0
2;134;690;696;6;92;2.0
2;135;696;698;2;92;2.0
2;136;698;699;1;92;2.0
2;137;699;701;2;92;2.0
2;138;701;703;2;92;2.0
2;139;703;706;3;92;2.0
2;140;706;713;7;92;2.0
2;141;713;715;2;92;2.0
2;142;715;718;3;92;2.0
2;143;718;719;1;92;2.0
2;144;719;721;2;92;2.0
2;145;721;723;2;92;2.0
2;146;723;726;3;92;2.0
2;147;726;730;4;92;2.0
2;148;730;738;8;92;2.0
2;149;738;739;1;92;2.0
2;150;739;741;2;92;2.0
2;151;741;743;2;92;2.0
2;152;743;746;3;92;2.0
2;153;746;750;4;92;2.0
2;154;750;756;6;92;2.0
2;155;756;758;2;92;2.0
2;156;758;759;1;92;2.0
2;157;759;761;2;92;2.0
2;158;761;763;2;92;2.0
2;159;763;766;3;92;2.0
2;160;766;773;7;92;2.0
2;161;773;775;2;92;2.0
2;162;775;778;3;92;2.0
2;163;778;779;1;92;2.0
2;164;779;781;2;92;2.0
2;165;781;783;2;92;2.0
2;166;783;786;3;92;2.0
2;167;786;790;4;92;2.0
2;168;790;793;3;92;2.0
2;169;793;798;5;92;2.0
2;170;798;799;1;92;2.0
2;171;799;801;2;92;2.0
2;172;801;803;2;92;2.0
2;173;803;806;3;92;2.0
2;174;806;813;7;92;2.0
2;175;813;815;2;92;2.0
2;176;815;816;1;92;2.0
2;177;816;818;2;92;2.0
2;178;818;819;1;92;2.0
2;179;819;821;2;92;2.0
2;180;821;823;2;92;2.0
2;181;823;826;3;92;2.0
2;182;826;833;7;92;2.0
2;183;833;835;2;92;2.0
2;184;835;838;3;92;2.0
2;185;838;839;1;92;2.0
2;186;839;841;2;92;2.0
2;187;841;843;2;92;2.0
2;188;843;846;3;92;2.0
2;189;846;848;2;92;2.0
2;190;848;850;2;92;2.0
2;191;850;853;3;92;2.0
2;192;853;858;5;92;2.0
2;193;858;859;1;92;2.0
2;194;859;861;2;92;2.0
2;195;861;863;2;92;2.0
2;196;863;866;3;92;2.0
2;197;866;868;2;92;2.0
2;198;868;870;2;92;2.0
2;199;870;873;3;92;2.0
2;200;873;876;3;92;2.0
2;201;876;878;2;92;2.0
2;202;878;879;1;92;2.0
2;203;879;881;2;92;2.0
2;204;881;883;2;92;2.0
2;205;883;886;3;92;2.0
2;206;886;888;2;92;2.0
2;207;888;891;3;92;2.0
2;208;891;893;2;92;2.0
2;209;893;895;2;92;2.0
2;210;895;898;3;92;2.0
2;211;898;899;1;92;2.0
2;212;899;901;2;92;2.0
2;213;901;903;2;92;2.0
2;214;903;906;3;92;2.0
2;215;906;908;2;92;2.0
2;216;908;910;2;92;2.0
2;217;910;913;3;92;2.0
2;218;913;916;3;92;2.0
2;219;916;918;2;92;2.0
2;220;918;919;1;92;2.0
2;221;919;921;2;92;2.0
2;222;921;923;2;92;2.0
2;223;923;926;3;92;2.0
2;224;926;928;2;92;2.0
2;225;928;930;2;92;2.0
2;226;930;933;3;92;2.0
2;227;933;936;3;92;2.0
2;228;936;938;2;92;2.0
2;229;938;939;1;92;2.0
2;230;939;941;2;92;2.0
2;231;941;943;2;92;2.0
2;232;943;946;3;92;2.0
2;233;946;948;2;92;2.0
2;234;948;951;3;92;2.0
2;235;951;953;2;92;2.0
2;236;953;955;2;92;2.0
2;237;955;958;3;92;2.0
2;238;958;959;1;92;2.0
2;239;959;961;2;92;2.0
2;240;961;963;2;92;2.0
2;241;963;966;3;92;2.0
2;242;966;968;2;92;2.0
2;243;968;970;2;92;2.0
2;244;970;973;3;92;2.0
2;245;973;976;3;92;2.0
2;246;976;978;2;92;2.0
2;247;978;979;1;92;2.0
2;248;979;981;2;92;2.0
2;249;981;983;2;92;2.0
2;250;983;986;3;92;2.0
2;251;986;988;2;92;2.0
2;252;988;990;2;92;2.0
2;253;990;993;3;92;2.0
2;254;993;998;5;92;2.0
2;255;998;999;1;92;2.0
2;256;999;1001;2;92;2.0
2;257;1001;1003;2;92;2.0
2;258;1003;1006;3;92;2.0
2;259;1006;1008;2;92;2.0
2;260;1008;1011;3;92;2.0
2;261;1011;1013;2;92;2.0
2;262;1013;1015;2;92;2.0
2;263;1015;1018;3;92;2.0
2;264;1018;1019;1;92;2.0
2;265;1019;1021;2;92;2.0
2;266;1021;1023;2;92;2.0
2;267;1023;1026;3;92;2.0
2;268;1026;1028;2;92;2.0
2;269;1028;1030;2;92;2.0
2;270;1030;1033;3;92;2.0
2;271;1033;1038;5;92;2.0
2;272;1038;1039;1;92;2.0
2;273;1039;1041;2;92;2.0
2;274;1041;1043;2;92;2.0
2;275;1043;1046;3;92;2.0
2;276;1046;1048;2;92;2.0
2;277;1048;1050;2;92;2.0
2;278;1050;1051;1;92;2.0
2;279;1051;1053;2;92;2.0
2;280;1053;1058;5;92;2.0
2;281;1058;1059;1;92;2.0
2;282;1059;1061;2;92;2.0
2;283;1061;1063;2;92;2.0
2;284;1063;1066;3;92;2.0
2;285;1066;1068;2;92;2.0
2;286;1068;1071;3;92;2.0
2;287;1071;1072;1;92;2.0
2;288;1072;1073;1;92;2.0
2;289;1073;1075;2;92;2.0
2;290;1075;1078;3;92;2.0
2;291;1078;1079;1;92;2.0
2;292;1079;1081;2;92;2.0
2;293;1081;1083;2;92;2.0
2;294;1083;1086;3;92;2.0
2;295;1086;1088;2;92;2.0
2;296;1088;1090;2;92;2.0
2;297;1090;1093;3;92;2.0
2;298;1093;1098;5;92;2.0
2;299;1098;1101;3;92;2.0
2;300;1101;1103;2;92;2.0
2;301;1103;1107;4;92;2.0
2;302;1107;1108;1;92;2.0
2;303;1108;1109;1;92;2.0
2;304;1109;1113;4;92;2.0
2;305;1113;1115;2;92;2.0
2;306;1115;1116;1;92;2.0
2;307;1116;1120;4;92;2.0
2;308;1120;1121;1;92;2.0
2;309;1121;1125;4;92;2.0
2;310;1125;1129;4;92;2.0
2;311;1129;1130;1;92;2.0
2;312;1130;1132;2;92;2.0
2;313;1132;1139;7;92;2.0
2;314;1139;1140;1;92;2.0
2;315;1140;1141;1;92;2.0
2;316;1141;1143;2;92;2.0
2;317;1143;1145;2;92;2.0
2;318;1145;1152;7;92;2.0
2;319;1152;1154;2;92;2.0
2;320;1154;1155;1;92;2.0
2;321;1155;1160;5;92;2.0
2;322;1160;1161;1;92;2.0
2;323;1161;1168;7;92;2.0
2;324;1168;1174;6;92;2.0
2;325;1174;1175;1;92;2.0
2;326;1175;1177;2;92;2.0
2;327;1177;1179;2;92;2.0
2;328;1179;1180;1;92;2.0
2;329;1180;1181;1;92;2.0
2;330;1181;1189;8;92;2.0
2;331;1189;1195;6;92;2.0
2;332;1195;1200;5;92;2.0
2;333;1200;1202;2;92;2.0
2;334;1202;1206;4;92;2.0
2;335;1206;1209;3;92;2.0
2;336;1209;1215;6;92;2.0
2;337;1215;1225;10;92;2.0
2;338;1225;1226;1;92;2.0
2;339;1226;1229;3;92;2.0
2;340;1229;1230;1;92;2.0
2;341;1230;1234;4;92;2.0
2;342;1234;1235;1;92;2.0
2;343;1235;1237;2;92;2.0
2;344;1237;1250;13;92;2.0
2;345;1250;1251;1;92;2.0
2;346;1251;1254;3;92;2.0
2;347;1254;1260;6;92;2.0
2;348;1260;1269;9;92;2.0
2;349;1269;1270;1;92;2.0
2;350;1270;1272;2;92;2.0
2;351;1272;1275;3;92;2.0
2;352;1275;1276;1;92;2.0
2;353;1276;1284;8;92;2.0
2;354;1284;1285;1;92;2.0
2;355;1285;1300;15;92;2.0
2;356;1300;1303;3;92;2.0
2;357;1303;1307;4;92;2.0
2;358;1307;1309;2;92;2.0
2;359;1309;1310;1;92;2.0
2;360;1310;1320;10;92;2.0
2;361;1320;1330;10;92;2.0
2;362;1330;1331;1;92;2.0
2;363;1331;1334;3;92;2.0
2;364;1334;1335;1;92;2.0
2;365;1335;1340;5;92;2.0
2;366;1340;1345;5;92;2.0
2;367;1345;1346;1;92;2.0
2;368;1346;1350;4;92;2.0
2;369;1350;1361;11;92;2.0
2;370;1361;1363;2;92;2.0
2;371;1363;1365;2;92;2.0
2;372;1365;1380;15;92;2.0
2;373;1380;1386;6;92;2.0
2;374;1386;1401;15;92;2.0
2;375;1401;1416;15;92;2.0
2;376;1416;1431;15;92;2.0
2;377;1431;1446;15;92;2.0
2;378;1446;1461;15;92;2.0
2;379;1461;1476;15;92;2.0
2;380;1476;1491;15;92;2.0
2;381;1491;1506;15;92;2.0
2;382;1506;1521;15;92;2.0
2;383;1521;1536;15;92;2.0
2;384;1536;1551;15;92;2.0
2;385;1551;1566;15;92;2.0
2;386;1566;1581;15;92;2.0
2;387;1581;1596;15;92;2.0
2;388;1596;1611;15;92;2.0
2;389;1611;1626;15;92;2.0
2;390;1626;1641;15;92;2.0
2;391;1641;1656;15;92;2.0
2;392;1656;1671;15;92;2.0
2;393;1671;1680;9;92;2.0
3;0;248;328;80;77;2.0
3;1;328;332;4;77;2.0
3;2;332;335;3;77;2.0
3;3;335;340;5;77;2.0
3;4;340;341;1;77;2.0
3;5;341;343;2;77;2.0
3;6;343;346;3;77;2.0
3;7;346;347;1;77;2.0
3;8;347;348;1;77;2.0
3;9;348;349;1;77;2.0
3;10;349;350;1;77;2.0
3;11;350;355;5;77;2.0
3;12;355;356;1;77;2.0
3;13;356;358;2;77;2.0
3;14;358;362;4;77;2.0
3;15;362;365;3;77;2.0
3;16;365;366;1;77;2.0
3;17;366;369;3;77;2.0
3;18;369;373;4;77;2.0
3;19;373;376;3;77;2.0
3;20;376;378;2;77;2.0
3;21;378;380;2;77;2.0
3;22;380;381;1;77;2.0
3;23;381;386;5;77;2.0
3;24;386;389;3;77;2.0
3;25;389;390;1;77;2.0
3;26;390;391;1;77;2.0
3;27;391;396;5;77;2.0
3;28;396;398;2;77;2.0
3;29;398;400;2;77;2.0
3;30;400;401;1;77;2.0
3;31;401;406;5;77;2.0
3;32;406;408;2;77;2.0
3;33;408;409;1;77;2.0
3;34;409;410;1;77;2.0
3;35;410;411;1;77;2.0
3;36;411;413;2;77;2.0
3;37;413;416;3;77;2.0
3;38;416;418;2;77;2.0
3;39;418;420;2;77;2.0
3;40;420;421;1;77;2.0
3;41;421;422;1;77;2.0
3;42;422;426;4;77;2.0
3;43;426;428;2;77;2.0
3;44;428;429;1;77;2.0
3;45;429;430;1;77;2.0
3;46;430;431;1;77;2.0
3;47;431;433;2;77;2.0
3;48;433;436;3;77;2.0
3;49;436;440;4;77;2.0
3;50;440;441;1;77;2.0
3;51;441;443;2;77;2.0
3;52;443;446;3;77;2.0
3;53;446;449;3;77;2.0
3;54;449;450;1;77;2.0
3;55;450;451;1;77;2.0
3;56;451;456;5;77;2.0
3;57;456;458;2;77;2.0
3;58;458;460;2;77;2.0
3;59;460;461;1;77;2.0
3;60;461;466;5;77;2.0
3;61;466;468;2;77;2.0
3;62;468;469;1;77;2.0
3;63;469;470;1;77;2.0
3;64;470;471;1;77;2.0
3;65;471;473;2;77;2.0
3;66;473;476;3;77;2.0
3;67;476;478;2;77;2.0
3;68;478;480;2;77;2.0
3;69;480;481;1;77;2.0
3;70;481;482;1;77;2.0
3;71;482;486;4;77;2.0
3;72;486;489;3;77;2.0
3;73;489;490;1;77;2.0
3;74;490;491;1;77;2.0
3;75;491;492;1;77;2.0
3;76;492;493;1;77;2.0
3;77;493;496;3;77;2.0
3;78;496;498;2;77;2.0
3;79;498;500;2;77;2.0
3;80;500;503;3;77;2.0
3;81;503;506;3;77;2.0
3;82;506;509;3;77;2.0
3;83;509;510;1;77;2.0
3;84;510;516;6;77;2.0
3;85;516;518;2;77;2.0
3;86;518;520;2;77;2.0
3;87;520;521;1;77;2.0
3;88;521;523;2;77;2.0
3;89;523;526;3;77;2.0
3;90;526;529;3;77;2.0
3;91;529;531;2;77;2.0
3;92;531;536;5;77;2.0
3;93;536;540;4;77;2.0
3;94;540;541;1;77;2.0
3;95;541;546;5;77;2.0
3;96;546;549;3;77;2.0
3;97;549;556;7;77;2.0
3;98;556;558;2;77;2.0
3;99;558;560;2;77;2.0
3;100;560;561;1;77;2.0
3;101;561;562;1;77;2.0
3;102;562;566;4;77;2.0
3;103;566;569;3;77;2.0
3;104;569;571;2;77;2.0
3;105;571;576;5;77;2.0
3;106;576;580;4;77;2.0
3;107;580;581;1;77;2.0
3;108;581;586;5;77;2.0
3;109;586;589;3;77;2.0
3;110;589;596;7;77;2.0
3;111;596;598;2;77;2.0
3;112;598;600;2;77;2.0
3;113;600;601;1;77;2.0
3;114;601;606;5;77;2.0
3;115;606;609;3;77;2.0
3;116;609;611;2;77;2.0
3;117;611;616;5;77;2.0
3;118;616;620;4;77;2.0
3;119;620;621;1;77;2.0
3;120;621;622;1;77;2.0
3;121;622;626;4;77;2.0
3;122;626;629;3;77;2.0
3;123;629;631;2;77;2.0
3;124;631;636;5;77;2.0
3;125;636;640;4;77;2.0
3;126;640;641;1;77;2.0
3;127;641;646;5;77;2.0
3;128;646;649;3;77;2.0
3;129;649;656;7;77;2.0
3;130;656;658;2;77;2.0
3;131;658;660;2;77;2.0
3;132;660;661;1;77;2.0
3;133;661;666;5;77;2.0
3;134;666;669;3;77;2.0
3;135;669;671;2;77;2.0
3;136;671;676;5;77;2.0
3;137;676;680;4;77;2.0
3;138;680;681;1;77;2.0
3;139;681;686;5;77;2.0
3;140;686;689;3;77;2.0
3;141;689;691;2;77;2.0
3;142;691;696;5;77;2.0
3;143;696;700;4;77;2.0
3;144;700;701;1;77;2.0
3;145;701;706;5;77;2.0
3;146;706;709;3;77;2.0
3;147;709;716;7;77;2.0
3;148;716;718;2;77;2.0
3;149;718;720;2;77;2.0
3;150;720;721;1;77;2.0
3;151;721;726;5;77;2.0
3;152;726;729;3;77;2.0
3;153;729;731;2;77;2.0
3;154;731;736;5;77;2.0
3;155;736;740;4;77;2.0
3;156;740;741;1;77;2.0
3;157;741;746;5;77;2.0
3;158;746;749;3;77;2.0
3;159;749;751;2;77;2.0
3;160;751;756;5;77;2.0
3;161;756;760;4;77;2.0
3;162;760;761;1;77;2.0
3;163;761;766;5;77;2.0
3;164;766;769;3;77;2.0
3;165;769;776;7;77;2.0
3;166;776;778;2;77;2.0
3;167;778;780;2;77;2.0
3;168;780;781;1;77;2.0
3;169;781;786;5;77;2.0
3;170;786;789;3;77;2.0
3;171;789;791;2;77;2.0
3;172;791;796;5;77;2.0
3;173;796;800;4;77;2.0
3;174;800;801;1;77;2.0
3;175;801;802;1;77;2.0
3;176;802;806;4;77;2.0
3;177;806;809;3;77;2.0
3;178;809;816;7;77;2.0
3;179;816;818;2;77;2.0
3;180;818;820;2;77;2.0
3;181;820;821;1;77;2.0
3;182;821;826;5;77;2.0
3;183;826;829;3;77;2.0
3;184;829;833;4;77;2.0
3;185;833;836;3;77;2.0
3;186;836;838;2;77;2.0
3;187;838;840;2;77;2.0
3;188;840;841;1;77;2.0
3;189;841;846;5;77;2.0
3;190;846;849;3;77;2.0
3;191;849;851;2;77;2.0
3;192;851;853;2;77;2.0
3;193;853;856;3;77;2.0
3;194;856;859;3;77;2.0
3;195;859;860;1;77;2.0
3;196;860;861;1;77;2.0
3;197;861;862;1;77;2.0
3;198;862;866;4;77;2.0
3;199;866;869;3;77;2.0
3;200;869;870;1;77;2.0
3;201;870;871;1;77;2.0
3;202;871;873;2;77;2.0
3;203;873;876;3;77;2.0
3;204;876;880;4;77;2.0
3;205;880;881;1;77;2.0
3;206;881;886;5;77;2.0
3;207;886;889;3;77;2.0
3;208;889;890;1;77;2.0
3;209;890;891;1;77;2.0
3;210;891;893;2;77;2.0
3;211;893;896;3;77;2.0
3;212;896;898;2;77;2.0
3;213;898;900;2;77;2.0
3;214;900;901;1;77;2.0
3;215;901;906;5;77;2.0
3;216;906;909;3;77;2.0
3;217;909;910;1;77;2.0
3;218;910;911;1;77;2.0
3;219;911;913;2;77;2.0
3;220;913;916;3;77;2.0
3;221;916;920;4;77;2.0
3;222;920;921;1;77;2.0
3;223;921;922;1;77;2.0
3;224;922;926;4;77;2.0
3;225;926;929;3;77;2.0
3;226;929;930;1;77;2.0
3;227;930;931;1;77;2.0
3;228;931;933;2;77;2.0
3;229;933;936;3;77;2.0
3;230;936;940;4;77;2.0
3;231;940;941;1;77;2.0
3;232;941;946;5;77;2.0
3;233;946;949;3;77;2.0
3;234;949;950;1;77;2.0
3;235;950;951;1;77;2.0
3;236;951;953;2;77;2.0
3;237;953;956;3;77;2.0
3;238;956;958;2;77;2.0
3;239;958;960;2;77;2.0
3;240;960;961;1;77;2.0
3;241;961;966;5;77;2.0
3;242;966;969;3;77;2.0
3;243;969;970;1;77;2.0
3;244;970;971;1;77;2.0
3;245;971;973;2;77;2.0
3;246;973;976;3;77;2.0
3;247;976;980;4;77;2.0
3;248;980;981;1;77;2.0
3;249;981;982;1;77;2.0
3;250;982;986;4;77;2.0
3;251;986;989;3;77;2.0
3;252;989;990;1;77;2.0
3;253;990;991;1;77;2.0
3;254;991;993;2;77;2.0
3;255;993;996;3;77;2.0
3;256;996;999;3;77;2.0
3;257;999;1000;1;77;2.0
3;258;1000;1001;1;77;2.0
3;259;1001;1006;5;77;2.0
3;260;1006;1009;3;77;2.0
3;261;1009;1011;2;77;2.0
3;262;1011;1013;2;77;2.0
3;263;1013;1015;2;77;2.0
3;264;1015;1016;1;77;2.0
3;265;1016;1018;2;77;2.0
3;266;1018;1021;3;77;2.0
3;267;1021;1026;5;77;2.0
3;268;1026;1029;3;77;2.0
3;269;1029;1030;1;77;2.0
3;270;1030;1031;1;77;2.0
3;271;1031;1033;2;77;2.0
3;272;1033;1036;3;77;2.0
3;273;1036;1041;5;77;2.0
3;274;1041;1045;4;77;2.0
3;275;1045;1046;1;77;2.0
3;276;1046;1049;3;77;2.0
3;277;1049;1051;2;77;2.0
3;278;1051;1053;2;77;2.0
3;279;1053;1056;3;77;2.0
3;280;1056;1060;4;77;2.0
3;281;1060;1061;1;77;2.0
3;282;1061;1069;8;77;2.0
3;283;1069;1071;2;77;2.0
3;284;1071;1073;2;77;2.0
3;285;1073;1075;2;77;2.0
3;286;1075;1076;1;77;2.0
3;287;1076;1078;2;77;2.0
3;288;1078;1081;3;77;2.0
3;289;1081;1086;5;77;2.0
3;290;1086;1089;3;77;2.0
3;291;1089;1090;1;77;2.0
3;292;1090;1091;1;77;2.0
3;293;1091;1093;2;77;2.0
3;294;1093;1101;8;77;2.0
3;295;1101;1104;3;77;2.0
3;296;1104;1105;1;77;2.0
3;297;1105;1106;1;77;2.0
3;298;1106;1110;4;77;2.0
3;299;1110;1111;1;77;2.0
3;300;1111;1113;2;77;2.0
3;301;1113;1116;3;77;2.0
3;302;1116;1117;1;77;2.0
3;303;1117;1118;1;77;2.0
3;304;1118;1121;3;77;2.0
3;305;1121;1128;7;77;2.0
3;306;1128;1129;1;77;2.0
3;307;1129;1132;3;77;2.0
3;308;1132;1133;1;77;2.0
3;309;1133;1137;4;77;2.0
3;310;1137;1141;4;77;2.0
3;311;1141;1142;1;77;2.0
3;312;1142;1143;1;77;2.0
3;313;1143;1146;3;77;2.0
3;314;1146;1148;2;77;2.0
3;315;1148;1149;1;77;2.0
3;316;1149;1155;6;77;2.0
3;317;1155;1157;2;77;2.0
3;318;1157;1158;1;77;2.0
3;319;1158;1161;3;77;2.0
3;320;1161;1163;2;77;2.0
3;321;1163;1171;8;77;2.0
3;322;1171;1174;3;77;2.0
3;323;1174;1177;3;77;2.0
3;324;1177;1178;1;77;2.0
3;325;1178;1180;2;77;2.0
3;326;1180;1181;1;77;2.0
3;327;1181;1183;2;77;2.0
3;328;1183;1192;9;77;2.0
3;329;1192;1197;5;77;2.0
3;330;1197;1198;1;77;2.0
3;331;1198;1199;1;77;2.0
3;332;1199;1203;4;77;2.0
3;333;1203;1206;3;77;2.0
3;334;1206;1212;6;77;2.0
3;335;1212;1218;6;77;2.0
3;336;1218;1222;4;77;2.0
3;337;1222;1226;4;77;2.0
3;338;1226;1228;2;77;2.0
3;339;1228;1230;2;77;2.0
3;340;1230;1233;3;77;2.0
3;341;1233;1234;1;77;2.0
3;342;1234;1238;4;77;2.0
3;343;1238;1247;9;77;2.0
3;344;1247;1251;4;77;2.0
3;345;1251;1253;2;77;2.0
3;346;1253;1255;2;77;2.0
3;347;1255;1263;8;77;2.0
3;348;1263;1269;6;77;2.0
3;349;1269;1272;3;77;2.0
3;350;1272;1273;1;77;2.0
3;351;1273;1276;3;77;2.0
3;352;1276;1278;2;77;2.0
3;353;1278;1287;9;77;2.0
3;354;1287;1288;1;77;2.0
3;355;1288;1297;9;77;2.0
3;356;1297;1303;6;77;2.0
3;357;1303;1304;1;77;2.0
3;358;1304;1309;5;77;2.0
3;359;1309;1312;3;77;2.0
3;360;1312;1313;1;77;2.0
3;361;1313;1323;10;77;2.0
3;362;1323;1327;4;77;2.0
3;363;1327;1331;4;77;2.0
3;364;1331;1337;6;77;2.0
3;365;1337;1338;1;77;2.0
3;366;1338;1343;5;77;2.0
3;367;1343;1346;3;77;2.0
3;368;1346;1347;1;77;2.0
3;369;1347;1348;1;77;2.0
3;370;1348;1361;13;77;2.0
3;371;1361;1362;1;77;2.0
3;372;1362;1364;2;77;2.0
3;373;1364;1366;2;77;2.0
3;374;1366;1383;17;77;2.0
3;375;1383;1386;3;77;2.0
3;376;1386;1401;15;77;2.0
3;377;1401;1416;15;77;2.0
3;378;1416;1431;15;77;2.0
3;379;1431;1446;15;77;2.0
3;380;1446;1461;15;77;2.0
3;381;1461;1476;15;77;2.0
3;382;1476;1491;15;77;2.0
3;383;1491;1506;15;77;2.0
3;384;1506;1521;15;77;2.0
3;385;1521;1536;15;77;2.0
3;386;1536;1551;15;77;2.0
3;387;1551;1566;15;77;2.0
3;388;1566;1581;15;77;2.0
3;389;1581;1596;15;77;2.0
3;390;1596;1611;15;77;2.0
3;391;1611;1626;15;77;2.0
3;392;1626;1641;15;77;2.0
3;393;1641;1656;15;77;2.0
3;394;1656;1671;15;77;2.0
3;395;1671;1680;9;77;2.0
4;0;245;326;81;119;2.0
4;1;326;331;5;119;2.0
4;2;331;338;7;119;2.0
4;3;338;339;1;119;2.0
4;4;339;341;2;119;2.0
4;5;341;344;3;119;2.0
4;6;344;346;2;119;2.0
4;7;346;348;2;119;2.0
4;8;348;350;2;119;2.0
4;9;350;353;3;119;2.0
4;10;353;354;1;119;2.0
4;11;354;356;2;119;2.0
4;12;356;361;5;119;2.0
4;13;361;364;3;119;2.0
4;14;364;367;3;119;2.0
4;15;367;368;1;119;2.0
4;16;368;369;1;119;2.0
4;17;369;371;2;119;2.0
4;18;371;375;4;119;2.0
4;19;375;376;1;119;2.0
4;20;376;379;3;119;2.0
4;21;379;380;1;119;2.0
4;22;380;383;3;119;2.0
4;23;383;384;1;119;2.0
4;24;384;385;1;119;2.0
4;25;385;388;3;119;2.0
4;26;388;389;1;119;2.0
4;27;389;394;5;119;2.0
4;28;394;395;1;119;2.0
4;29;395;396;1;119;2.0
4;30;396;399;3;119;2.0
4;31;399;400;1;119;2.0
4;32;400;404;4;119;2.0
4;33;404;405;1;119;2.0
4;34;405;406;1;119;2.0
4;35;406;408;2;119;2.0
4;36;408;409;1;119;2.0
4;37;409;411;2;119;2.0
4;38;411;413;2;119;2.0
4;39;413;414;1;119;2.0
4;40;414;415;1;119;2.0
4;41;415;416;1;119;2.0
4;42;416;419;3;119;2.0
4;43;419;420;1;119;2.0
4;44;420;421;1;119;2.0
4;45;421;424;3;119;2.0
4;46;424;425;1;119;2.0
4;47;425;426;1;119;2.0
4;48;426;428;2;119;2.0
4;49;428;429;1;119;2.0
4;50;429;431;2;119;2.0
4;51;431;434;3;119;2.0
4;52;434;435;1;119;2.0
4;53;435;439;4;119;2.0
4;54;439;440;1;119;2.0
4;55;440;441;1;119;2.0
4;56;441;443;2;119;2.0
4;57;443;444;1;119;2.0
4;58;444;445;1;119;2.0
4;59;445;448;3;119;2.0
4;60;448;449;1;119;2.0
4;61;449;454;5;119;2.0
4;62;454;455;1;119;2.0
4;63;455;456;1;119;2.0
4;64;456;459;3;119;2.0
4;65;459;460;1;119;2.0
4;66;460;464;4;119;2.0
4;67;464;465;1;119;2.0
4;68;465;466;1;119;2.0
4;69;466;468;2;119;2.0
4;70;468;469;1;119;2.0
4;71;469;471;2;119;2.0
4;72;471;473;2;119;2.0
4;73;473;474;1;119;2.0
4;74;474;475;1;119;2.0
4;75;475;476;1;119;2.0
4;76;476;479;3;119;2.0
4;77;479;480;1;119;2.0
4;78;480;481;1;119;2.0
4;79;481;484;3;119;2.0
4;80;484;485;1;119;2.0
4;81;485;488;3;119;2.0
4;82;488;489;1;119;2.0
4;83;489;490;1;119;2.0
4;84;490;491;1;119;2.0
4;85;491;494;3;119;2.0
4;86;494;496;2;119;2.0
4;87;496;500;4;119;2.0
4;88;500;501;1;119;2.0
4;89;501;504;3;119;2.0
4;90;504;505;1;119;2.0
4;91;505;508;3;119;2.0
4;92;508;514;6;119;2.0
4;93;514;516;2;119;2.0
4;94;516;519;3;119;2.0
4;95;519;520;1;119;2.0
4;96;520;521;1;119;2.0
4;97;521;524;3;119;2.0
4;98;524;525;1;119;2.0
4;99;525;528;3;119;2.0
4;100;528;533;5;119;2.0
4;101;533;539;6;119;2.0
4;102;539;540;1;119;2.0
4;103;540;544;4;119;2.0
4;104;544;545;1;119;2.0
4;105;545;548;3;119;2.0
4;106;548;556;8;119;2.0
4;107;556;559;3;119;2.0
4;108;559;560;1;119;2.0
4;109;560;561;1;119;2.0
4;110;561;564;3;119;2.0
4;111;564;565;1;119;2.0
4;112;565;568;3;119;2.0
4;113;568;574;6;119;2.0
4;114;574;579;5;119;2.0
4;115;579;580;1;119;2.0
4;116;580;584;4;119;2.0
4;117;584;585;1;119;2.0
4;118;585;588;3;119;2.0
4;119;588;593;5;119;2.0
4;120;593;596;3;119;2.0
4;121;596;599;3;119;2.0
4;122;599;600;1;119;2.0
4;123;600;604;4;119;2.0
4;124;604;605;1;119;2.0
4;125;605;608;3;119;2.0
4;126;608;619;11;119;2.0
4;127;619;620;1;119;2.0
4;128;620;621;1;119;2.0
4;129;621;624;3;119;2.0
4;130;624;625;1;119;2.0
4;131;625;628;3;119;2.0
4;132;628;634;6;119;2.0
4;133;634;639;5;119;2.0
4;134;639;640;1;119;2.0
4;135;640;644;4;119;2.0
4;136;644;645;1;119;2.0
4;137;645;648;3;119;2.0
4;138;648;653;5;119;2.0
4;139;653;656;3;119;2.0
4;140;656;659;3;119;2.0
4;141;659;660;1;119;2.0
4;142;660;664;4;119;2.0
4;143;664;665;1;119;2.0
4;144;665;668;3;119;2.0
4;145;668;679;11;119;2.0
4;146;679;680;1;119;2.0
4;147;680;684;4;119;2.0
4;148;684;685;1;119;2.0
4;149;685;688;3;119;2.0
4;150;688;694;6;119;2.0
4;151;694;699;5;119;2.0
4;152;699;700;1;119;2.0
4;153;700;704;4;119;2.0
4;154;704;705;1;119;2.0
4;155;705;708;3;119;2.0
4;156;708;713;5;119;2.0
4;157;713;716;3;119;2.0
4;158;716;719;3;119;2.0
4;159;719;720;1;119;2.0
4;160;720;724;4;119;2.0
4;161;724;725;1;119;2.0
4;162;725;728;3;119;2.0
4;163;728;739;11;119;2.0
4;164;739;740;1;119;2.0
4;165;740;744;4;119;2.0
4;166;744;745;1;119;2.0
4;167;745;748;3;119;2.0
4;168;748;754;6;119;2.0
4;169;754;759;5;119;2.0
4;170;759;760;1;119;2.0
4;171;760;764;4;119;2.0
4;172;764;765;1;119;2.0
4;173;765;768;3;119;2.0
4;174;768;773;5;119;2.0
4;175;773;776;3;119;2.0
4;176;776;779;3;119;2.0
4;177;779;780;1;119;2.0
4;178;780;784;4;119;2.0
4;179;784;785;1;119;2.0
4;180;785;788;3;119;2.0
4;181;788;795;7;119;2.0
4;182;795;799;4;119;2.0
4;183;799;800;1;119;2.0
4;184;800;801;1;119;2.0
4;185;801;804;3;119;2.0
4;186;804;805;1;119;2.0
4;187;805;808;3;119;2.0
4;188;808;813;5;119;2.0
4;189;813;814;1;119;2.0
4;190;814;815;1;119;2.0
4;191;815;816;1;119;2.0
4;192;816;819;3;119;2.0
4;193;819;820;1;119;2.0
4;194;820;824;4;119;2.0
4;195;824;825;1;119;2.0
4;196;825;828;3;119;2.0
4;197;828;831;3;119;2.0
4;198;831;833;2;119;2.0
4;199;833;835;2;119;2.0
4;200;835;836;1;119;2.0
4;201;836;839;3;119;2.0
4;202;839;840;1;119;2.0
4;203;840;844;4;119;2.0
4;204;844;845;1;119;2.0
4;205;845;848;3;119;2.0
4;206;848;849;1;119;2.0
4;207;849;851;2;119;2.0
4;208;851;855;4;119;2.0
4;209;855;857;2;119;2.0
4;210;857;859;2;119;2.0
4;211;859;860;1;119;2.0
4;212;860;861;1;119;2.0
4;213;861;864;3;119;2.0
4;214;864;865;1;119;2.0
4;215;865;868;3;119;2.0
4;216;868;869;1;119;2.0
4;217;869;871;2;119;2.0
4;218;871;873;2;119;2.0
4;219;873;874;1;119;2.0
4;220;874;875;1;119;2.0
4;221;875;879;4;119;2.0
4;222;879;880;1;119;2.0
4;223;880;884;4;119;2.0
4;224;884;885;1;119;2.0
4;225;885;888;3;119;2.0
4;226;888;889;1;119;2.0
4;227;889;891;2;119;2.0
4;228;891;893;2;119;2.0
4;229;893;894;1;119;2.0
4;230;894;895;1;119;2.0
4;231;895;896;1;119;2.0
4;232;896;899;3;119;2.0
4;233;899;900;1;119;2.0
4;234;900;904;4;119;2.0
4;235;904;905;1;119;2.0
4;236;905;908;3;119;2.0
4;237;908;909;1;119;2.0
4;238;909;911;2;119;2.0
4;239;911;914;3;119;2.0
4;240;914;915;1;119;2.0
4;241;915;919;4;119;2.0
4;242;919;920;1;119;2.0
4;243;920;921;1;119;2.0
4;244;921;924;3;119;2.0
4;245;924;925;1;119;2.0
4;246;925;928;3;119;2.0
4;247;928;929;1;119;2.0
4;248;929;931;2;119;2.0
4;249;931;933;2;119;2.0
4;250;933;934;1;119;2.0
4;251;934;935;1;119;2.0
4;252;935;939;4;119;2.0
4;253;939;940;1;119;2.0
4;254;940;944;4;119;2.0
4;255;944;945;1;119;2.0
4;256;945;948;3;119;2.0
4;257;948;949;1;119;2.0
4;258;949;951;2;119;2.0
4;259;951;953;2;119;2.0
4;260;953;954;1;119;2.0
4;261;954;955;1;119;2.0
4;262;955;956;1;119;2.0
4;263;956;959;3;119;2.0
4;264;959;960;1;119;2.0
4;265;960;964;4;119;2.0
4;266;964;965;1;119;2.0
4;267;965;968;3;119;2.0
4;268;968;969;1;119;2.0
4;269;969;971;2;119;2.0
4;270;971;974;3;119;2.0
4;271;974;975;1;119;2.0
4;272;975;979;4;119;2.0
4;273;979;980;1;119;2.0
4;274;980;981;1;119;2.0
4;275;981;984;3;119;2.0
4;276;984;985;1;119;2.0
4;277;985;988;3;119;2.0
4;278;988;989;1;119;2.0
4;279;989;991;2;119;2.0
4;280;991;994;3;119;2.0
4;281;994;995;1;119;2.0
4;282;995;997;2;119;2.0
4;283;997;999;2;119;2.0
4;284;999;1000;1;119;2.0
4;285;1000;1004;4;119;2.0
4;286;1004;1005;1;119;2.0
4;287;1005;1008;3;119;2.0
4;288;1008;1009;1;119;2.0
4;289;1009;1011;2;119;2.0
4;290;1011;1015;4;119;2.0
4;291;1015;1016;1;119;2.0
4;292;1016;1019;3;119;2.0
4;293;1019;1020;1;119;2.0
4;294;1020;1024;4;119;2.0
4;295;1024;1028;4;119;2.0
4;296;1028;1030;2;119;2.0
4;297;1030;1031;1;119;2.0
4;298;1031;1034;3;119;2.0
4;299;1034;1039;5;119;2.0
4;300;1039;1040;1;119;2.0
4;301;1040;1045;5;119;2.0
4;302;1045;1048;3;119;2.0
4;303;1048;1049;1;119;2.0
4;304;1049;1051;2;119;2.0
4;305;1051;1054;3;119;2.0
4;306;1054;1059;5;119;2.0
4;307;1059;1060;1;119;2.0
4;308;1060;1064;4;119;2.0
4;309;1064;1068;4;119;2.0
4;310;1068;1069;1;119;2.0
4;311;1069;1071;2;119;2.0
4;312;1071;1072;1;119;2.0
4;313;1072;1075;3;119;2.0
4;314;1075;1076;1;119;2.0
4;315;1076;1079;3;119;2.0
4;316;1079;1080;1;119;2.0
4;317;1080;1084;4;119;2.0
4;318;1084;1088;4;119;2.0
4;319;1088;1090;2;119;2.0
4;320;1090;1091;1;119;2.0
4;321;1091;1094;3;119;2.0
4;322;1094;1099;5;119;2.0
4;323;1099;1105;6;119;2.0
4;324;1105;1107;2;119;2.0
4;325;1107;1108;1;119;2.0
4;326;1108;1109;1;119;2.0
4;327;1109;1110;1;119;2.0
4;328;1110;1111;1;119;2.0
4;329;1111;1114;3;119;2.0
4;330;1114;1117;3;119;2.0
4;331;1117;1119;2;119;2.0
4;332;1119;1121;2;119;2.0
4;333;1121;1126;5;119;2.0
4;334;1126;1129;3;119;2.0
4;335;1129;1130;1;119;2.0
4;336;1130;1132;2;119;2.0
4;337;1132;1133;1;119;2.0
4;338;1133;1139;6;119;2.0
4;339;1139;1140;1;119;2.0
4;340;1140;1141;1;119;2.0
4;341;1141;1145;4;119;2.0
4;342;1145;1147;2;119;2.0
4;343;1147;1152;5;119;2.0
4;344;1152;1153;1;119;2.0
4;345;1153;1156;3;119;2.0
4;346;1156;1159;3;119;2.0
4;347;1159;1161;2;119;2.0
4;348;1161;1162;1;119;2.0
4;349;1162;1170;8;119;2.0
4;350;1170;1172;2;119;2.0
4;351;1172;1176;4;119;2.0
4;352;1176;1177;1;119;2.0
4;353;1177;1178;1;119;2.0
4;354;1178;1179;1;119;2.0
4;355;1179;1181;2;119;2.0
4;356;1181;1182;1;119;2.0
4;357;1182;1189;7;119;2.0
4;358;1189;1196;7;119;2.0
4;359;1196;1197;1;119;2.0
4;360;1197;1201;4;119;2.0
4;361;1201;1202;1;119;2.0
4;362;1202;1203;1;119;2.0
4;363;1203;1204;1;119;2.0
4;364;1204;1210;6;119;2.0
4;365;1210;1216;6;119;2.0
4;366;1216;1224;8;119;2.0
4;367;1224;1226;2;119;2.0
4;368;1226;1227;1;119;2.0
4;369;1227;1232;5;119;2.0
4;370;1232;1236;4;119;2.0
4;371;1236;1238;2;119;2.0
4;372;1238;1249;11;119;2.0
4;373;1249;1251;2;119;2.0
4;374;1251;1252;1;119;2.0
4;375;1252;1261;9;119;2.0
4;376;1261;1269;8;119;2.0
4;377;1269;1272;3;119;2.0
4;378;1272;1273;1;119;2.0
4;379;1273;1274;1;119;2.0
4;380;1274;1276;2;119;2.0
4;381;1276;1277;1;119;2.0
4;382;1277;1285;8;119;2.0
4;383;1285;1286;1;119;2.0
4;384;1286;1301;15;119;2.0
4;385;1301;1302;1;119;2.0
4;386;1302;1307;5;119;2.0
4;387;1307;1308;1;119;2.0
4;388;1308;1310;2;119;2.0
4;389;1310;1311;1;119;2.0
4;390;1311;1312;1;119;2.0
4;391;1312;1322;10;119;2.0
4;392;1322;1329;7;119;2.0
4;393;1329;1331;2;119;2.0
4;394;1331;1335;4;119;2.0
4;395;1335;1336;1;119;2.0
4;396;1336;1342;6;119;2.0
4;397;1342;1344;2;119;2.0
4;398;1344;1347;3;119;2.0
4;399;1347;1351;4;119;2.0
4;400;1351;1359;8;119;2.0
4;401;1359;1363;4;119;2.0
4;402;1363;1364;1;119;2.0
4;403;1364;1366;2;119;2.0
4;404;1366;1381;15;119;2.0
4;405;1381;1384;3;119;2.0
4;406;1384;1399;15;119;2.0
4;407;1399;1414;15;119;2.0
4;408;1414;1429;15;119;2.0
4;409;1429;1444;15;119;2.0
4;410;1444;1459;15;119;2.0
4;411;1459;1474;15;119;2.0
4;412;1474;1489;15;119;2.0
4;413;1489;1504;15;119;2.0
4;414;1504;1519;15;119;2.0
4;415;1519;1534;15;119;2.0
4;416;1534;1549;15;119;2.0
4;417;1549;1564;15;119;2.0
4;418;1564;1579;15;119;2.0
4;419;1579;1594;15;119;2.0
4;420;1594;1609;15;119;2.0
4;421;1609;1624;15;119;2.0
4;422;1624;1639;15;119;2.0
4;423;1639;1654;15;119;2.0
4;424;1654;1669;15;119;2.0
4;425;1669;1680;11;119;2.0
5;0;243;325;82;96;2.0
5;1;325;331;6;96;2.0
5;2;331;337;6;96;2.0
5;3;337;338;1;96;2.0
5;4;338;341;3;96;2.0
5;5;341;343;2;96;2.0
5;6;343;346;3;96;2.0
5;7;346;348;2;96;2.0
5;8;348;351;3;96;2.0
5;9;351;352;1;96;2.0
5;10;352;353;1;96;2.0
5;11;353;354;1;96;2.0
5;12;354;355;1;96;2.0
5;13;355;356;1;96;2.0
5;14;356;361;5;96;2.0
5;15;361;366;5;96;2.0
5;16;366;368;2;96;2.0
5;17;368;371;3;96;2.0
5;18;371;373;2;96;2.0
5;19;373;375;2;96;2.0
5;20;375;378;3;96;2.0
5;21;378;381;3;96;2.0
5;22;381;382;1;96;2.0
5;23;382;385;3;96;2.0
5;24;385;386;1;96;2.0
5;25;386;388;2;96;2.0
5;26;388;395;7;96;2.0
5;27;395;396;1;96;2.0
5;28;396;398;2;96;2.0
5;29;398;402;4;96;2.0
5;30;402;405;3;96;2.0
5;31;405;406;1;96;2.0
5;32;406;408;2;96;2.0
5;33;408;411;3;96;2.0
5;34;411;413;2;96;2.0
5;35;413;415;2;96;2.0
5;36;415;416;1;96;2.0
5;37;416;418;2;96;2.0
5;38;418;422;4;96;2.0
5;39;422;423;1;96;2.0
5;40;423;425;2;96;2.0
5;41;425;426;1;96;2.0
5;42;426;428;2;96;2.0
5;43;428;433;5;96;2.0
5;44;433;435;2;96;2.0
5;45;435;436;1;96;2.0
5;46;436;438;2;96;2.0
5;47;438;441;3;96;2.0
5;48;441;442;1;96;2.0
5;49;442;443;1;96;2.0
5;50;443;445;2;96;2.0
5;51;445;446;1;96;2.0
5;52;446;448;2;96;2.0
5;53;448;455;7;96;2.0
5;54;455;456;1;96;2.0
5;55;456;458;2;96;2.0
5;56;458;461;3;96;2.0
5;57;461;462;1;96;2.0
5;58;462;465;3;96;2.0
5;59;465;466;1;96;2.0
5;60;466;468;2;96;2.0
5;61;468;471;3;96;2.0
5;62;471;473;2;96;2.0
5;63;473;475;2;96;2.0
5;64;475;476;1;96;2.0
5;65;476;478;2;96;2.0
5;66;478;482;4;96;2.0
5;67;482;483;1;96;2.0
5;68;483;485;2;96;2.0
5;69;485;486;1;96;2.0
5;70;486;488;2;96;2.0
5;71;488;492;4;96;2.0
5;72;492;493;1;96;2.0
5;73;493;495;2;96;2.0
5;74;495;496;1;96;2.0
5;75;496;502;6;96;2.0
5;76;502;503;1;96;2.0
5;77;503;505;2;96;2.0
5;78;505;506;1;96;2.0
5;79;506;508;2;96;2.0
5;80;508;515;7;96;2.0
5;81;515;516;1;96;2.0
5;82;516;520;4;96;2.0
5;83;520;521;1;96;2.0
5;84;521;522;1;96;2.0
5;85;522;525;3;96;2.0
5;86;525;526;1;96;2.0
5;87;526;528;2;96;2.0
5;88;528;530;2;96;2.0
5;89;530;531;1;96;2.0
5;90;531;538;7;96;2.0
5;91;538;541;3;96;2.0
5;92;541;542;1;96;2.0
5;93;542;545;3;96;2.0
5;94;545;546;1;96;2.0
5;95;546;548;2;96;2.0
5;96;548;555;7;96;2.0
5;97;555;558;3;96;2.0
5;98;558;561;3;96;2.0
5;99;561;562;1;96;2.0
5;100;562;563;1;96;2.0
5;101;563;565;2;96;2.0
5;102;565;566;1;96;2.0
5;103;566;568;2;96;2.0
5;104;568;570;2;96;2.0
5;105;570;576;6;96;2.0
5;106;576;578;2;96;2.0
5;107;578;581;3;96;2.0
5;108;581;582;1;96;2.0
5;109;582;585;3;96;2.0
5;110;585;586;1;96;2.0
5;111;586;588;2;96;2.0
5;112;588;591;3;96;2.0
5;113;591;595;4;96;2.0
5;114;595;598;3;96;2.0
5;115;598;601;3;96;2.0
5;116;601;602;1;96;2.0
5;117;602;605;3;96;2.0
5;118;605;606;1;96;2.0
5;119;606;608;2;96;2.0
5;120;608;610;2;96;2.0
5;121;610;618;8;96;2.0
5;122;618;621;3;96;2.0
5;123;621;622;1;96;2.0
5;124;622;623;1;96;2.0
5;125;623;625;2;96;2.0
5;126;625;626;1;96;2.0
5;127;626;628;2;96;2.0
5;128;628;630;2;96;2.0
5;129;630;636;6;96;2.0
5;130;636;638;2;96;2.0
5;131;638;641;3;96;2.0
5;132;641;642;1;96;2.0
5;133;642;645;3;96;2.0
5;134;645;646;1;96;2.0
5;135;646;648;2;96;2.0
5;136;648;651;3;96;2.0
5;137;651;655;4;96;2.0
5;138;655;658;3;96;2.0
5;139;658;661;3;96;2.0
5;140;661;662;1;96;2.0
5;141;662;665;3;96;2.0
5;142;665;666;1;96;2.0
5;143;666;668;2;96;2.0
5;144;668;670;2;96;2.0
5;145;670;678;8;96;2.0
5;146;678;681;3;96;2.0
5;147;681;682;1;96;2.0
5;148;682;685;3;96;2.0
5;149;685;686;1;96;2.0
5;150;686;688;2;96;2.0
5;151;688;690;2;96;2.0
5;152;690;696;6;96;2.0
5;153;696;698;2;96;2.0
5;154;698;701;3;96;2.0
5;155;701;702;1;96;2.0
5;156;702;705;3;96;2.0
5;157;705;706;1;96;2.0
5;158;706;708;2;96;2.0
5;159;708;711;3;96;2.0
5;160;711;715;4;96;2.0
5;161;715;718;3;96;2.0
5;162;718;721;3;96;2.0
5;163;721;722;1;96;2.0
5;164;722;725;3;96;2.0
5;165;725;726;1;96;2.0
5;166;726;728;2;96;2.0
5;167;728;730;2;96;2.0
5;168;730;738;8;96;2.0
5;169;738;741;3;96;2.0
5;170;741;742;1;96;2.0
5;171;742;745;3;96;2.0
5;172;745;746;1;96;2.0
5;173;746;748;2;96;2.0
5;174;748;750;2;96;2.0
5;175;750;756;6;96;2.0
5;176;756;758;2;96;2.0
5;177;758;761;3;96;2.0
5;178;761;762;1;96;2.0
5;179;762;765;3;96;2.0
5;180;765;766;1;96;2.0
5;181;766;768;2;96;2.0
5;182;768;771;3;96;2.0
5;183;771;775;4;96;2.0
5;184;775;778;3;96;2.0
5;185;778;781;3;96;2.0
5;186;781;782;1;96;2.0
5;187;782;785;3;96;2.0
5;188;785;786;1;96;2.0
5;189;786;788;2;96;2.0
5;190;788;790;2;96;2.0
5;191;790;795;5;96;2.0
5;192;795;798;3;96;2.0
5;193;798;801;3;96;2.0
5;194;801;802;1;96;2.0
5;195;802;803;1;96;2.0
5;196;803;805;2;96;2.0
5;197;805;806;1;96;2.0
5;198;806;808;2;96;2.0
5;199;808;811;3;96;2.0
5;200;811;815;4;96;2.0
5;201;815;816;1;96;2.0
5;202;816;818;2;96;2.0
5;203;818;821;3;96;2.0
5;204;821;822;1;96;2.0
5;205;822;825;3;96;2.0
5;206;825;826;1;96;2.0
5;207;826;828;2;96;2.0
5;208;828;831;3;96;2.0
5;209;831;833;2;96;2.0
5;210;833;835;2;96;2.0
5;211;835;838;3;96;2.0
5;212;838;841;3;96;2.0
5;213;841;842;1;96;2.0
5;214;842;845;3;96;2.0
5;215;845;846;1;96;2.0
5;216;846;848;2;96;2.0
5;217;848;850;2;96;2.0
5;218;850;853;3;96;2.0
5;219;853;855;2;96;2.0
5;220;855;858;3;96;2.0
5;221;858;859;1;96;2.0
5;222;859;861;2;96;2.0
5;223;861;862;1;96;2.0
5;224;862;863;1;96;2.0
5;225;863;865;2;96;2.0
5;226;865;866;1;96;2.0
5;227;866;868;2;96;2.0
5;228;868;870;2;96;2.0
5;229;870;871;1;96;2.0
5;230;871;873;2;96;2.0
5;231;873;875;2;96;2.0
5;232;875;876;1;96;2.0
5;233;876;878;2;96;2.0
5;234;878;881;3;96;2.0
5;235;881;882;1;96;2.0
5;236;882;885;3;96;2.0
5;237;885;886;1;96;2.0
5;238;886;888;2;96;2.0
5;239;888;891;3;96;2.0
5;240;891;893;2;96;2.0
5;241;893;895;2;96;2.0
5;242;895;896;1;96;2.0
5;243;896;898;2;96;2.0
5;244;898;901;3;96;2.0
5;245;901;902;1;96;2.0
5;246;902;905;3;96;2.0
5;247;905;906;1;96;2.0
5;248;906;908;2;96;2.0
5;249;908;910;2;96;2.0
5;250;910;913;3;96;2.0
5;251;913;915;2;96;2.0
5;252;915;916;1;96;2.0
5;253;916;918;2;96;2.0
5;254;918;921;3;96;2.0
5;255;921;922;1;96;2.0
5;256;922;923;1;96;2.0
5;257;923;925;2;96;2.0
5;258;925;926;1;96;2.0
5;259;926;928;2;96;2.0
5;260;928;930;2;96;2.0
5;261;930;931;1;96;2.0
5;262;931;933;2;96;2.0
5;263;933;935;2;96;2.0
5;264;935;936;1;96;2.0
5;265;936;938;2;96;2.0
5;266;938;941;3;96;2.0
5;267;941;942;1;96;2.0
5;268;942;945;3;96;2.0
5;269;945;946;1;96;2.0
5;270;946;948;2;96;2.0
5;271;948;951;3;96;2.0
5;272;951;953;2;96;2.0
5;273;953;955;2;96;2.0
5;274;955;956;1;96;2.0
5;275;956;958;2;96;2.0
5;276;958;961;3;96;2.0
5;277;961;962;1;96;2.0
5;278;962;965;3;96;2.0
5;279;965;966;1;96;2.0
5;280;966;968;2;96;2.0
5;281;968;970;2;96;2.0
5;282;970;973;3;96;2.0
5;283;973;975;2;96;2.0
5;284;975;976;1;96;2.0
5;285;976;978;2;96;2.0
5;286;978;981;3;96;2.0
5;287;981;982;1;96;2.0
5;288;982;983;1;96;2.0
5;289;983;985;2;96;2.0
5;290;985;986;1;96;2.0
5;291;986;988;2;96;2.0
5;292;988;990;2;96;2.0
5;293;990;993;3;96;2.0
5;294;993;995;2;96;2.0
5;295;995;996;1;96;2.0
5;296;996;998;2;96;2.0
5;297;998;999;1;96;2.0
5;298;999;1001;2;96;2.0
5;299;1001;1002;1;96;2.0
5;300;1002;1005;3;96;2.0
5;301;1005;1006;1;96;2.0
5;302;1006;1008;2;96;2.0
5;303;1008;1011;3;96;2.0
5;304;1011;1013;2;96;2.0
5;305;1013;1015;2;96;2.0
5;306;1015;1021;6;96;2.0
5;307;1021;1022;1;96;2.0
5;308;1022;1023;1;96;2.0
5;309;1023;1026;3;96;2.0
5;310;1026;1028;2;96;2.0
5;311;1028;1030;2;96;2.0
5;312;1030;1033;3;96;2.0
5;313;1033;1036;3;96;2.0
5;314;1036;1038;2;96;2.0
5;315;1038;1041;3;96;2.0
5;316;1041;1042;1;96;2.0
5;317;1042;1045;3;96;2.0
5;318;1045;1048;3;96;2.0
5;319;1048;1050;2;96;2.0
5;320;1050;1051;1;96;2.0
5;321;1051;1053;2;96;2.0
5;322;1053;1060;7;96;2.0
5;323;1060;1061;1;96;2.0
5;324;1061;1062;1;96;2.0
5;325;1062;1066;4;96;2.0
5;326;1066;1068;2;96;2.0
5;327;1068;1070;2;96;2.0
5;328;1070;1071;1;96;2.0
5;329;1071;1073;2;96;2.0
5;330;1073;1075;2;96;2.0
5;331;1075;1081;6;96;2.0
5;332;1081;1082;1;96;2.0
5;333;1082;1083;1;96;2.0
5;334;1083;1088;5;96;2.0
5;335;1088;1090;2;96;2.0
5;336;1090;1093;3;96;2.0
5;337;1093;1096;3;96;2.0
5;338;1096;1098;2;96;2.0
5;339;1098;1101;3;96;2.0
5;340;1101;1105;4;96;2.0
5;341;1105;1109;4;96;2.0
5;342;1109;1110;1;96;2.0
5;343;1110;1111;1;96;2.0
5;344;1111;1113;2;96;2.0
5;345;1113;1116;3;96;2.0
5;346;1116;1117;1;96;2.0
5;347;1117;1121;4;96;2.0
5;348;1121;1123;2;96;2.0
5;349;1123;1125;2;96;2.0
5;350;1125;1127;2;96;2.0
5;351;1127;1132;5;96;2.0
5;352;1132;1135;3;96;2.0
5;353;1135;1139;4;96;2.0
5;354;1139;1140;1;96;2.0
5;355;1140;1141;1;96;2.0
5;356;1141;1143;2;96;2.0
5;357;1143;1145;2;96;2.0
5;358;1145;1147;2;96;2.0
5;359;1147;1154;7;96;2.0
5;360;1154;1155;1;96;2.0
5;361;1155;1161;6;96;2.0
5;362;1161;1162;1;96;2.0
5;363;1162;1163;1;96;2.0
5;364;1163;1170;7;96;2.0
5;365;1170;1174;4;96;2.0
5;366;1174;1175;1;96;2.0
5;367;1175;1179;4;96;2.0
5;368;1179;1180;1;96;2.0
5;369;1180;1181;1;96;2.0
5;370;1181;1182;1;96;2.0
5;371;1182;1183;1;96;2.0
5;372;1183;1187;4;96;2.0
5;373;1187;1195;8;96;2.0
5;374;1195;1197;2;96;2.0
5;375;1197;1202;5;96;2.0
5;376;1202;1203;1;96;2.0
5;377;1203;1205;2;96;2.0
5;378;1205;1206;1;96;2.0
5;379;1206;1209;3;96;2.0
5;380;1209;1215;6;96;2.0
5;381;1215;1226;11;96;2.0
5;382;1226;1227;1;96;2.0
5;383;1227;1228;1;96;2.0
5;384;1228;1229;1;96;2.0
5;385;1229;1232;3;96;2.0
5;386;1232;1234;2;96;2.0
5;387;1234;1235;1;96;2.0
5;388;1235;1240;5;96;2.0
5;389;1240;1251;11;96;2.0
5;390;1251;1252;1;96;2.0
5;391;1252;1253;1;96;2.0
5;392;1253;1254;1;96;2.0
5;393;1254;1260;6;96;2.0
5;394;1260;1267;7;96;2.0
5;395;1267;1272;5;96;2.0
5;396;1272;1275;3;96;2.0
5;397;1275;1276;1;96;2.0
5;398;1276;1277;1;96;2.0
5;399;1277;1278;1;96;2.0
5;400;1278;1284;6;96;2.0
5;401;1284;1285;1;96;2.0
5;402;1285;1302;17;96;2.0
5;403;1302;1303;1;96;2.0
5;404;1303;1309;6;96;2.0
5;405;1309;1310;1;96;2.0
5;406;1310;1312;2;96;2.0
5;407;1312;1322;10;96;2.0
5;408;1322;1331;9;96;2.0
5;409;1331;1333;2;96;2.0
5;410;1333;1334;1;96;2.0
5;411;1334;1335;1;96;2.0
5;412;1335;1342;7;96;2.0
5;413;1342;1345;3;96;2.0
5;414;1345;1347;2;96;2.0
5;415;1347;1353;6;96;2.0
5;416;1353;1361;8;96;2.0
5;417;1361;1363;2;96;2.0
5;418;1363;1368;5;96;2.0
5;419;1368;1380;12;96;2.0
5;420;1380;1386;6;96;2.0
5;421;1386;1401;15;96;2.0
5;422;1401;1416;15;96;2.0
5;423;1416;1431;15;96;2.0
5;424;1431;1446;15;96;2.0
5;425;1446;1461;15;96;2.0
5;426;1461;1476;15;96;2.0
5;427;1476;1491;15;96;2.0
5;428;1491;1506;15;96;2.0
5;429;1506;1521;15;96;2.0
5;430;1521;1536;15;96;2.0
5;431;1536;1551;15;96;2.0
5;432;1551;1566;15;96;2.0
5;433;1566;1581;15;96;2.0
5;434;1581;1596;15;96;2.0
5;435;1596;1611;15;96;2.0
5;436;1611;1626;15;96;2.0
5;437;1626;1641;15;96;2.0
5;438;1641;1656;15;96;2.0
5;439;1656;1671;15;96;2.0
5;440;1671;1680;9;96;2.0
6;0;252;334;82;160;2.0
6;1;334;338;4;160;2.0
6;2;338;340;2;160;2.0
6;3;340;345;5;160;2.0
6;4;345;346;1;160;2.0
6;5;346;347;1;160;2.0
6;6;347;348;1;160;2.0
6;7;348;350;2;160;2.0
6;8;350;351;1;160;2.0
6;9;351;353;2;160;2.0
6;10;353;355;2;160;2.0
6;11;355;358;3;160;2.0
6;12;358;361;3;160;2.0
6;13;361;362;1;160;2.0
6;14;362;364;2;160;2.0
6;15;364;368;4;160;2.0
6;16;368;370;2;160;2.0
6;17;370;375;5;160;2.0
6;18;375;381;6;160;2.0
6;19;381;382;1;160;2.0
6;20;382;383;1;160;2.0
6;21;383;384;1;160;2.0
6;22;384;385;1;160;2.0
6;23;385;387;2;160;2.0
6;24;387;392;5;160;2.0
6;25;392;395;3;160;2.0
6;26;395;397;2;160;2.0
6;27;397;398;1;160;2.0
6;28;398;400;2;160;2.0
6;29;400;401;1;160;2.0
6;30;401;402;1;160;2.0
6;31;402;405;3;160;2.0
6;32;405;407;2;160;2.0
6;33;407;412;5;160;2.0
6;34;412;414;2;160;2.0
6;35;414;415;1;160;2.0
6;36;415;417;2;160;2.0
6;37;417;418;1;160;2.0
6;38;418;421;3;160;2.0
6;39;421;422;1;160;2.0
6;40;422;424;2;160;2.0
6;41;424;425;1;160;2.0
6;42;425;427;2;160;2.0
6;43;427;428;1;160;2.0
6;44;428;432;4;160;2.0
6;45;432;434;2;160;2.0
6;46;434;435;1;160;2.0
6;47;435;437;2;160;2.0
6;48;437;441;4;160;2.0
6;49;441;442;1;160;2.0
6;50;442;445;3;160;2.0
6;51;445;447;2;160;2.0
6;52;447;448;1;160;2.0
6;53;448;452;4;160;2.0
6;54;452;455;3;160;2.0
6;55;455;457;2;160;2.0
6;56;457;458;1;160;2.0
6;57;458;460;2;160;2.0
6;58;460;461;1;160;2.0
6;59;461;462;1;160;2.0
6;60;462;463;1;160;2.0
6;61;463;464;1;160;2.0
6;62;464;465;1;160;2.0
6;63;465;467;2;160;2.0
6;64;467;472;5;160;2.0
6;65;472;474;2;160;2.0
6;66;474;475;1;160;2.0
6;67;475;477;2;160;2.0
6;68;477;478;1;160;2.0
6;69;478;481;3;160;2.0
6;70;481;482;1;160;2.0
6;71;482;484;2;160;2.0
6;72;484;485;1;160;2.0
6;73;485;487;2;160;2.0
6;74;487;488;1;160;2.0
6;75;488;492;4;160;2.0
6;76;492;495;3;160;2.0
6;77;495;497;2;160;2.0
6;78;497;498;1;160;2.0
6;79;498;501;3;160;2.0
6;80;501;504;3;160;2.0
6;81;504;505;1;160;2.0
6;82;505;512;7;160;2.0
6;83;512;515;3;160;2.0
6;84;515;518;3;160;2.0
6;85;518;521;3;160;2.0
6;86;521;523;2;160;2.0
6;87;523;524;1;160;2.0
6;88;524;525;1;160;2.0
6;89;525;529;4;160;2.0
6;90;529;532;3;160;2.0
6;91;532;535;3;160;2.0
6;92;535;537;2;160;2.0
6;93;537;541;4;160;2.0
6;94;541;542;1;160;2.0
6;95;542;543;1;160;2.0
6;96;543;545;2;160;2.0
6;97;545;547;2;160;2.0
6;98;547;552;5;160;2.0
6;99;552;555;3;160;2.0
6;100;555;561;6;160;2.0
6;101;561;563;2;160;2.0
6;102;563;564;1;160;2.0
6;103;564;565;1;160;2.0
6;104;565;567;2;160;2.0
6;105;567;572;5;160;2.0
6;106;572;575;3;160;2.0
6;107;575;577;2;160;2.0
6;108;577;578;1;160;2.0
6;109;578;581;3;160;2.0
6;110;581;583;2;160;2.0
6;111;583;585;2;160;2.0
6;112;585;587;2;160;2.0
6;113;587;592;5;160;2.0
6;114;592;595;3;160;2.0
6;115;595;601;6;160;2.0
6;116;601;602;1;160;2.0
6;117;602;603;1;160;2.0
6;118;603;604;1;160;2.0
6;119;604;605;1;160;2.0
6;120;605;607;2;160;2.0
6;121;607;612;5;160;2.0
6;122;612;615;3;160;2.0
6;123;615;617;2;160;2.0
6;124;617;621;4;160;2.0
6;125;621;623;2;160;2.0
6;126;623;625;2;160;2.0
6;127;625;627;2;160;2.0
6;128;627;632;5;160;2.0
6;129;632;635;3;160;2.0
6;130;635;637;2;160;2.0
6;131;637;638;1;160;2.0
6;132;638;641;3;160;2.0
6;133;641;643;2;160;2.0
6;134;643;645;2;160;2.0
6;135;645;647;2;160;2.0
6;136;647;652;5;160;2.0
6;137;652;655;3;160;2.0
6;138;655;661;6;160;2.0
6;139;661;662;1;160;2.0
6;140;662;663;1;160;2.0
6;141;663;664;1;160;2.0
6;142;664;665;1;160;2.0
6;143;665;667;2;160;2.0
6;144;667;672;5;160;2.0
6;145;672;675;3;160;2.0
6;146;675;677;2;160;2.0
6;147;677;681;4;160;2.0
6;148;681;683;2;160;2.0
6;149;683;685;2;160;2.0
6;150;685;687;2;160;2.0
6;151;687;692;5;160;2.0
6;152;692;695;3;160;2.0
6;153;695;697;2;160;2.0
6;154;697;698;1;160;2.0
6;155;698;701;3;160;2.0
6;156;701;703;2;160;2.0
6;157;703;705;2;160;2.0
6;158;705;707;2;160;2.0
6;159;707;712;5;160;2.0
6;160;712;715;3;160;2.0
6;161;715;721;6;160;2.0
6;162;721;722;1;160;2.0
6;163;722;723;1;160;2.0
6;164;723;724;1;160;2.0
6;165;724;725;1;160;2.0
6;166;725;727;2;160;2.0
6;167;727;732;5;160;2.0
6;168;732;735;3;160;2.0
6;169;735;737;2;160;2.0
6;170;737;741;4;160;2.0
6;171;741;743;2;160;2.0
6;172;743;745;2;160;2.0
6;173;745;747;2;160;2.0
6;174;747;752;5;160;2.0
6;175;752;755;3;160;2.0
6;176;755;757;2;160;2.0
6;177;757;758;1;160;2.0
6;178;758;761;3;160;2.0
6;179;761;763;2;160;2.0
6;180;763;765;2;160;2.0
6;181;765;767;2;160;2.0
6;182;767;772;5;160;2.0
6;183;772;775;3;160;2.0
6;184;775;781;6;160;2.0
6;185;781;782;1;160;2.0
6;186;782;783;1;160;2.0
6;187;783;784;1;160;2.0
6;188;784;785;1;160;2.0
6;189;785;787;2;160;2.0
6;190;787;792;5;160;2.0
6;191;792;795;3;160;2.0
6;192;795;797;2;160;2.0
6;193;797;801;4;160;2.0
6;194;801;802;1;160;2.0
6;195;802;803;1;160;2.0
6;196;803;805;2;160;2.0
6;197;805;807;2;160;2.0
6;198;807;812;5;160;2.0
6;199;812;815;3;160;2.0
6;200;815;818;3;160;2.0
6;201;818;821;3;160;2.0
6;202;821;822;1;160;2.0
6;203;822;823;1;160;2.0
6;204;823;824;1;160;2.0
6;205;824;825;1;160;2.0
6;206;825;827;2;160;2.0
6;207;827;832;5;160;2.0
6;208;832;835;3;160;2.0
6;209;835;841;6;160;2.0
6;210;841;842;1;160;2.0
6;211;842;843;1;160;2.0
6;212;843;844;1;160;2.0
6;213;844;845;1;160;2.0
6;214;845;847;2;160;2.0
6;215;847;852;5;160;2.0
6;216;852;855;3;160;2.0
6;217;855;857;2;160;2.0
6;218;857;861;4;160;2.0
6;219;861;862;1;160;2.0
6;220;862;863;1;160;2.0
6;221;863;865;2;160;2.0
6;222;865;867;2;160;2.0
6;223;867;872;5;160;2.0
6;224;872;875;3;160;2.0
6;225;875;877;2;160;2.0
6;226;877;878;1;160;2.0
6;227;878;881;3;160;2.0
6;228;881;882;1;160;2.0
6;229;882;883;1;160;2.0
6;230;883;885;2;160;2.0
6;231;885;887;2;160;2.0
6;232;887;892;5;160;2.0
6;233;892;893;1;160;2.0
6;234;893;895;2;160;2.0
6;235;895;897;2;160;2.0
6;236;897;901;4;160;2.0
6;237;901;902;1;160;2.0
6;238;902;903;1;160;2.0
6;239;903;904;1;160;2.0
6;240;904;905;1;160;2.0
6;241;905;907;2;160;2.0
6;242;907;912;5;160;2.0
6;243;912;915;3;160;2.0
6;244;915;917;2;160;2.0
6;245;917;918;1;160;2.0
6;246;918;921;3;160;2.0
6;247;921;922;1;160;2.0
6;248;922;923;1;160;2.0
6;249;923;925;2;160;2.0
6;250;925;927;2;160;2.0
6;251;927;932;5;160;2.0
6;252;932;935;3;160;2.0
6;253;935;937;2;160;2.0
6;254;937;938;1;160;2.0
6;255;938;941;3;160;2.0
6;256;941;942;1;160;2.0
6;257;942;943;1;160;2.0
6;258;943;945;2;160;2.0
6;259;945;947;2;160;2.0
6;260;947;952;5;160;2.0
6;261;952;953;1;160;2.0
6;262;953;955;2;160;2.0
6;263;955;957;2;160;2.0
6;264;957;961;4;160;2.0
6;265;961;962;1;160;2.0
6;266;962;963;1;160;2.0
6;267;963;964;1;160;2.0
6;268;964;965;1;160;2.0
6;269;965;967;2;160;2.0
6;270;967;972;5;160;2.0
6;271;972;975;3;160;2.0
6;272;975;977;2;160;2.0
6;273;977;978;1;160;2.0
6;274;978;981;3;160;2.0
6;275;981;982;1;160;2.0
6;276;982;983;1;160;2.0
6;277;983;985;2;160;2.0
6;278;985;987;2;160;2.0
6;279;987;992;5;160;2.0
6;280;992;995;3;160;2.0
6;281;995;997;2;160;2.0
6;282;997;1001;4;160;2.0
6;283;1001;1002;1;160;2.0
6;284;1002;1003;1;160;2.0
6;285;1003;1005;2;160;2.0
6;286;1005;1007;2;160;2.0
6;287;1007;1012;5;160;2.0
6;288;1012;1013;1;160;2.0
6;289;1013;1015;2;160;2.0
6;290;1015;1017;2;160;2.0
6;291;1017;1020;3;160;2.0
6;292;1020;1021;1;160;2.0
6;293;1021;1022;1;160;2.0
6;294;1022;1023;1;160;2.0
6;295;1023;1024;1;160;2.0
6;296;1024;1032;8;160;2.0
6;297;1032;1035;3;160;2.0
6;298;1035;1037;2;160;2.0
6;299;1037;1041;4;160;2.0
6;300;1041;1043;2;160;2.0
6;301;1043;1047;4;160;2.0
6;302;1047;1050;3;160;2.0
6;303;1050;1052;2;160;2.0
6;304;1052;1053;1;160;2.0
6;305;1053;1055;2;160;2.0
6;306;1055;1057;2;160;2.0
6;307;1057;1061;4;160;2.0
6;308;1061;1062;1;160;2.0
6;309;1062;1063;1;160;2.0
6;310;1063;1065;2;160;2.0
6;311;1065;1067;2;160;2.0
6;312;1067;1073;6;160;2.0
6;313;1073;1075;2;160;2.0
6;314;1075;1077;2;160;2.0
6;315;1077;1080;3;160;2.0
6;316;1080;1081;1;160;2.0
6;317;1081;1082;1;160;2.0
6;318;1082;1083;1;160;2.0
6;319;1083;1084;1;160;2.0
6;320;1084;1092;8;160;2.0
6;321;1092;1095;3;160;2.0
6;322;1095;1097;2;160;2.0
6;323;1097;1103;6;160;2.0
6;324;1103;1107;4;160;2.0
6;325;1107;1109;2;160;2.0
6;326;1109;1110;1;160;2.0
6;327;1110;1112;2;160;2.0
6;328;1112;1115;3;160;2.0
6;329;1115;1116;1;160;2.0
6;330;1116;1117;1;160;2.0
6;331;1117;1118;1;160;2.0
6;332;1118;1122;4;160;2.0
6;333;1122;1123;1;160;2.0
6;334;1123;1124;1;160;2.0
6;335;1124;1134;10;160;2.0
6;336;1134;1138;4;160;2.0
6;337;1138;1139;1;160;2.0
6;338;1139;1142;3;160;2.0
6;339;1142;1143;1;160;2.0
6;340;1143;1148;5;160;2.0
6;341;1148;1149;1;160;2.0
6;342;1149;1152;3;160;2.0
6;343;1152;1154;2;160;2.0
6;344;1154;1161;7;160;2.0
6;345;1161;1162;1;160;2.0
6;346;1162;1163;1;160;2.0
6;347;1163;1164;1;160;2.0
6;348;1164;1169;5;160;2.0
6;349;1169;1176;7;160;2.0
6;350;1176;1177;1;160;2.0
6;351;1177;1179;2;160;2.0
6;352;1179;1182;3;160;2.0
6;353;1182;1183;1;160;2.0
6;354;1183;1184;1;160;2.0
6;355;1184;1186;2;160;2.0
6;356;1186;1189;3;160;2.0
6;357;1189;1198;9;160;2.0
6;358;1198;1202;4;160;2.0
6;359;1202;1204;2;160;2.0
6;360;1204;1208;4;160;2.0
6;361;1208;1209;1;160;2.0
6;362;1209;1218;9;160;2.0
6;363;1218;1224;6;160;2.0
6;364;1224;1227;3;160;2.0
6;365;1227;1228;1;160;2.0
6;366;1228;1234;6;160;2.0
6;367;1234;1236;2;160;2.0
6;368;1236;1239;3;160;2.0
6;369;1239;1244;5;160;2.0
6;370;1244;1252;8;160;2.0
6;371;1252;1253;1;160;2.0
6;372;1253;1259;6;160;2.0
6;373;1259;1261;2;160;2.0
6;374;1261;1269;8;160;2.0
6;375;1269;1274;5;160;2.0
6;376;1274;1277;3;160;2.0
6;377;1277;1278;1;160;2.0
6;378;1278;1279;1;160;2.0
6;379;1279;1284;5;160;2.0
6;380;1284;1293;9;160;2.0
6;381;1293;1294;1;160;2.0
6;382;1294;1302;8;160;2.0
6;383;1302;1305;3;160;2.0
6;384;1305;1309;4;160;2.0
6;385;1309;1311;2;160;2.0
6;386;1311;1318;7;160;2.0
6;387;1318;1319;1;160;2.0
6;388;1319;1329;10;160;2.0
6;389;1329;1332;3;160;2.0
6;390;1332;1333;1;160;2.0
6;391;1333;1343;10;160;2.0
6;392;1343;1344;1;160;2.0
6;393;1344;1349;5;160;2.0
6;394;1349;1352;3;160;2.0
6;395;1352;1354;2;160;2.0
6;396;1354;1363;9;160;2.0
6;397;1363;1367;4;160;2.0
6;398;1367;1370;3;160;2.0
6;399;1370;1372;2;160;2.0
6;400;1372;1388;16;160;2.0
6;401;1388;1389;1;160;2.0
6;402;1389;1404;15;160;2.0
6;403;1404;1419;15;160;2.0
6;404;1419;1434;15;160;2.0
6;405;1434;1449;15;160;2.0
6;406;1449;1464;15;160;2.0
6;407;1464;1479;15;160;2.0
6;408;1479;1494;15;160;2.0
6;409;1494;1509;15;160;2.0
6;410;1509;1524;15;160;2.0
6;411;1524;1539;15;160;2.0
6;412;1539;1554;15;160;2.0
6;413;1554;1569;15;160;2.0
6;414;1569;1584;15;160;2.0
6;415;1584;1599;15;160;2.0
6;416;1599;1614;15;160;2.0
6;417;1614;1629;15;160;2.0
6;418;1629;1644;15;160;2.0
6;419;1644;1659;15;160;2.0
6;420;1659;1680;21;160;2.0
7;0;250;334;84;1;2.0
7;1;334;338;4;1;2.0
7;2;338;341;3;1;2.0
7;3;341;342;1;1;2.0
7;4;342;344;2;1;2.0
7;5;344;346;2;1;2.0
7;6;346;347;1;1;2.0
7;7;347;353;6;1;2.0
7;8;353;354;1;1;2.0
7;9;354;355;1;1;2.0
7;10;355;357;2;1;2.0
7;11;357;360;3;1;2.0
7;12;360;361;1;1;2.0
7;13;361;362;1;1;2.0
7;14;362;364;2;1;2.0
7;15;364;368;4;1;2.0
7;16;368;371;3;1;2.0
7;17;371;372;1;1;2.0
7;18;372;375;3;1;2.0
7;19;375;379;4;1;2.0
7;20;379;382;3;1;2.0
7;21;382;383;1;1;2.0
7;22;383;384;1;1;2.0
7;23;384;387;3;1;2.0
7;24;387;390;3;1;2.0
7;25;390;392;2;1;2.0
7;26;392;394;2;1;2.0
7;27;394;395;1;1;2.0
7;28;395;396;1;1;2.0
7;29;396;397;1;1;2.0
7;30;397;402;5;1;2.0
7;31;402;403;1;1;2.0
7;32;403;407;4;1;2.0
7;33;407;411;4;1;2.0
7;34;411;412;1;1;2.0
7;35;412;414;2;1;2.0
7;36;414;415;1;1;2.0
7;37;415;417;2;1;2.0
7;38;417;420;3;1;2.0
7;39;420;421;1;1;2.0
7;40;421;422;1;1;2.0
7;41;422;423;1;1;2.0
7;42;423;424;1;1;2.0
7;43;424;427;3;1;2.0
7;44;427;431;4;1;2.0
7;45;431;432;1;1;2.0
7;46;432;434;2;1;2.0
7;47;434;435;1;1;2.0
7;48;435;437;2;1;2.0
7;49;437;441;4;1;2.0
7;50;441;442;1;1;2.0
7;51;442;443;1;1;2.0
7;52;443;444;1;1;2.0
7;53;444;447;3;1;2.0
7;54;447;450;3;1;2.0
7;55;450;452;2;1;2.0
7;56;452;454;2;1;2.0
7;57;454;455;1;1;2.0
7;58;455;456;1;1;2.0
7;59;456;457;1;1;2.0
7;60;457;459;2;1;2.0
7;61;459;462;3;1;2.0
7;62;462;463;1;1;2.0
7;63;463;464;1;1;2.0
7;64;464;467;3;1;2.0
7;65;467;471;4;1;2.0
7;66;471;472;1;1;2.0
7;67;472;474;2;1;2.0
7;68;474;475;1;1;2.0
7;69;475;477;2;1;2.0
7;70;477;480;3;1;2.0
7;71;480;481;1;1;2.0
7;72;481;482;1;1;2.0
7;73;482;483;1;1;2.0
7;74;483;484;1;1;2.0
7;75;484;487;3;1;2.0
7;76;487;491;4;1;2.0
7;77;491;492;1;1;2.0
7;78;492;493;1;1;2.0
7;79;493;494;1;1;2.0
7;80;494;495;1;1;2.0
7;81;495;497;2;1;2.0
7;82;497;501;4;1;2.0
7;83;501;503;2;1;2.0
7;84;503;504;1;1;2.0
7;85;504;507;3;1;2.0
7;86;507;512;5;1;2.0
7;87;512;514;2;1;2.0
7;88;514;515;1;1;2.0
7;89;515;517;2;1;2.0
7;90;517;519;2;1;2.0
7;91;519;523;4;1;2.0
7;92;523;524;1;1;2.0
7;93;524;527;3;1;2.0
7;94;527;529;2;1;2.0
7;95;529;532;3;1;2.0
7;96;532;535;3;1;2.0
7;97;535;539;4;1;2.0
7;98;539;540;1;1;2.0
7;99;540;543;3;1;2.0
7;100;543;547;4;1;2.0
7;101;547;552;5;1;2.0
7;102;552;555;3;1;2.0
7;103;555;559;4;1;2.0
7;104;559;561;2;1;2.0
7;105;561;563;2;1;2.0
7;106;563;564;1;1;2.0
7;107;564;567;3;1;2.0
7;108;567;572;5;1;2.0
7;109;572;574;2;1;2.0
7;110;574;575;1;1;2.0
7;111;575;579;4;1;2.0
7;112;579;583;4;1;2.0
7;113;583;587;4;1;2.0
7;114;587;592;5;1;2.0
7;115;592;595;3;1;2.0
7;116;595;599;4;1;2.0
7;117;599;600;1;1;2.0
7;118;600;603;3;1;2.0
7;119;603;604;1;1;2.0
7;120;604;607;3;1;2.0
7;121;607;612;5;1;2.0
7;122;612;615;3;1;2.0
7;123;615;619;4;1;2.0
7;124;619;621;2;1;2.0
7;125;621;623;2;1;2.0
7;126;623;627;4;1;2.0
7;127;627;632;5;1;2.0
7;128;632;634;2;1;2.0
7;129;634;635;1;1;2.0
7;130;635;639;4;1;2.0
7;131;639;643;4;1;2.0
7;132;643;647;4;1;2.0
7;133;647;652;5;1;2.0
7;134;652;655;3;1;2.0
7;135;655;659;4;1;2.0
7;136;659;660;1;1;2.0
7;137;660;663;3;1;2.0
7;138;663;664;1;1;2.0
7;139;664;667;3;1;2.0
7;140;667;672;5;1;2.0
7;141;672;675;3;1;2.0
7;142;675;679;4;1;2.0
7;143;679;683;4;1;2.0
7;144;683;687;4;1;2.0
7;145;687;692;5;1;2.0
7;146;692;694;2;1;2.0
7;147;694;695;1;1;2.0
7;148;695;699;4;1;2.0
7;149;699;703;4;1;2.0
7;150;703;707;4;1;2.0
7;151;707;712;5;1;2.0
7;152;712;715;3;1;2.0
7;153;715;719;4;1;2.0
7;154;719;720;1;1;2.0
7;155;720;723;3;1;2.0
7;156;723;724;1;1;2.0
7;157;724;727;3;1;2.0
7;158;727;732;5;1;2.0
7;159;732;735;3;1;2.0
7;160;735;739;4;1;2.0
7;161;739;743;4;1;2.0
7;162;743;747;4;1;2.0
7;163;747;752;5;1;2.0
7;164;752;754;2;1;2.0
7;165;754;755;1;1;2.0
7;166;755;759;4;1;2.0
7;167;759;763;4;1;2.0
7;168;763;767;4;1;2.0
7;169;767;772;5;1;2.0
7;170;772;775;3;1;2.0
7;171;775;779;4;1;2.0
7;172;779;780;1;1;2.0
7;173;780;783;3;1;2.0
7;174;783;784;1;1;2.0
7;175;784;787;3;1;2.0
7;176;787;792;5;1;2.0
7;177;792;795;3;1;2.0
7;178;795;799;4;1;2.0
7;179;799;801;2;1;2.0
7;180;801;802;1;1;2.0
7;181;802;803;1;1;2.0
7;182;803;807;4;1;2.0
7;183;807;812;5;1;2.0
7;184;812;814;2;1;2.0
7;185;814;815;1;1;2.0
7;186;815;819;4;1;2.0
7;187;819;820;1;1;2.0
7;188;820;822;2;1;2.0
7;189;822;823;1;1;2.0
7;190;823;824;1;1;2.0
7;191;824;827;3;1;2.0
7;192;827;831;4;1;2.0
7;193;831;832;1;1;2.0
7;194;832;835;3;1;2.0
7;195;835;839;4;1;2.0
7;196;839;840;1;1;2.0
7;197;840;842;2;1;2.0
7;198;842;843;1;1;2.0
7;199;843;844;1;1;2.0
7;200;844;847;3;1;2.0
7;201;847;851;4;1;2.0
7;202;851;852;1;1;2.0
7;203;852;855;3;1;2.0
7;204;855;857;2;1;2.0
7;205;857;859;2;1;2.0
7;206;859;861;2;1;2.0
7;207;861;862;1;1;2.0
7;208;862;863;1;1;2.0
7;209;863;867;4;1;2.0
7;210;867;871;4;1;2.0
7;211;871;872;1;1;2.0
7;212;872;874;2;1;2.0
7;213;874;875;1;1;2.0
7;214;875;877;2;1;2.0
7;215;877;879;2;1;2.0
7;216;879;880;1;1;2.0
7;217;880;882;2;1;2.0
7;218;882;883;1;1;2.0
7;219;883;887;4;1;2.0
7;220;887;889;2;1;2.0
7;221;889;891;2;1;2.0
7;222;891;892;1;1;2.0
7;223;892;895;3;1;2.0
7;224;895;897;2;1;2.0
7;225;897;899;2;1;2.0
7;226;899;900;1;1;2.0
7;227;900;902;2;1;2.0
7;228;902;903;1;1;2.0
7;229;903;904;1;1;2.0
7;230;904;907;3;1;2.0
7;231;907;911;4;1;2.0
7;232;911;912;1;1;2.0
7;233;912;914;2;1;2.0
7;234;914;915;1;1;2.0
7;235;915;917;2;1;2.0
7;236;917;919;2;1;2.0
7;237;919;921;2;1;2.0
7;238;921;922;1;1;2.0
7;239;922;923;1;1;2.0
7;240;923;927;4;1;2.0
7;241;927;931;4;1;2.0
7;242;931;932;1;1;2.0
7;243;932;934;2;1;2.0
7;244;934;935;1;1;2.0
7;245;935;937;2;1;2.0
7;246;937;939;2;1;2.0
7;247;939;940;1;1;2.0
7;248;940;942;2;1;2.0
7;249;942;943;1;1;2.0
7;250;943;947;4;1;2.0
7;251;947;949;2;1;2.0
7;252;949;951;2;1;2.0
7;253;951;952;1;1;2.0
7;254;952;955;3;1;2.0
7;255;955;957;2;1;2.0
7;256;957;959;2;1;2.0
7;257;959;960;1;1;2.0
7;258;960;962;2;1;2.0
7;259;962;963;1;1;2.0
7;260;963;964;1;1;2.0
7;261;964;967;3;1;2.0
7;262;967;971;4;1;2.0
7;263;971;972;1;1;2.0
7;264;972;974;2;1;2.0
7;265;974;975;1;1;2.0
7;266;975;977;2;1;2.0
7;267;977;979;2;1;2.0
7;268;979;981;2;1;2.0
7;269;981;982;1;1;2.0
7;270;982;983;1;1;2.0
7;271;983;987;4;1;2.0
7;272;987;991;4;1;2.0
7;273;991;992;1;1;2.0
7;274;992;995;3;1;2.0
7;275;995;997;2;1;2.0
7;276;997;999;2;1;2.0
7;277;999;1002;3;1;2.0
7;278;1002;1003;1;1;2.0
7;279;1003;1007;4;1;2.0
7;280;1007;1009;2;1;2.0
7;281;1009;1011;2;1;2.0
7;282;1011;1012;1;1;2.0
7;283;1012;1015;3;1;2.0
7;284;1015;1017;2;1;2.0
7;285;1017;1019;2;1;2.0
7;286;1019;1022;3;1;2.0
7;287;1022;1023;1;1;2.0
7;288;1023;1024;1;1;2.0
7;289;1024;1031;7;1;2.0
7;290;1031;1032;1;1;2.0
7;291;1032;1035;3;1;2.0
7;292;1035;1037;2;1;2.0
7;293;1037;1039;2;1;2.0
7;294;1039;1043;4;1;2.0
7;295;1043;1047;4;1;2.0
7;296;1047;1049;2;1;2.0
7;297;1049;1051;2;1;2.0
7;298;1051;1052;1;1;2.0
7;299;1052;1055;3;1;2.0
7;300;1055;1059;4;1;2.0
7;301;1059;1062;3;1;2.0
7;302;1062;1063;1;1;2.0
7;303;1063;1067;4;1;2.0
7;304;1067;1069;2;1;2.0
7;305;1069;1071;2;1;2.0
7;306;1071;1075;4;1;2.0
7;307;1075;1077;2;1;2.0
7;308;1077;1079;2;1;2.0
7;309;1079;1082;3;1;2.0
7;310;1082;1083;1;1;2.0
7;311;1083;1084;1;1;2.0
7;312;1084;1091;7;1;2.0
7;313;1091;1092;1;1;2.0
7;314;1092;1095;3;1;2.0
7;315;1095;1097;2;1;2.0
7;316;1097;1099;2;1;2.0
7;317;1099;1107;8;1;2.0
7;318;1107;1111;4;1;2.0
7;319;1111;1112;1;1;2.0
7;320;1112;1114;2;1;2.0
7;321;1114;1117;3;1;2.0
7;322;1117;1119;2;1;2.0
7;323;1119;1122;3;1;2.0
7;324;1122;1124;2;1;2.0
7;325;1124;1130;6;1;2.0
7;326;1130;1134;4;1;2.0
7;327;1134;1136;2;1;2.0
7;328;1136;1139;3;1;2.0
7;329;1139;1144;5;1;2.0
7;330;1144;1148;4;1;2.0
7;331;1148;1149;1;1;2.0
7;332;1149;1152;3;1;2.0
7;333;1152;1154;2;1;2.0
7;334;1154;1156;2;1;2.0
7;335;1156;1159;3;1;2.0
7;336;1159;1164;5;1;2.0
7;337;1164;1169;5;1;2.0
7;338;1169;1172;3;1;2.0
7;339;1172;1177;5;1;2.0
7;340;1177;1179;2;1;2.0
7;341;1179;1181;2;1;2.0
7;342;1181;1184;3;1;2.0
7;343;1184;1189;5;1;2.0
7;344;1189;1196;7;1;2.0
7;345;1196;1204;8;1;2.0
7;346;1204;1206;2;1;2.0
7;347;1206;1209;3;1;2.0
7;348;1209;1218;9;1;2.0
7;349;1218;1224;6;1;2.0
7;350;1224;1229;5;1;2.0
7;351;1229;1232;3;1;2.0
7;352;1232;1234;2;1;2.0
7;353;1234;1239;5;1;2.0
7;354;1239;1241;2;1;2.0
7;355;1241;1244;3;1;2.0
7;356;1244;1249;5;1;2.0
7;357;1249;1254;5;1;2.0
7;358;1254;1259;5;1;2.0
7;359;1259;1269;10;1;2.0
7;360;1269;1274;5;1;2.0
7;361;1274;1276;2;1;2.0
7;362;1276;1279;3;1;2.0
7;363;1279;1284;5;1;2.0
7;364;1284;1293;9;1;2.0
7;365;1293;1294;1;1;2.0
7;366;1294;1301;7;1;2.0
7;367;1301;1304;3;1;2.0
7;368;1304;1307;3;1;2.0
7;369;1307;1309;2;1;2.0
7;370;1309;1311;2;1;2.0
7;371;1311;1318;7;1;2.0
7;372;1318;1319;1;1;2.0
7;373;1319;1329;10;1;2.0
7;374;1329;1334;5;1;2.0
7;375;1334;1343;9;1;2.0
7;376;1343;1344;1;1;2.0
7;377;1344;1349;5;1;2.0
7;378;1349;1350;1;1;2.0
7;379;1350;1354;4;1;2.0
7;380;1354;1359;5;1;2.0
7;381;1359;1369;10;1;2.0
7;382;1369;1370;1;1;2.0
7;383;1370;1372;2;1;2.0
7;384;1372;1384;12;1;2.0
7;385;1384;1389;5;1;2.0
7;386;1389;1404;15;1;2.0
7;387;1404;1419;15;1;2.0
7;388;1419;1434;15;1;2.0
7;389;1434;1449;15;1;2.0
7;390;1449;1464;15;1;2.0
7;391;1464;1479;15;1;2.0
7;392;1479;1494;15;1;2.0
7;393;1494;1509;15;1;2.0
7;394;1509;1524;15;1;2.0
7;395;1524;1539;15;1;2.0
7;396;1539;1554;15;1;2.0
7;397;1554;1569;15;1;2.0
7;398;1569;1584;15;1;2.0
7;399;1584;1599;15;1;2.0
7;400;1599;1614;15;1;2.0
7;401;1614;1629;15;1;2.0
7;402;1629;1644;15;1;2.0
7;403;1644;1659;15;1;2.0
7;404;1659;1680;21;1;2.0
8;0;250;335;85;43;2.0
8;1;335;341;6;43;2.0
8;2;341;345;4;43;2.0
8;3;345;347;2;43;2.0
8;4;347;348;1;43;2.0
8;5;348;350;2;43;2.0
8;6;350;356;6;43;2.0
8;7;356;358;2;43;2.0
8;8;358;361;3;43;2.0
8;9;361;362;1;43;2.0
8;10;362;363;1;43;2.0
8;11;363;364;1;43;2.0
8;12;364;365;1;43;2.0
8;13;365;368;3;43;2.0
8;14;368;371;3;43;2.0
8;15;371;375;4;43;2.0
8;16;375;376;1;43;2.0
8;17;376;377;1;43;2.0
8;18;377;378;1;43;2.0
8;19;378;383;5;43;2.0
8;20;383;385;2;43;2.0
8;21;385;388;3;43;2.0
8;22;388;391;3;43;2.0
8;23;391;392;1;43;2.0
8;24;392;395;3;43;2.0
8;25;395;398;3;43;2.0
8;26;398;400;2;43;2.0
8;27;400;402;2;43;2.0
8;28;402;405;3;43;2.0
8;29;405;408;3;43;2.0
8;30;408;412;4;43;2.0
8;31;412;415;3;43;2.0
8;32;415;418;3;43;2.0
8;33;418;421;3;43;2.0
8;34;421;422;1;43;2.0
8;35;422;423;1;43;2.0
8;36;423;425;2;43;2.0
8;37;425;428;3;43;2.0
8;38;428;432;4;43;2.0
8;39;432;435;3;43;2.0
8;40;435;438;3;43;2.0
8;41;438;442;4;43;2.0
8;42;442;445;3;43;2.0
8;43;445;448;3;43;2.0
8;44;448;451;3;43;2.0
8;45;451;452;1;43;2.0
8;46;452;455;3;43;2.0
8;47;455;458;3;43;2.0
8;48;458;460;2;43;2.0
8;49;460;462;2;43;2.0
8;50;462;463;1;43;2.0
8;51;463;465;2;43;2.0
8;52;465;468;3;43;2.0
8;53;468;472;4;43;2.0
8;54;472;475;3;43;2.0
8;55;475;478;3;43;2.0
8;56;478;481;3;43;2.0
8;57;481;482;1;43;2.0
8;58;482;483;1;43;2.0
8;59;483;485;2;43;2.0
8;60;485;488;3;43;2.0
8;61;488;492;4;43;2.0
8;62;492;494;2;43;2.0
8;63;494;495;1;43;2.0
8;64;495;498;3;43;2.0
8;65;498;502;4;43;2.0
8;66;502;505;3;43;2.0
8;67;505;508;3;43;2.0
8;68;508;512;4;43;2.0
8;69;512;513;1;43;2.0
8;70;513;515;2;43;2.0
8;71;515;518;3;43;2.0
8;72;518;522;4;43;2.0
8;73;522;523;1;43;2.0
8;74;523;525;2;43;2.0
8;75;525;528;3;43;2.0
8;76;528;530;2;43;2.0
8;77;530;532;2;43;2.0
8;78;532;535;3;43;2.0
8;79;535;538;3;43;2.0
8;80;538;541;3;43;2.0
8;81;541;543;2;43;2.0
8;82;543;548;5;43;2.0
8;83;548;552;4;43;2.0
8;84;552;555;3;43;2.0
8;85;555;558;3;43;2.0
8;86;558;563;5;43;2.0
8;87;563;565;2;43;2.0
8;88;565;568;3;43;2.0
8;89;568;572;4;43;2.0
8;90;572;575;3;43;2.0
8;91;575;578;3;43;2.0
8;92;578;583;5;43;2.0
8;93;583;588;5;43;2.0
8;94;588;592;4;43;2.0
8;95;592;595;3;43;2.0
8;96;595;598;3;43;2.0
8;97;598;601;3;43;2.0
8;98;601;603;2;43;2.0
8;99;603;605;2;43;2.0
8;100;605;608;3;43;2.0
8;101;608;612;4;43;2.0
8;102;612;615;3;43;2.0
8;103;615;618;3;43;2.0
8;104;618;623;5;43;2.0
8;105;623;628;5;43;2.0
8;106;628;632;4;43;2.0
8;107;632;635;3;43;2.0
8;108;635;638;3;43;2.0
8;109;638;643;5;43;2.0
8;110;643;648;5;43;2.0
8;111;648;652;4;43;2.0
8;112;652;655;3;43;2.0
8;113;655;658;3;43;2.0
8;114;658;661;3;43;2.0
8;115;661;663;2;43;2.0
8;116;663;665;2;43;2.0
8;117;665;668;3;43;2.0
8;118;668;672;4;43;2.0
8;119;672;675;3;43;2.0
8;120;675;678;3;43;2.0
8;121;678;683;5;43;2.0
8;122;683;688;5;43;2.0
8;123;688;692;4;43;2.0
8;124;692;695;3;43;2.0
8;125;695;698;3;43;2.0
8;126;698;703;5;43;2.0
8;127;703;708;5;43;2.0
8;128;708;712;4;43;2.0
8;129;712;715;3;43;2.0
8;130;715;718;3;43;2.0
8;131;718;721;3;43;2.0
8;132;721;723;2;43;2.0
8;133;723;725;2;43;2.0
8;134;725;728;3;43;2.0
8;135;728;732;4;43;2.0
8;136;732;735;3;43;2.0
8;137;735;738;3;43;2.0
8;138;738;743;5;43;2.0
8;139;743;748;5;43;2.0
8;140;748;752;4;43;2.0
8;141;752;755;3;43;2.0
8;142;755;758;3;43;2.0
8;143;758;763;5;43;2.0
8;144;763;768;5;43;2.0
8;145;768;772;4;43;2.0
8;146;772;775;3;43;2.0
8;147;775;778;3;43;2.0
8;148;778;781;3;43;2.0
8;149;781;783;2;43;2.0
8;150;783;785;2;43;2.0
8;151;785;788;3;43;2.0
8;152;788;792;4;43;2.0
8;153;792;795;3;43;2.0
8;154;795;798;3;43;2.0
8;155;798;803;5;43;2.0
8;156;803;805;2;43;2.0
8;157;805;808;3;43;2.0
8;158;808;812;4;43;2.0
8;159;812;815;3;43;2.0
8;160;815;818;3;43;2.0
8;161;818;821;3;43;2.0
8;162;821;823;2;43;2.0
8;163;823;825;2;43;2.0
8;164;825;828;3;43;2.0
8;165;828;832;4;43;2.0
8;166;832;835;3;43;2.0
8;167;835;838;3;43;2.0
8;168;838;841;3;43;2.0
8;169;841;843;2;43;2.0
8;170;843;845;2;43;2.0
8;171;845;848;3;43;2.0
8;172;848;852;4;43;2.0
8;173;852;855;3;43;2.0
8;174;855;856;1;43;2.0
8;175;856;858;2;43;2.0
8;176;858;861;3;43;2.0
8;177;861;863;2;43;2.0
8;178;863;865;2;43;2.0
8;179;865;868;3;43;2.0
8;180;868;872;4;43;2.0
8;181;872;875;3;43;2.0
8;182;875;878;3;43;2.0
8;183;878;881;3;43;2.0
8;184;881;882;1;43;2.0
8;185;882;883;1;43;2.0
8;186;883;885;2;43;2.0
8;187;885;888;3;43;2.0
8;188;888;892;4;43;2.0
8;189;892;893;1;43;2.0
8;190;893;895;2;43;2.0
8;191;895;898;3;43;2.0
8;192;898;901;3;43;2.0
8;193;901;902;1;43;2.0
8;194;902;903;1;43;2.0
8;195;903;905;2;43;2.0
8;196;905;908;3;43;2.0
8;197;908;912;4;43;2.0
8;198;912;915;3;43;2.0
8;199;915;916;1;43;2.0
8;200;916;918;2;43;2.0
8;201;918;922;4;43;2.0
8;202;922;923;1;43;2.0
8;203;923;925;2;43;2.0
8;204;925;928;3;43;2.0
8;205;928;932;4;43;2.0
8;206;932;935;3;43;2.0
8;207;935;938;3;43;2.0
8;208;938;941;3;43;2.0
8;209;941;942;1;43;2.0
8;210;942;943;1;43;2.0
8;211;943;945;2;43;2.0
8;212;945;948;3;43;2.0
8;213;948;952;4;43;2.0
8;214;952;953;1;43;2.0
8;215;953;955;2;43;2.0
8;216;955;958;3;43;2.0
8;217;958;961;3;43;2.0
8;218;961;962;1;43;2.0
8;219;962;963;1;43;2.0
8;220;963;965;2;43;2.0
8;221;965;968;3;43;2.0
8;222;968;972;4;43;2.0
8;223;972;975;3;43;2.0
8;224;975;976;1;43;2.0
8;225;976;978;2;43;2.0
8;226;978;982;4;43;2.0
8;227;982;983;1;43;2.0
8;228;983;985;2;43;2.0
8;229;985;988;3;43;2.0
8;230;988;992;4;43;2.0
8;231;992;995;3;43;2.0
8;232;995;998;3;43;2.0
8;233;998;1001;3;43;2.0
8;234;1001;1002;1;43;2.0
8;235;1002;1003;1;43;2.0
8;236;1003;1005;2;43;2.0
8;237;1005;1008;3;43;2.0
8;238;1008;1012;4;43;2.0
8;239;1012;1013;1;43;2.0
8;240;1013;1015;2;43;2.0
8;241;1015;1016;1;43;2.0
8;242;1016;1018;2;43;2.0
8;243;1018;1023;5;43;2.0
8;244;1023;1025;2;43;2.0
8;245;1025;1027;2;43;2.0
8;246;1027;1028;1;43;2.0
8;247;1028;1033;5;43;2.0
8;248;1033;1035;2;43;2.0
8;249;1035;1036;1;43;2.0
8;250;1036;1038;2;43;2.0
8;251;1038;1040;2;43;2.0
8;252;1040;1042;2;43;2.0
8;253;1042;1043;1;43;2.0
8;254;1043;1048;5;43;2.0
8;255;1048;1053;5;43;2.0
8;256;1053;1055;2;43;2.0
8;257;1055;1057;2;43;2.0
8;258;1057;1058;1;43;2.0
8;259;1058;1063;5;43;2.0
8;260;1063;1068;5;43;2.0
8;261;1068;1070;2;43;2.0
8;262;1070;1072;2;43;2.0
8;263;1072;1073;1;43;2.0
8;264;1073;1075;2;43;2.0
8;265;1075;1078;3;43;2.0
8;266;1078;1080;2;43;2.0
8;267;1080;1083;3;43;2.0
8;268;1083;1085;2;43;2.0
8;269;1085;1087;2;43;2.0
8;270;1087;1088;1;43;2.0
8;271;1088;1093;5;43;2.0
8;272;1093;1095;2;43;2.0
8;273;1095;1098;3;43;2.0
8;274;1098;1100;2;43;2.0
8;275;1100;1102;2;43;2.0
8;276;1102;1103;1;43;2.0
8;277;1103;1108;5;43;2.0
8;278;1108;1115;7;43;2.0
8;279;1115;1116;1;43;2.0
8;280;1116;1117;1;43;2.0
8;281;1117;1118;1;43;2.0
8;282;1118;1120;2;43;2.0
8;283;1120;1123;3;43;2.0
8;284;1123;1127;4;43;2.0
8;285;1127;1129;2;43;2.0
8;286;1129;1134;5;43;2.0
8;287;1134;1135;1;43;2.0
8;288;1135;1137;2;43;2.0
8;289;1137;1141;4;43;2.0
8;290;1141;1142;1;43;2.0
8;291;1142;1143;1;43;2.0
8;292;1143;1149;6;43;2.0
8;293;1149;1150;1;43;2.0
8;294;1150;1155;5;43;2.0
8;295;1155;1157;2;43;2.0
8;296;1157;1161;4;43;2.0
8;297;1161;1162;1;43;2.0
8;298;1162;1163;1;43;2.0
8;299;1163;1165;2;43;2.0
8;300;1165;1169;4;43;2.0
8;301;1169;1172;3;43;2.0
8;302;1172;1176;4;43;2.0
8;303;1176;1180;4;43;2.0
8;304;1180;1183;3;43;2.0
8;305;1183;1185;2;43;2.0
8;306;1185;1186;1;43;2.0
8;307;1186;1187;1;43;2.0
8;308;1187;1189;2;43;2.0
8;309;1189;1192;3;43;2.0
8;310;1192;1197;5;43;2.0
8;311;1197;1205;8;43;2.0
8;312;1205;1207;2;43;2.0
8;313;1207;1208;1;43;2.0
8;314;1208;1209;1;43;2.0
8;315;1209;1211;2;43;2.0
8;316;1211;1212;1;43;2.0
8;317;1212;1219;7;43;2.0
8;318;1219;1225;6;43;2.0
8;319;1225;1228;3;43;2.0
8;320;1228;1234;6;43;2.0
8;321;1234;1236;2;43;2.0
8;322;1236;1237;1;43;2.0
8;323;1237;1242;5;43;2.0
8;324;1242;1245;3;43;2.0
8;325;1245;1246;1;43;2.0
8;326;1246;1253;7;43;2.0
8;327;1253;1259;6;43;2.0
8;328;1259;1262;3;43;2.0
8;329;1262;1270;8;43;2.0
8;330;1270;1277;7;43;2.0
8;331;1277;1278;1;43;2.0
8;332;1278;1281;3;43;2.0
8;333;1281;1282;1;43;2.0
8;334;1282;1284;2;43;2.0
8;335;1284;1287;3;43;2.0
8;336;1287;1294;7;43;2.0
8;337;1294;1295;1;43;2.0
8;338;1295;1305;10;43;2.0
8;339;1305;1309;4;43;2.0
8;340;1309;1311;2;43;2.0
8;341;1311;1312;1;43;2.0
8;342;1312;1316;4;43;2.0
8;343;1316;1319;3;43;2.0
8;344;1319;1320;1;43;2.0
8;345;1320;1322;2;43;2.0
8;346;1322;1332;10;43;2.0
8;347;1332;1333;1;43;2.0
8;348;1333;1339;6;43;2.0
8;349;1339;1344;5;43;2.0
8;350;1344;1345;1;43;2.0
8;351;1345;1347;2;43;2.0
8;352;1347;1352;5;43;2.0
8;353;1352;1357;5;43;2.0
8;354;1357;1359;2;43;2.0
8;355;1359;1363;4;43;2.0
8;356;1363;1373;10;43;2.0
8;357;1373;1374;1;43;2.0
8;358;1374;1388;14;43;2.0
8;359;1388;1390;2;43;2.0
8;360;1390;1405;15;43;2.0
8;361;1405;1420;15;43;2.0
8;362;1420;1435;15;43;2.0
8;363;1435;1450;15;43;2.0
8;364;1450;1465;15;43;2.0
8;365;1465;1480;15;43;2.0
8;366;1480;1495;15;43;2.0
8;367;1495;1510;15;43;2.0
8;368;1510;1525;15;43;2.0
8;369;1525;1540;15;43;2.0
8;370;1540;1555;15;43;2.0
8;371;1555;1570;15;43;2.0
8;372;1570;1585;15;43;2.0
8;373;1585;1600;15;43;2.0
8;374;1600;1615;15;43;2.0
8;375;1615;1630;15;43;2.0
8;376;1630;1645;15;43;2.0
8;377;1645;1660;15;43;2.0
8;378;1660;1680;20;43;2.0
9;0;250;333;83;4;2.0
9;1;333;338;5;4;2.0
9;2;338;339;1;4;2.0
9;3;339;341;2;4;2.0
9;4;341;342;1;4;2.0
9;5;342;344;2;4;2.0
9;6;344;345;1;4;2.0
9;7;345;346;1;4;2.0
9;8;346;352;6;4;2.0
9;9;352;353;1;4;2.0
9;10;353;355;2;4;2.0
9;11;355;356;1;4;2.0
9;12;356;360;4;4;2.0
9;13;360;361;1;4;2.0
9;14;361;362;1;4;2.0
9;15;362;363;1;4;2.0
9;16;363;368;5;4;2.0
9;17;368;369;1;4;2.0
9;18;369;371;2;4;2.0
9;19;371;374;3;4;2.0
9;20;374;375;1;4;2.0
9;21;375;377;2;4;2.0
9;22;377;382;5;4;2.0
9;23;382;383;1;4;2.0
9;24;383;386;3;4;2.0
9;25;386;390;4;4;2.0
9;26;390;392;2;4;2.0
9;27;392;394;2;4;2.0
9;28;394;395;1;4;2.0
9;29;395;396;1;4;2.0
9;30;396;402;6;4;2.0
9;31;402;406;4;4;2.0
9;32;406;409;3;4;2.0
9;33;409;412;3;4;2.0
9;34;412;413;1;4;2.0
9;35;413;415;2;4;2.0
9;36;415;416;1;4;2.0
9;37;416;419;3;4;2.0
9;38;419;420;1;4;2.0
9;39;420;422;2;4;2.0
9;40;422;423;1;4;2.0
9;41;423;426;3;4;2.0
9;42;426;429;3;4;2.0
9;43;429;432;3;4;2.0
9;44;432;433;1;4;2.0
9;45;433;435;2;4;2.0
9;46;435;436;1;4;2.0
9;47;436;439;3;4;2.0
9;48;439;442;3;4;2.0
9;49;442;446;4;4;2.0
9;50;446;450;4;4;2.0
9;51;450;452;2;4;2.0
9;52;452;454;2;4;2.0
9;53;454;455;1;4;2.0
9;54;455;456;1;4;2.0
9;55;456;457;1;4;2.0
9;56;457;462;5;4;2.0
9;57;462;463;1;4;2.0
9;58;463;466;3;4;2.0
9;59;466;469;3;4;2.0
9;60;469;472;3;4;2.0
9;61;472;473;1;4;2.0
9;62;473;475;2;4;2.0
9;63;475;476;1;4;2.0
9;64;476;479;3;4;2.0
9;65;479;480;1;4;2.0
9;66;480;482;2;4;2.0
9;67;482;483;1;4;2.0
9;68;483;486;3;4;2.0
9;69;486;489;3;4;2.0
9;70;489;491;2;4;2.0
9;71;491;492;1;4;2.0
9;72;492;495;3;4;2.0
9;73;495;496;1;4;2.0
9;74;496;499;3;4;2.0
9;75;499;502;3;4;2.0
9;76;502;503;1;4;2.0
9;77;503;506;3;4;2.0
9;78;506;511;5;4;2.0
9;79;511;512;1;4;2.0
9;80;512;515;3;4;2.0
9;81;515;516;1;4;2.0
9;82;516;517;1;4;2.0
9;83;517;522;5;4;2.0
9;84;522;523;1;4;2.0
9;85;523;526;3;4;2.0
9;86;526;528;2;4;2.0
9;87;528;532;4;4;2.0
9;88;532;535;3;4;2.0
9;89;535;537;2;4;2.0
9;90;537;540;3;4;2.0
9;91;540;542;2;4;2.0
9;92;542;546;4;4;2.0
9;93;546;552;6;4;2.0
9;94;552;555;3;4;2.0
9;95;555;557;2;4;2.0
9;96;557;559;2;4;2.0
9;97;559;562;3;4;2.0
9;98;562;563;1;4;2.0
9;99;563;566;3;4;2.0
9;100;566;572;6;4;2.0
9;101;572;575;3;4;2.0
9;102;575;577;2;4;2.0
9;103;577;582;5;4;2.0
9;104;582;586;4;4;2.0
9;105;586;592;6;4;2.0
9;106;592;595;3;4;2.0
9;107;595;597;2;4;2.0
9;108;597;600;3;4;2.0
9;109;600;602;2;4;2.0
9;110;602;603;1;4;2.0
9;111;603;606;3;4;2.0
9;112;606;612;6;4;2.0
9;113;612;615;3;4;2.0
9;114;615;617;2;4;2.0
9;115;617;619;2;4;2.0
9;116;619;622;3;4;2.0
9;117;622;626;4;4;2.0
9;118;626;632;6;4;2.0
9;119;632;635;3;4;2.0
9;120;635;637;2;4;2.0
9;121;637;642;5;4;2.0
9;122;642;646;4;4;2.0
9;123;646;652;6;4;2.0
9;124;652;655;3;4;2.0
9;125;655;657;2;4;2.0
9;126;657;660;3;4;2.0
9;127;660;662;2;4;2.0
9;128;662;663;1;4;2.0
9;129;663;666;3;4;2.0
9;130;666;672;6;4;2.0
9;131;672;675;3;4;2.0
9;132;675;677;2;4;2.0
9;133;677;682;5;4;2.0
9;134;682;686;4;4;2.0
9;135;686;692;6;4;2.0
9;136;692;695;3;4;2.0
9;137;695;697;2;4;2.0
9;138;697;702;5;4;2.0
9;139;702;706;4;4;2.0
9;140;706;712;6;4;2.0
9;141;712;715;3;4;2.0
9;142;715;717;2;4;2.0
9;143;717;720;3;4;2.0
9;144;720;722;2;4;2.0
9;145;722;723;1;4;2.0
9;146;723;726;3;4;2.0
9;147;726;732;6;4;2.0
9;148;732;735;3;4;2.0
9;149;735;737;2;4;2.0
9;150;737;742;5;4;2.0
9;151;742;746;4;4;2.0
9;152;746;752;6;4;2.0
9;153;752;755;3;4;2.0
9;154;755;757;2;4;2.0
9;155;757;762;5;4;2.0
9;156;762;766;4;4;2.0
9;157;766;772;6;4;2.0
9;158;772;775;3;4;2.0
9;159;775;777;2;4;2.0
9;160;777;780;3;4;2.0
9;161;780;782;2;4;2.0
9;162;782;783;1;4;2.0
9;163;783;786;3;4;2.0
9;164;786;792;6;4;2.0
9;165;792;795;3;4;2.0
9;166;795;797;2;4;2.0
9;167;797;799;2;4;2.0
9;168;799;802;3;4;2.0
9;169;802;806;4;4;2.0
9;170;806;812;6;4;2.0
9;171;812;815;3;4;2.0
9;172;815;817;2;4;2.0
9;173;817;820;3;4;2.0
9;174;820;822;2;4;2.0
9;175;822;823;1;4;2.0
9;176;823;826;3;4;2.0
9;177;826;829;3;4;2.0
9;178;829;832;3;4;2.0
9;179;832;835;3;4;2.0
9;180;835;837;2;4;2.0
9;181;837;840;3;4;2.0
9;182;840;842;2;4;2.0
9;183;842;843;1;4;2.0
9;184;843;846;3;4;2.0
9;185;846;849;3;4;2.0
9;186;849;852;3;4;2.0
9;187;852;855;3;4;2.0
9;188;855;856;1;4;2.0
9;189;856;857;1;4;2.0
9;190;857;859;2;4;2.0
9;191;859;862;3;4;2.0
9;192;862;866;4;4;2.0
9;193;866;869;3;4;2.0
9;194;869;872;3;4;2.0
9;195;872;875;3;4;2.0
9;196;875;876;1;4;2.0
9;197;876;877;1;4;2.0
9;198;877;880;3;4;2.0
9;199;880;882;2;4;2.0
9;200;882;886;4;4;2.0
9;201;886;887;1;4;2.0
9;202;887;889;2;4;2.0
9;203;889;892;3;4;2.0
9;204;892;895;3;4;2.0
9;205;895;896;1;4;2.0
9;206;896;897;1;4;2.0
9;207;897;900;3;4;2.0
9;208;900;902;2;4;2.0
9;209;902;903;1;4;2.0
9;210;903;906;3;4;2.0
9;211;906;909;3;4;2.0
9;212;909;912;3;4;2.0
9;213;912;915;3;4;2.0
9;214;915;916;1;4;2.0
9;215;916;917;1;4;2.0
9;216;917;919;2;4;2.0
9;217;919;922;3;4;2.0
9;218;922;926;4;4;2.0
9;219;926;929;3;4;2.0
9;220;929;932;3;4;2.0
9;221;932;935;3;4;2.0
9;222;935;936;1;4;2.0
9;223;936;937;1;4;2.0
9;224;937;940;3;4;2.0
9;225;940;942;2;4;2.0
9;226;942;946;4;4;2.0
9;227;946;947;1;4;2.0
9;228;947;949;2;4;2.0
9;229;949;952;3;4;2.0
9;230;952;955;3;4;2.0
9;231;955;956;1;4;2.0
9;232;956;957;1;4;2.0
9;233;957;960;3;4;2.0
9;234;960;962;2;4;2.0
9;235;962;963;1;4;2.0
9;236;963;966;3;4;2.0
9;237;966;969;3;4;2.0
9;238;969;972;3;4;2.0
9;239;972;975;3;4;2.0
9;240;975;976;1;4;2.0
9;241;976;977;1;4;2.0
9;242;977;979;2;4;2.0
9;243;979;982;3;4;2.0
9;244;982;986;4;4;2.0
9;245;986;989;3;4;2.0
9;246;989;992;3;4;2.0
9;247;992;995;3;4;2.0
9;248;995;996;1;4;2.0
9;249;996;997;1;4;2.0
9;250;997;1002;5;4;2.0
9;251;1002;1006;4;4;2.0
9;252;1006;1007;1;4;2.0
9;253;1007;1009;2;4;2.0
9;254;1009;1012;3;4;2.0
9;255;1012;1015;3;4;2.0
9;256;1015;1016;1;4;2.0
9;257;1016;1017;1;4;2.0
9;258;1017;1021;4;4;2.0
9;259;1021;1022;1;4;2.0
9;260;1022;1023;1;4;2.0
9;261;1023;1029;6;4;2.0
9;262;1029;1031;2;4;2.0
9;263;1031;1035;4;4;2.0
9;264;1035;1036;1;4;2.0
9;265;1036;1037;1;4;2.0
9;266;1037;1042;5;4;2.0
9;267;1042;1046;4;4;2.0
9;268;1046;1047;1;4;2.0
9;269;1047;1049;2;4;2.0
9;270;1049;1051;2;4;2.0
9;271;1051;1052;1;4;2.0
9;272;1052;1055;3;4;2.0
9;273;1055;1057;2;4;2.0
9;274;1057;1061;4;4;2.0
9;275;1061;1062;1;4;2.0
9;276;1062;1066;4;4;2.0
9;277;1066;1067;1;4;2.0
9;278;1067;1069;2;4;2.0
9;279;1069;1075;6;4;2.0
9;280;1075;1076;1;4;2.0
9;281;1076;1077;1;4;2.0
9;282;1077;1079;2;4;2.0
9;283;1079;1081;2;4;2.0
9;284;1081;1082;1;4;2.0
9;285;1082;1083;1;4;2.0
9;286;1083;1089;6;4;2.0
9;287;1089;1091;2;4;2.0
9;288;1091;1095;4;4;2.0
9;289;1095;1096;1;4;2.0
9;290;1096;1097;1;4;2.0
9;291;1097;1106;9;4;2.0
9;292;1106;1109;3;4;2.0
9;293;1109;1110;1;4;2.0
9;294;1110;1111;1;4;2.0
9;295;1111;1112;1;4;2.0
9;296;1112;1114;2;4;2.0
9;297;1114;1117;3;4;2.0
9;298;1117;1121;4;4;2.0
9;299;1121;1123;2;4;2.0
9;300;1123;1124;1;4;2.0
9;301;1124;1128;4;4;2.0
9;302;1128;1133;5;4;2.0
9;303;1133;1135;2;4;2.0
9;304;1135;1136;1;4;2.0
9;305;1136;1137;1;4;2.0
9;306;1137;1139;2;4;2.0
9;307;1139;1143;4;4;2.0
9;308;1143;1147;4;4;2.0
9;309;1147;1148;1;4;2.0
9;310;1148;1152;4;4;2.0
9;311;1152;1154;2;4;2.0
9;312;1154;1155;1;4;2.0
9;313;1155;1157;2;4;2.0
9;314;1157;1159;2;4;2.0
9;315;1159;1163;4;4;2.0
9;316;1163;1169;6;4;2.0
9;317;1169;1170;1;4;2.0
9;318;1170;1177;7;4;2.0
9;319;1177;1180;3;4;2.0
9;320;1180;1183;3;4;2.0
9;321;1183;1184;1;4;2.0
9;322;1184;1189;5;4;2.0
9;323;1189;1196;7;4;2.0
9;324;1196;1202;6;4;2.0
9;325;1202;1203;1;4;2.0
9;326;1203;1204;1;4;2.0
9;327;1204;1205;1;4;2.0
9;328;1205;1209;4;4;2.0
9;329;1209;1217;8;4;2.0
9;330;1217;1222;5;4;2.0
9;331;1222;1223;1;4;2.0
9;332;1223;1228;5;4;2.0
9;333;1228;1230;2;4;2.0
9;334;1230;1234;4;4;2.0
9;335;1234;1239;5;4;2.0
9;336;1239;1240;1;4;2.0
9;337;1240;1243;3;4;2.0
9;338;1243;1247;4;4;2.0
9;339;1247;1253;6;4;2.0
9;340;1253;1259;6;4;2.0
9;341;1259;1268;9;4;2.0
9;342;1268;1272;4;4;2.0
9;343;1272;1275;3;4;2.0
9;344;1275;1276;1;4;2.0
9;345;1276;1278;2;4;2.0
9;346;1278;1279;1;4;2.0
9;347;1279;1284;5;4;2.0
9;348;1284;1292;8;4;2.0
9;349;1292;1293;1;4;2.0
9;350;1293;1299;6;4;2.0
9;351;1299;1303;4;4;2.0
9;352;1303;1305;2;4;2.0
9;353;1305;1309;4;4;2.0
9;354;1309;1310;1;4;2.0
9;355;1310;1317;7;4;2.0
9;356;1317;1318;1;4;2.0
9;357;1318;1319;1;4;2.0
9;358;1319;1327;8;4;2.0
9;359;1327;1329;2;4;2.0
9;360;1329;1333;4;4;2.0
9;361;1333;1342;9;4;2.0
9;362;1342;1343;1;4;2.0
9;363;1343;1348;5;4;2.0
9;364;1348;1349;1;4;2.0
9;365;1349;1353;4;4;2.0
9;366;1353;1354;1;4;2.0
9;367;1354;1357;3;4;2.0
9;368;1357;1368;11;4;2.0
9;369;1368;1370;2;4;2.0
9;370;1370;1371;1;4;2.0
9;371;1371;1382;11;4;2.0
9;372;1382;1388;6;4;2.0
9;373;1388;1403;15;4;2.0
9;374;1403;1418;15;4;2.0
9;375;1418;1433;15;4;2.0
9;376;1433;1448;15;4;2.0
9;377;1448;1463;15;4;2.0
9;378;1463;1478;15;4;2.0
9;379;1478;1493;15;4;2.0
9;380;1493;1508;15;4;2.0
9;381;1508;1523;15;4;2.0
9;382;1523;1538;15;4;2.0
9;383;1538;1553;15;4;2.0
9;384;1553;1568;15;4;2.0
9;385;1568;1583;15;4;2.0
9;386;1583;1598;15;4;2.0
9;387;1598;1613;15;4;2.0
9;388;1613;1628;15;4;2.0
9;389;1628;1643;15;4;2.0
9;390;1643;1658;15;4;2.0
9;391;1658;1680;22;4;2.0
10;0;252;336;84;11;2.0
10;1;336;342;6;11;2.0
10;2;342;345;3;11;2.0
10;3;345;348;3;11;2.0
10;4;348;349;1;11;2.0
10;5;349;350;1;11;2.0
10;6;350;357;7;11;2.0
10;7;357;359;2;11;2.0
10;8;359;362;3;11;2.0
10;9;362;363;1;11;2.0
10;10;363;364;1;11;2.0
10;11;364;365;1;11;2.0
10;12;365;366;1;11;2.0
10;13;366;368;2;11;2.0
10;14;368;372;4;11;2.0
10;15;372;375;3;11;2.0
10;16;375;377;2;11;2.0
10;17;377;378;1;11;2.0
10;18;378;379;1;11;2.0
10;19;379;383;4;11;2.0
10;20;383;386;3;11;2.0
10;21;386;389;3;11;2.0
10;22;389;392;3;11;2.0
10;23;392;393;1;11;2.0
10;24;393;396;3;11;2.0
10;25;396;398;2;11;2.0
10;26;398;399;1;11;2.0
10;27;399;400;1;11;2.0
10;28;400;403;3;11;2.0
10;29;403;406;3;11;2.0
10;30;406;409;3;11;2.0
10;31;409;413;4;11;2.0
10;32;413;415;2;11;2.0
10;33;415;416;1;11;2.0
10;34;416;418;2;11;2.0
10;35;418;419;1;11;2.0
10;36;419;422;3;11;2.0
10;37;422;423;1;11;2.0
10;38;423;424;1;11;2.0
10;39;424;426;2;11;2.0
10;40;426;428;2;11;2.0
10;41;428;429;1;11;2.0
10;42;429;433;4;11;2.0
10;43;433;435;2;11;2.0
10;44;435;436;1;11;2.0
10;45;436;439;3;11;2.0
10;46;439;443;4;11;2.0
10;47;443;445;2;11;2.0
10;48;445;446;1;11;2.0
10;49;446;448;2;11;2.0
10;50;448;449;1;11;2.0
10;51;449;452;3;11;2.0
10;52;452;453;1;11;2.0
10;53;453;456;3;11;2.0
10;54;456;458;2;11;2.0
10;55;458;459;1;11;2.0
10;56;459;460;1;11;2.0
10;57;460;463;3;11;2.0
10;58;463;466;3;11;2.0
10;59;466;469;3;11;2.0
10;60;469;473;4;11;2.0
10;61;473;475;2;11;2.0
10;62;475;476;1;11;2.0
10;63;476;478;2;11;2.0
10;64;478;479;1;11;2.0
10;65;479;482;3;11;2.0
10;66;482;483;1;11;2.0
10;67;483;484;1;11;2.0
10;68;484;486;2;11;2.0
10;69;486;488;2;11;2.0
10;70;488;489;1;11;2.0
10;71;489;493;4;11;2.0
10;72;493;495;2;11;2.0
10;73;495;496;1;11;2.0
10;74;496;498;2;11;2.0
10;75;498;499;1;11;2.0
10;76;499;503;4;11;2.0
10;77;503;505;2;11;2.0
10;78;505;506;1;11;2.0
10;79;506;509;3;11;2.0
10;80;509;513;4;11;2.0
10;81;513;514;1;11;2.0
10;82;514;516;2;11;2.0
10;83;516;518;2;11;2.0
10;84;518;519;1;11;2.0
10;85;519;523;4;11;2.0
10;86;523;526;3;11;2.0
10;87;526;529;3;11;2.0
10;88;529;531;2;11;2.0
10;89;531;533;2;11;2.0
10;90;533;536;3;11;2.0
10;91;536;539;3;11;2.0
10;92;539;542;3;11;2.0
10;93;542;543;1;11;2.0
10;94;543;549;6;11;2.0
10;95;549;553;4;11;2.0
10;96;553;556;3;11;2.0
10;97;556;559;3;11;2.0
10;98;559;563;4;11;2.0
10;99;563;564;1;11;2.0
10;100;564;566;2;11;2.0
10;101;566;569;3;11;2.0
10;102;569;573;4;11;2.0
10;103;573;576;3;11;2.0
10;104;576;578;2;11;2.0
10;105;578;579;1;11;2.0
10;106;579;583;4;11;2.0
10;107;583;589;6;11;2.0
10;108;589;593;4;11;2.0
10;109;593;596;3;11;2.0
10;110;596;599;3;11;2.0
10;111;599;602;3;11;2.0
10;112;602;603;1;11;2.0
10;113;603;606;3;11;2.0
10;114;606;609;3;11;2.0
10;115;609;613;4;11;2.0
10;116;613;616;3;11;2.0
10;117;616;619;3;11;2.0
10;118;619;623;4;11;2.0
10;119;623;624;1;11;2.0
10;120;624;629;5;11;2.0
10;121;629;633;4;11;2.0
10;122;633;636;3;11;2.0
10;123;636;638;2;11;2.0
10;124;638;639;1;11;2.0
10;125;639;643;4;11;2.0
10;126;643;649;6;11;2.0
10;127;649;653;4;11;2.0
10;128;653;656;3;11;2.0
10;129;656;659;3;11;2.0
10;130;659;662;3;11;2.0
10;131;662;663;1;11;2.0
10;132;663;666;3;11;2.0
10;133;666;669;3;11;2.0
10;134;669;673;4;11;2.0
10;135;673;676;3;11;2.0
10;136;676;679;3;11;2.0
10;137;679;683;4;11;2.0
10;138;683;689;6;11;2.0
10;139;689;693;4;11;2.0
10;140;693;696;3;11;2.0
10;141;696;698;2;11;2.0
10;142;698;699;1;11;2.0
10;143;699;703;4;11;2.0
10;144;703;709;6;11;2.0
10;145;709;713;4;11;2.0
10;146;713;716;3;11;2.0
10;147;716;719;3;11;2.0
10;148;719;722;3;11;2.0
10;149;722;723;1;11;2.0
10;150;723;726;3;11;2.0
10;151;726;729;3;11;2.0
10;152;729;733;4;11;2.0
10;153;733;736;3;11;2.0
10;154;736;739;3;11;2.0
10;155;739;743;4;11;2.0
10;156;743;749;6;11;2.0
10;157;749;753;4;11;2.0
10;158;753;756;3;11;2.0
10;159;756;758;2;11;2.0
10;160;758;759;1;11;2.0
10;161;759;763;4;11;2.0
10;162;763;769;6;11;2.0
10;163;769;773;4;11;2.0
10;164;773;776;3;11;2.0
10;165;776;779;3;11;2.0
10;166;779;782;3;11;2.0
10;167;782;783;1;11;2.0
10;168;783;786;3;11;2.0
10;169;786;789;3;11;2.0
10;170;789;793;4;11;2.0
10;171;793;796;3;11;2.0
10;172;796;799;3;11;2.0
10;173;799;803;4;11;2.0
10;174;803;804;1;11;2.0
10;175;804;806;2;11;2.0
10;176;806;809;3;11;2.0
10;177;809;813;4;11;2.0
10;178;813;816;3;11;2.0
10;179;816;818;2;11;2.0
10;180;818;819;1;11;2.0
10;181;819;822;3;11;2.0
10;182;822;823;1;11;2.0
10;183;823;826;3;11;2.0
10;184;826;829;3;11;2.0
10;185;829;833;4;11;2.0
10;186;833;835;2;11;2.0
10;187;835;836;1;11;2.0
10;188;836;839;3;11;2.0
10;189;839;842;3;11;2.0
10;190;842;843;1;11;2.0
10;191;843;846;3;11;2.0
10;192;846;849;3;11;2.0
10;193;849;853;4;11;2.0
10;194;853;855;2;11;2.0
10;195;855;856;1;11;2.0
10;196;856;857;1;11;2.0
10;197;857;859;2;11;2.0
10;198;859;861;2;11;2.0
10;199;861;863;2;11;2.0
10;200;863;864;1;11;2.0
10;201;864;866;2;11;2.0
10;202;866;869;3;11;2.0
10;203;869;873;4;11;2.0
10;204;873;875;2;11;2.0
10;205;875;876;1;11;2.0
10;206;876;878;2;11;2.0
10;207;878;879;1;11;2.0
10;208;879;882;3;11;2.0
10;209;882;883;1;11;2.0
10;210;883;886;3;11;2.0
10;211;886;889;3;11;2.0
10;212;889;893;4;11;2.0
10;213;893;895;2;11;2.0
10;214;895;896;1;11;2.0
10;215;896;899;3;11;2.0
10;216;899;902;3;11;2.0
10;217;902;903;1;11;2.0
10;218;903;906;3;11;2.0
10;219;906;909;3;11;2.0
10;220;909;913;4;11;2.0
10;221;913;915;2;11;2.0
10;222;915;916;1;11;2.0
10;223;916;917;1;11;2.0
10;224;917;918;1;11;2.0
10;225;918;919;1;11;2.0
10;226;919;923;4;11;2.0
10;227;923;924;1;11;2.0
10;228;924;926;2;11;2.0
10;229;926;929;3;11;2.0
10;230;929;933;4;11;2.0
10;231;933;935;2;11;2.0
10;232;935;936;1;11;2.0
10;233;936;938;2;11;2.0
10;234;938;939;1;11;2.0
10;235;939;942;3;11;2.0
10;236;942;943;1;11;2.0
10;237;943;946;3;11;2.0
10;238;946;949;3;11;2.0
10;239;949;953;4;11;2.0
10;240;953;955;2;11;2.0
10;241;955;956;1;11;2.0
10;242;956;959;3;11;2.0
10;243;959;962;3;11;2.0
10;244;962;963;1;11;2.0
10;245;963;966;3;11;2.0
10;246;966;969;3;11;2.0
10;247;969;973;4;11;2.0
10;248;973;975;2;11;2.0
10;249;975;976;1;11;2.0
10;250;976;977;1;11;2.0
10;251;977;978;1;11;2.0
10;252;978;979;1;11;2.0
10;253;979;983;4;11;2.0
10;254;983;984;1;11;2.0
10;255;984;986;2;11;2.0
10;256;986;989;3;11;2.0
10;257;989;993;4;11;2.0
10;258;993;995;2;11;2.0
10;259;995;996;1;11;2.0
10;260;996;999;3;11;2.0
10;261;999;1001;2;11;2.0
10;262;1001;1003;2;11;2.0
10;263;1003;1006;3;11;2.0
10;264;1006;1009;3;11;2.0
10;265;1009;1013;4;11;2.0
10;266;1013;1015;2;11;2.0
10;267;1015;1016;1;11;2.0
10;268;1016;1017;1;11;2.0
10;269;1017;1019;2;11;2.0
10;270;1019;1023;4;11;2.0
10;271;1023;1026;3;11;2.0
10;272;1026;1028;2;11;2.0
10;273;1028;1029;1;11;2.0
10;274;1029;1034;5;11;2.0
10;275;1034;1035;1;11;2.0
10;276;1035;1037;2;11;2.0
10;277;1037;1039;2;11;2.0
10;278;1039;1041;2;11;2.0
10;279;1041;1043;2;11;2.0
10;280;1043;1049;6;11;2.0
10;281;1049;1053;4;11;2.0
10;282;1053;1055;2;11;2.0
10;283;1055;1056;1;11;2.0
10;284;1056;1058;2;11;2.0
10;285;1058;1059;1;11;2.0
10;286;1059;1063;4;11;2.0
10;287;1063;1064;1;11;2.0
10;288;1064;1069;5;11;2.0
10;289;1069;1071;2;11;2.0
10;290;1071;1073;2;11;2.0
10;291;1073;1075;2;11;2.0
10;292;1075;1079;4;11;2.0
10;293;1079;1081;2;11;2.0
10;294;1081;1083;2;11;2.0
10;295;1083;1086;3;11;2.0
10;296;1086;1088;2;11;2.0
10;297;1088;1089;1;11;2.0
10;298;1089;1094;5;11;2.0
10;299;1094;1095;1;11;2.0
10;300;1095;1099;4;11;2.0
10;301;1099;1101;2;11;2.0
10;302;1101;1103;2;11;2.0
10;303;1103;1109;6;11;2.0
10;304;1109;1115;6;11;2.0
10;305;1115;1116;1;11;2.0
10;306;1116;1117;1;11;2.0
10;307;1117;1118;1;11;2.0
10;308;1118;1121;3;11;2.0
10;309;1121;1123;2;11;2.0
10;310;1123;1124;1;11;2.0
10;311;1124;1128;4;11;2.0
10;312;1128;1130;2;11;2.0
10;313;1130;1134;4;11;2.0
10;314;1134;1136;2;11;2.0
10;315;1136;1138;2;11;2.0
10;316;1138;1142;4;11;2.0
10;317;1142;1143;1;11;2.0
10;318;1143;1150;7;11;2.0
10;319;1150;1151;1;11;2.0
10;320;1151;1156;5;11;2.0
10;321;1156;1158;2;11;2.0
10;322;1158;1162;4;11;2.0
10;323;1162;1163;1;11;2.0
10;324;1163;1166;3;11;2.0
10;325;1166;1170;4;11;2.0
10;326;1170;1173;3;11;2.0
10;327;1173;1176;3;11;2.0
10;328;1176;1181;5;11;2.0
10;329;1181;1183;2;11;2.0
10;330;1183;1186;3;11;2.0
10;331;1186;1187;1;11;2.0
10;332;1187;1188;1;11;2.0
10;333;1188;1190;2;11;2.0
10;334;1190;1193;3;11;2.0
10;335;1193;1198;5;11;2.0
10;336;1198;1206;8;11;2.0
10;337;1206;1208;2;11;2.0
10;338;1208;1210;2;11;2.0
10;339;1210;1212;2;11;2.0
10;340;1212;1213;1;11;2.0
10;341;1213;1220;7;11;2.0
10;342;1220;1226;6;11;2.0
10;343;1226;1228;2;11;2.0
10;344;1228;1235;7;11;2.0
10;345;1235;1236;1;11;2.0
10;346;1236;1238;2;11;2.0
10;347;1238;1243;5;11;2.0
10;348;1243;1246;3;11;2.0
10;349;1246;1247;1;11;2.0
10;350;1247;1253;6;11;2.0
10;351;1253;1260;7;11;2.0
10;352;1260;1263;3;11;2.0
10;353;1263;1271;8;11;2.0
10;354;1271;1278;7;11;2.0
10;355;1278;1282;4;11;2.0
10;356;1282;1283;1;11;2.0
10;357;1283;1285;2;11;2.0
10;358;1285;1288;3;11;2.0
10;359;1288;1295;7;11;2.0
10;360;1295;1296;1;11;2.0
10;361;1296;1305;9;11;2.0
10;362;1305;1310;5;11;2.0
10;363;1310;1311;1;11;2.0
10;364;1311;1313;2;11;2.0
10;365;1313;1317;4;11;2.0
10;366;1317;1320;3;11;2.0
10;367;1320;1321;1;11;2.0
10;368;1321;1323;2;11;2.0
10;369;1323;1333;10;11;2.0
10;370;1333;1340;7;11;2.0
10;371;1340;1345;5;11;2.0
10;372;1345;1346;1;11;2.0
10;373;1346;1348;2;11;2.0
10;374;1348;1353;5;11;2.0
10;375;1353;1358;5;11;2.0
10;376;1358;1360;2;11;2.0
10;377;1360;1363;3;11;2.0
10;378;1363;1374;11;11;2.0
10;379;1374;1375;1;11;2.0
10;380;1375;1388;13;11;2.0
10;381;1388;1391;3;11;2.0
10;382;1391;1406;15;11;2.0
10;383;1406;1421;15;11;2.0
10;384;1421;1436;15;11;2.0
10;385;1436;1451;15;11;2.0
10;386;1451;1466;15;11;2.0
10;387;1466;1481;15;11;2.0
10;388;1481;1496;15;11;2.0
10;389;1496;1511;15;11;2.0
10;390;1511;1526;15;11;2.0
10;391;1526;1541;15;11;2.0
10;392;1541;1556;15;11;2.0
10;393;1556;1571;15;11;2.0
10;394;1571;1586;15;11;2.0
10;395;1586;1601;15;11;2.0
10;396;1601;1616;15;11;2.0
10;397;1616;1631;15;11;2.0
10;398;1631;1646;15;11;2.0
10;399;1646;1661;15;11;2.0
10;400;1661;1680;19;11;2.0
11;0;250;331;81;87;2.0
11;1;331;337;6;87;2.0
11;2;337;343;6;87;2.0
11;3;343;344;1;87;2.0
11;4;344;347;3;87;2.0
11;5;347;351;4;87;2.0
11;6;351;352;1;87;2.0
11;7;352;354;2;87;2.0
11;8;354;356;2;87;2.0
11;9;356;358;2;87;2.0
11;10;358;359;1;87;2.0
11;11;359;360;1;87;2.0
11;12;360;361;1;87;2.0
11;13;361;362;1;87;2.0
11;14;362;363;1;87;2.0
11;15;363;367;4;87;2.0
11;16;367;372;5;87;2.0
11;17;372;374;2;87;2.0
11;18;374;377;3;87;2.0
11;19;377;381;4;87;2.0
11;20;381;384;3;87;2.0
11;21;384;388;4;87;2.0
11;22;388;389;1;87;2.0
11;23;389;390;1;87;2.0
11;24;390;391;1;87;2.0
11;25;391;392;1;87;2.0
11;26;392;394;2;87;2.0
11;27;394;401;7;87;2.0
11;28;401;402;1;87;2.0
11;29;402;404;2;87;2.0
11;30;404;406;2;87;2.0
11;31;406;408;2;87;2.0
11;32;408;411;3;87;2.0
11;33;411;412;1;87;2.0
11;34;412;414;2;87;2.0
11;35;414;420;6;87;2.0
11;36;420;421;1;87;2.0
11;37;421;422;1;87;2.0
11;38;422;424;2;87;2.0
11;39;424;428;4;87;2.0
11;40;428;430;2;87;2.0
11;41;430;431;1;87;2.0
11;42;431;432;1;87;2.0
11;43;432;434;2;87;2.0
11;44;434;441;7;87;2.0
11;45;441;442;1;87;2.0
11;46;442;444;2;87;2.0
11;47;444;448;4;87;2.0
11;48;448;450;2;87;2.0
11;49;450;451;1;87;2.0
11;50;451;452;1;87;2.0
11;51;452;454;2;87;2.0
11;52;454;461;7;87;2.0
11;53;461;462;1;87;2.0
11;54;462;464;2;87;2.0
11;55;464;466;2;87;2.0
11;56;466;468;2;87;2.0
11;57;468;469;1;87;2.0
11;58;469;471;2;87;2.0
11;59;471;472;1;87;2.0
11;60;472;474;2;87;2.0
11;61;474;480;6;87;2.0
11;62;480;481;1;87;2.0
11;63;481;482;1;87;2.0
11;64;482;484;2;87;2.0
11;65;484;488;4;87;2.0
11;66;488;490;2;87;2.0
11;67;490;491;1;87;2.0
11;68;491;492;1;87;2.0
11;69;492;494;2;87;2.0
11;70;494;500;6;87;2.0
11;71;500;501;1;87;2.0
11;72;501;502;1;87;2.0
11;73;502;504;2;87;2.0
11;74;504;508;4;87;2.0
11;75;508;509;1;87;2.0
11;76;509;511;2;87;2.0
11;77;511;512;1;87;2.0
11;78;512;514;2;87;2.0
11;79;514;521;7;87;2.0
11;80;521;522;1;87;2.0
11;81;522;524;2;87;2.0
11;82;524;526;2;87;2.0
11;83;526;528;2;87;2.0
11;84;528;529;1;87;2.0
11;85;529;531;2;87;2.0
11;86;531;532;1;87;2.0
11;87;532;534;2;87;2.0
11;88;534;537;3;87;2.0
11;89;537;540;3;87;2.0
11;90;540;544;4;87;2.0
11;91;544;548;4;87;2.0
11;92;548;549;1;87;2.0
11;93;549;551;2;87;2.0
11;94;551;552;1;87;2.0
11;95;552;554;2;87;2.0
11;96;554;561;7;87;2.0
11;97;561;564;3;87;2.0
11;98;564;568;4;87;2.0
11;99;568;569;1;87;2.0
11;100;569;570;1;87;2.0
11;101;570;571;1;87;2.0
11;102;571;572;1;87;2.0
11;103;572;574;2;87;2.0
11;104;574;577;3;87;2.0
11;105;577;584;7;87;2.0
11;106;584;588;4;87;2.0
11;107;588;589;1;87;2.0
11;108;589;591;2;87;2.0
11;109;591;592;1;87;2.0
11;110;592;594;2;87;2.0
11;111;594;600;6;87;2.0
11;112;600;601;1;87;2.0
11;113;601;604;3;87;2.0
11;114;604;608;4;87;2.0
11;115;608;609;1;87;2.0
11;116;609;611;2;87;2.0
11;117;611;612;1;87;2.0
11;118;612;614;2;87;2.0
11;119;614;617;3;87;2.0
11;120;617;624;7;87;2.0
11;121;624;628;4;87;2.0
11;122;628;629;1;87;2.0
11;123;629;630;1;87;2.0
11;124;630;631;1;87;2.0
11;125;631;632;1;87;2.0
11;126;632;634;2;87;2.0
11;127;634;637;3;87;2.0
11;128;637;644;7;87;2.0
11;129;644;648;4;87;2.0
11;130;648;649;1;87;2.0
11;131;649;651;2;87;2.0
11;132;651;652;1;87;2.0
11;133;652;654;2;87;2.0
11;134;654;660;6;87;2.0
11;135;660;661;1;87;2.0
11;136;661;664;3;87;2.0
11;137;664;668;4;87;2.0
11;138;668;669;1;87;2.0
11;139;669;671;2;87;2.0
11;140;671;672;1;87;2.0
11;141;672;674;2;87;2.0
11;142;674;677;3;87;2.0
11;143;677;684;7;87;2.0
11;144;684;688;4;87;2.0
11;145;688;689;1;87;2.0
11;146;689;691;2;87;2.0
11;147;691;692;1;87;2.0
11;148;692;694;2;87;2.0
11;149;694;697;3;87;2.0
11;150;697;704;7;87;2.0
11;151;704;708;4;87;2.0
11;152;708;709;1;87;2.0
11;153;709;711;2;87;2.0
11;154;711;712;1;87;2.0
11;155;712;714;2;87;2.0
11;156;714;720;6;87;2.0
11;157;720;721;1;87;2.0
11;158;721;724;3;87;2.0
11;159;724;728;4;87;2.0
11;160;728;729;1;87;2.0
11;161;729;731;2;87;2.0
11;162;731;732;1;87;2.0
11;163;732;734;2;87;2.0
11;164;734;737;3;87;2.0
11;165;737;744;7;87;2.0
11;166;744;748;4;87;2.0
11;167;748;749;1;87;2.0
11;168;749;751;2;87;2.0
11;169;751;752;1;87;2.0
11;170;752;754;2;87;2.0
11;171;754;757;3;87;2.0
11;172;757;764;7;87;2.0
11;173;764;768;4;87;2.0
11;174;768;769;1;87;2.0
11;175;769;771;2;87;2.0
11;176;771;772;1;87;2.0
11;177;772;774;2;87;2.0
11;178;774;780;6;87;2.0
11;179;780;781;1;87;2.0
11;180;781;784;3;87;2.0
11;181;784;788;4;87;2.0
11;182;788;789;1;87;2.0
11;183;789;791;2;87;2.0
11;184;791;792;1;87;2.0
11;185;792;794;2;87;2.0
11;186;794;797;3;87;2.0
11;187;797;801;4;87;2.0
11;188;801;804;3;87;2.0
11;189;804;808;4;87;2.0
11;190;808;809;1;87;2.0
11;191;809;810;1;87;2.0
11;192;810;811;1;87;2.0
11;193;811;812;1;87;2.0
11;194;812;814;2;87;2.0
11;195;814;820;6;87;2.0
11;196;820;821;1;87;2.0
11;197;821;824;3;87;2.0
11;198;824;828;4;87;2.0
11;199;828;829;1;87;2.0
11;200;829;831;2;87;2.0
11;201;831;832;1;87;2.0
11;202;832;834;2;87;2.0
11;203;834;840;6;87;2.0
11;204;840;841;1;87;2.0
11;205;841;844;3;87;2.0
11;206;844;848;4;87;2.0
11;207;848;849;1;87;2.0
11;208;849;851;2;87;2.0
11;209;851;852;1;87;2.0
11;210;852;854;2;87;2.0
11;211;854;855;1;87;2.0
11;212;855;857;2;87;2.0
11;213;857;861;4;87;2.0
11;214;861;864;3;87;2.0
11;215;864;867;3;87;2.0
11;216;867;868;1;87;2.0
11;217;868;869;1;87;2.0
11;218;869;870;1;87;2.0
11;219;870;871;1;87;2.0
11;220;871;872;1;87;2.0
11;221;872;874;2;87;2.0
11;222;874;877;3;87;2.0
11;223;877;880;3;87;2.0
11;224;880;881;1;87;2.0
11;225;881;882;1;87;2.0
11;226;882;884;2;87;2.0
11;227;884;888;4;87;2.0
11;228;888;889;1;87;2.0
11;229;889;891;2;87;2.0
11;230;891;892;1;87;2.0
11;231;892;894;2;87;2.0
11;232;894;899;5;87;2.0
11;233;899;900;1;87;2.0
11;234;900;901;1;87;2.0
11;235;901;902;1;87;2.0
11;236;902;904;2;87;2.0
11;237;904;908;4;87;2.0
11;238;908;909;1;87;2.0
11;239;909;911;2;87;2.0
11;240;911;912;1;87;2.0
11;241;912;914;2;87;2.0
11;242;914;915;1;87;2.0
11;243;915;917;2;87;2.0
11;244;917;921;4;87;2.0
11;245;921;922;1;87;2.0
11;246;922;924;2;87;2.0
11;247;924;928;4;87;2.0
11;248;928;929;1;87;2.0
11;249;929;930;1;87;2.0
11;250;930;931;1;87;2.0
11;251;931;932;1;87;2.0
11;252;932;934;2;87;2.0
11;253;934;937;3;87;2.0
11;254;937;940;3;87;2.0
11;255;940;941;1;87;2.0
11;256;941;942;1;87;2.0
11;257;942;944;2;87;2.0
11;258;944;948;4;87;2.0
11;259;948;949;1;87;2.0
11;260;949;951;2;87;2.0
11;261;951;952;1;87;2.0
11;262;952;954;2;87;2.0
11;263;954;959;5;87;2.0
11;264;959;960;1;87;2.0
11;265;960;961;1;87;2.0
11;266;961;962;1;87;2.0
11;267;962;964;2;87;2.0
11;268;964;968;4;87;2.0
11;269;968;969;1;87;2.0
11;270;969;971;2;87;2.0
11;271;971;972;1;87;2.0
11;272;972;974;2;87;2.0
11;273;974;975;1;87;2.0
11;274;975;977;2;87;2.0
11;275;977;981;4;87;2.0
11;276;981;982;1;87;2.0
11;277;982;984;2;87;2.0
11;278;984;988;4;87;2.0
11;279;988;989;1;87;2.0
11;280;989;990;1;87;2.0
11;281;990;991;1;87;2.0
11;282;991;992;1;87;2.0
11;283;992;994;2;87;2.0
11;284;994;997;3;87;2.0
11;285;997;1001;4;87;2.0
11;286;1001;1002;1;87;2.0
11;287;1002;1004;2;87;2.0
11;288;1004;1007;3;87;2.0
11;289;1007;1008;1;87;2.0
11;290;1008;1009;1;87;2.0
11;291;1009;1011;2;87;2.0
11;292;1011;1012;1;87;2.0
11;293;1012;1014;2;87;2.0
11;294;1014;1015;1;87;2.0
11;295;1015;1019;4;87;2.0
11;296;1019;1021;2;87;2.0
11;297;1021;1027;6;87;2.0
11;298;1027;1028;1;87;2.0
11;299;1028;1029;1;87;2.0
11;300;1029;1034;5;87;2.0
11;301;1034;1035;1;87;2.0
11;302;1035;1036;1;87;2.0
11;303;1036;1037;1;87;2.0
11;304;1037;1041;4;87;2.0
11;305;1041;1042;1;87;2.0
11;306;1042;1044;2;87;2.0
11;307;1044;1048;4;87;2.0
11;308;1048;1049;1;87;2.0
11;309;1049;1051;2;87;2.0
11;310;1051;1054;3;87;2.0
11;311;1054;1057;3;87;2.0
11;312;1057;1059;2;87;2.0
11;313;1059;1061;2;87;2.0
11;314;1061;1066;5;87;2.0
11;315;1066;1068;2;87;2.0
11;316;1068;1069;1;87;2.0
11;317;1069;1072;3;87;2.0
11;318;1072;1074;2;87;2.0
11;319;1074;1079;5;87;2.0
11;320;1079;1081;2;87;2.0
11;321;1081;1087;6;87;2.0
11;322;1087;1088;1;87;2.0
11;323;1088;1089;1;87;2.0
11;324;1089;1094;5;87;2.0
11;325;1094;1096;2;87;2.0
11;326;1096;1097;1;87;2.0
11;327;1097;1101;4;87;2.0
11;328;1101;1102;1;87;2.0
11;329;1102;1104;2;87;2.0
11;330;1104;1109;5;87;2.0
11;331;1109;1111;2;87;2.0
11;332;1111;1116;5;87;2.0
11;333;1116;1117;1;87;2.0
11;334;1117;1119;2;87;2.0
11;335;1119;1121;2;87;2.0
11;336;1121;1123;2;87;2.0
11;337;1123;1124;1;87;2.0
11;338;1124;1129;5;87;2.0
11;339;1129;1131;2;87;2.0
11;340;1131;1136;5;87;2.0
11;341;1136;1138;2;87;2.0
11;342;1138;1140;2;87;2.0
11;343;1140;1141;1;87;2.0
11;344;1141;1145;4;87;2.0
11;345;1145;1146;1;87;2.0
11;346;1146;1149;3;87;2.0
11;347;1149;1151;2;87;2.0
11;348;1151;1153;2;87;2.0
11;349;1153;1161;8;87;2.0
11;350;1161;1168;7;87;2.0
11;351;1168;1169;1;87;2.0
11;352;1169;1176;7;87;2.0
11;353;1176;1181;5;87;2.0
11;354;1181;1182;1;87;2.0
11;355;1182;1186;4;87;2.0
11;356;1186;1188;2;87;2.0
11;357;1188;1189;1;87;2.0
11;358;1189;1196;7;87;2.0
11;359;1196;1201;5;87;2.0
11;360;1201;1203;2;87;2.0
11;361;1203;1208;5;87;2.0
11;362;1208;1209;1;87;2.0
11;363;1209;1211;2;87;2.0
11;364;1211;1214;3;87;2.0
11;365;1214;1215;1;87;2.0
11;366;1215;1221;6;87;2.0
11;367;1221;1233;12;87;2.0
11;368;1233;1234;1;87;2.0
11;369;1234;1236;2;87;2.0
11;370;1236;1238;2;87;2.0
11;371;1238;1241;3;87;2.0
11;372;1241;1242;1;87;2.0
11;373;1242;1246;4;87;2.0
11;374;1246;1258;12;87;2.0
11;375;1258;1259;1;87;2.0
11;376;1259;1261;2;87;2.0
11;377;1261;1266;5;87;2.0
11;378;1266;1276;10;87;2.0
11;379;1276;1278;2;87;2.0
11;380;1278;1281;3;87;2.0
11;381;1281;1283;2;87;2.0
11;382;1283;1284;1;87;2.0
11;383;1284;1290;6;87;2.0
11;384;1290;1291;1;87;2.0
11;385;1291;1308;17;87;2.0
11;386;1308;1309;1;87;2.0
11;387;1309;1311;2;87;2.0
11;388;1311;1315;4;87;2.0
11;389;1315;1316;1;87;2.0
11;390;1316;1317;1;87;2.0
11;391;1317;1318;1;87;2.0
11;392;1318;1328;10;87;2.0
11;393;1328;1339;11;87;2.0
11;394;1339;1340;1;87;2.0
11;395;1340;1341;1;87;2.0
11;396;1341;1348;7;87;2.0
11;397;1348;1352;4;87;2.0
11;398;1352;1353;1;87;2.0
11;399;1353;1359;6;87;2.0
11;400;1359;1369;10;87;2.0
11;401;1369;1374;5;87;2.0
11;402;1374;1386;12;87;2.0
11;403;1386;1394;8;87;2.0
11;404;1394;1409;15;87;2.0
11;405;1409;1424;15;87;2.0
11;406;1424;1439;15;87;2.0
11;407;1439;1454;15;87;2.0
11;408;1454;1469;15;87;2.0
11;409;1469;1484;15;87;2.0
11;410;1484;1499;15;87;2.0
11;411;1499;1514;15;87;2.0
11;412;1514;1529;15;87;2.0
11;413;1529;1544;15;87;2.0
11;414;1544;1559;15;87;2.0
11;415;1559;1574;15;87;2.0
11;416;1574;1589;15;87;2.0
11;417;1589;1604;15;87;2.0
11;418;1604;1619;15;87;2.0
11;419;1619;1634;15;87;2.0
11;420;1634;1649;15;87;2.0
11;421;1649;1664;15;87;2.0
11;422;1664;1680;16;87;2.0
12;0;246;326;80;72;2.0
12;1;326;330;4;72;2.0
12;2;330;338;8;72;2.0
12;3;338;339;1;72;2.0
12;4;339;344;5;72;2.0
12;5;344;345;1;72;2.0
12;6;345;347;2;72;2.0
12;7;347;349;2;72;2.0
12;8;349;350;1;72;2.0
12;9;350;353;3;72;2.0
12;10;353;354;1;72;2.0
12;11;354;356;2;72;2.0
12;12;356;357;1;72;2.0
12;13;357;360;3;72;2.0
12;14;360;367;7;72;2.0
12;15;367;369;2;72;2.0
12;16;369;374;5;72;2.0
12;17;374;376;2;72;2.0
12;18;376;379;3;72;2.0
12;19;379;380;1;72;2.0
12;20;380;382;2;72;2.0
12;21;382;384;2;72;2.0
12;22;384;387;3;72;2.0
12;23;387;389;2;72;2.0
12;24;389;394;5;72;2.0
12;25;394;397;3;72;2.0
12;26;397;399;2;72;2.0
12;27;399;400;1;72;2.0
12;28;400;404;4;72;2.0
12;29;404;406;2;72;2.0
12;30;406;407;1;72;2.0
12;31;407;409;2;72;2.0
12;32;409;414;5;72;2.0
12;33;414;416;2;72;2.0
12;34;416;417;1;72;2.0
12;35;417;419;2;72;2.0
12;36;419;420;1;72;2.0
12;37;420;424;4;72;2.0
12;38;424;426;2;72;2.0
12;39;426;427;1;72;2.0
12;40;427;429;2;72;2.0
12;41;429;434;5;72;2.0
12;42;434;439;5;72;2.0
12;43;439;440;1;72;2.0
12;44;440;444;4;72;2.0
12;45;444;447;3;72;2.0
12;46;447;449;2;72;2.0
12;47;449;454;5;72;2.0
12;48;454;456;2;72;2.0
12;49;456;457;1;72;2.0
12;50;457;459;2;72;2.0
12;51;459;460;1;72;2.0
12;52;460;462;2;72;2.0
12;53;462;464;2;72;2.0
12;54;464;466;2;72;2.0
12;55;466;467;1;72;2.0
12;56;467;469;2;72;2.0
12;57;469;474;5;72;2.0
12;58;474;476;2;72;2.0
12;59;476;477;1;72;2.0
12;60;477;479;2;72;2.0
12;61;479;480;1;72;2.0
12;62;480;484;4;72;2.0
12;63;484;487;3;72;2.0
12;64;487;489;2;72;2.0
12;65;489;493;4;72;2.0
12;66;493;494;1;72;2.0
12;67;494;496;2;72;2.0
12;68;496;497;1;72;2.0
12;69;497;500;3;72;2.0
12;70;500;504;4;72;2.0
12;71;504;507;3;72;2.0
12;72;507;514;7;72;2.0
12;73;514;516;2;72;2.0
12;74;516;517;1;72;2.0
12;75;517;520;3;72;2.0
12;76;520;521;1;72;2.0
12;77;521;522;1;72;2.0
12;78;522;524;2;72;2.0
12;79;524;527;3;72;2.0
12;80;527;531;4;72;2.0
12;81;531;534;3;72;2.0
12;82;534;539;5;72;2.0
12;83;539;540;1;72;2.0
12;84;540;542;2;72;2.0
12;85;542;544;2;72;2.0
12;86;544;547;3;72;2.0
12;87;547;556;9;72;2.0
12;88;556;559;3;72;2.0
12;89;559;560;1;72;2.0
12;90;560;562;2;72;2.0
12;91;562;564;2;72;2.0
12;92;564;567;3;72;2.0
12;93;567;571;4;72;2.0
12;94;571;577;6;72;2.0
12;95;577;579;2;72;2.0
12;96;579;580;1;72;2.0
12;97;580;582;2;72;2.0
12;98;582;584;2;72;2.0
12;99;584;587;3;72;2.0
12;100;587;594;7;72;2.0
12;101;594;596;2;72;2.0
12;102;596;599;3;72;2.0
12;103;599;600;1;72;2.0
12;104;600;602;2;72;2.0
12;105;602;604;2;72;2.0
12;106;604;607;3;72;2.0
12;107;607;611;4;72;2.0
12;108;611;619;8;72;2.0
12;109;619;620;1;72;2.0
12;110;620;622;2;72;2.0
12;111;622;624;2;72;2.0
12;112;624;627;3;72;2.0
12;113;627;631;4;72;2.0
12;114;631;637;6;72;2.0
12;115;637;639;2;72;2.0
12;116;639;640;1;72;2.0
12;117;640;642;2;72;2.0
12;118;642;644;2;72;2.0
12;119;644;647;3;72;2.0
12;120;647;654;7;72;2.0
12;121;654;656;2;72;2.0
12;122;656;659;3;72;2.0
12;123;659;660;1;72;2.0
12;124;660;662;2;72;2.0
12;125;662;664;2;72;2.0
12;126;664;667;3;72;2.0
12;127;667;671;4;72;2.0
12;128;671;679;8;72;2.0
12;129;679;680;1;72;2.0
12;130;680;682;2;72;2.0
12;131;682;684;2;72;2.0
12;132;684;687;3;72;2.0
12;133;687;691;4;72;2.0
12;134;691;697;6;72;2.0
12;135;697;699;2;72;2.0
12;136;699;700;1;72;2.0
12;137;700;702;2;72;2.0
12;138;702;704;2;72;2.0
12;139;704;707;3;72;2.0
12;140;707;714;7;72;2.0
12;141;714;716;2;72;2.0
12;142;716;719;3;72;2.0
12;143;719;720;1;72;2.0
12;144;720;722;2;72;2.0
12;145;722;724;2;72;2.0
12;146;724;727;3;72;2.0
12;147;727;731;4;72;2.0
12;148;731;739;8;72;2.0
12;149;739;740;1;72;2.0
12;150;740;742;2;72;2.0
12;151;742;744;2;72;2.0
12;152;744;747;3;72;2.0
12;153;747;751;4;72;2.0
12;154;751;757;6;72;2.0
12;155;757;759;2;72;2.0
12;156;759;760;1;72;2.0
12;157;760;762;2;72;2.0
12;158;762;764;2;72;2.0
12;159;764;767;3;72;2.0
12;160;767;774;7;72;2.0
12;161;774;776;2;72;2.0
12;162;776;779;3;72;2.0
12;163;779;780;1;72;2.0
12;164;780;782;2;72;2.0
12;165;782;784;2;72;2.0
12;166;784;787;3;72;2.0
12;167;787;791;4;72;2.0
12;168;791;794;3;72;2.0
12;169;794;799;5;72;2.0
12;170;799;800;1;72;2.0
12;171;800;802;2;72;2.0
12;172;802;804;2;72;2.0
12;173;804;807;3;72;2.0
12;174;807;814;7;72;2.0
12;175;814;816;2;72;2.0
12;176;816;817;1;72;2.0
12;177;817;819;2;72;2.0
12;178;819;820;1;72;2.0
12;179;820;822;2;72;2.0
12;180;822;824;2;72;2.0
12;181;824;827;3;72;2.0
12;182;827;834;7;72;2.0
12;183;834;836;2;72;2.0
12;184;836;839;3;72;2.0
12;185;839;840;1;72;2.0
12;186;840;842;2;72;2.0
12;187;842;844;2;72;2.0
12;188;844;847;3;72;2.0
12;189;847;849;2;72;2.0
12;190;849;851;2;72;2.0
12;191;851;854;3;72;2.0
12;192;854;859;5;72;2.0
12;193;859;860;1;72;2.0
12;194;860;862;2;72;2.0
12;195;862;864;2;72;2.0
12;196;864;867;3;72;2.0
12;197;867;869;2;72;2.0
12;198;869;871;2;72;2.0
12;199;871;874;3;72;2.0
12;200;874;877;3;72;2.0
12;201;877;879;2;72;2.0
12;202;879;880;1;72;2.0
12;203;880;882;2;72;2.0
12;204;882;884;2;72;2.0
12;205;884;887;3;72;2.0
12;206;887;889;2;72;2.0
12;207;889;892;3;72;2.0
12;208;892;894;2;72;2.0
12;209;894;896;2;72;2.0
12;210;896;899;3;72;2.0
12;211;899;900;1;72;2.0
12;212;900;902;2;72;2.0
12;213;902;904;2;72;2.0
12;214;904;907;3;72;2.0
12;215;907;909;2;72;2.0
12;216;909;911;2;72;2.0
12;217;911;914;3;72;2.0
12;218;914;917;3;72;2.0
12;219;917;919;2;72;2.0
12;220;919;920;1;72;2.0
12;221;920;922;2;72;2.0
12;222;922;924;2;72;2.0
12;223;924;927;3;72;2.0
12;224;927;929;2;72;2.0
12;225;929;931;2;72;2.0
12;226;931;934;3;72;2.0
12;227;934;937;3;72;2.0
12;228;937;939;2;72;2.0
12;229;939;940;1;72;2.0
12;230;940;942;2;72;2.0
12;231;942;944;2;72;2.0
12;232;944;947;3;72;2.0
12;233;947;949;2;72;2.0
12;234;949;952;3;72;2.0
12;235;952;954;2;72;2.0
12;236;954;956;2;72;2.0
12;237;956;959;3;72;2.0
12;238;959;960;1;72;2.0
12;239;960;962;2;72;2.0
12;240;962;964;2;72;2.0
12;241;964;967;3;72;2.0
12;242;967;969;2;72;2.0
12;243;969;971;2;72;2.0
12;244;971;974;3;72;2.0
12;245;974;977;3;72;2.0
12;246;977;979;2;72;2.0
12;247;979;980;1;72;2.0
12;248;980;982;2;72;2.0
12;249;982;984;2;72;2.0
12;250;984;987;3;72;2.0
12;251;987;989;2;72;2.0
12;252;989;991;2;72;2.0
12;253;991;994;3;72;2.0
12;254;994;999;5;72;2.0
12;255;999;1000;1;72;2.0
12;256;1000;1002;2;72;2.0
12;257;1002;1004;2;72;2.0
12;258;1004;1007;3;72;2.0
12;259;1007;1009;2;72;2.0
12;260;1009;1012;3;72;2.0
12;261;1012;1014;2;72;2.0
12;262;1014;1016;2;72;2.0
12;263;1016;1019;3;72;2.0
12;264;1019;1020;1;72;2.0
12;265;1020;1022;2;72;2.0
12;266;1022;1024;2;72;2.0
12;267;1024;1027;3;72;2.0
12;268;1027;1029;2;72;2.0
12;269;1029;1031;2;72;2.0
12;270;1031;1034;3;72;2.0
12;271;1034;1039;5;72;2.0
12;272;1039;1040;1;72;2.0
12;273;1040;1042;2;72;2.0
12;274;1042;1044;2;72;2.0
12;275;1044;1047;3;72;2.0
12;276;1047;1049;2;72;2.0
12;277;1049;1051;2;72;2.0
12;278;1051;1052;1;72;2.0
12;279;1052;1054;2;72;2.0
12;280;1054;1059;5;72;2.0
12;281;1059;1060;1;72;2.0
12;282;1060;1062;2;72;2.0
12;283;1062;1064;2;72;2.0
12;284;1064;1067;3;72;2.0
12;285;1067;1069;2;72;2.0
12;286;1069;1072;3;72;2.0
12;287;1072;1073;1;72;2.0
12;288;1073;1074;1;72;2.0
12;289;1074;1076;2;72;2.0
12;290;1076;1079;3;72;2.0
12;291;1079;1080;1;72;2.0
12;292;1080;1082;2;72;2.0
12;293;1082;1084;2;72;2.0
12;294;1084;1087;3;72;2.0
12;295;1087;1089;2;72;2.0
12;296;1089;1091;2;72;2.0
12;297;1091;1094;3;72;2.0
12;298;1094;1099;5;72;2.0
12;299;1099;1102;3;72;2.0
12;300;1102;1104;2;72;2.0
12;301;1104;1108;4;72;2.0
12;302;1108;1109;1;72;2.0
12;303;1109;1110;1;72;2.0
12;304;1110;1114;4;72;2.0
12;305;1114;1116;2;72;2.0
12;306;1116;1117;1;72;2.0
12;307;1117;1121;4;72;2.0
12;308;1121;1122;1;72;2.0
12;309;1122;1126;4;72;2.0
12;310;1126;1130;4;72;2.0
12;311;1130;1131;1;72;2.0
12;312;1131;1133;2;72;2.0
12;313;1133;1140;7;72;2.0
12;314;1140;1141;1;72;2.0
12;315;1141;1142;1;72;2.0
12;316;1142;1144;2;72;2.0
12;317;1144;1146;2;72;2.0
12;318;1146;1153;7;72;2.0
12;319;1153;1155;2;72;2.0
12;320;1155;1156;1;72;2.0
12;321;1156;1161;5;72;2.0
12;322;1161;1162;1;72;2.0
12;323;1162;1169;7;72;2.0
12;324;1169;1175;6;72;2.0
12;325;1175;1176;1;72;2.0
12;326;1176;1178;2;72;2.0
12;327;1178;1180;2;72;2.0
12;328;1180;1181;1;72;2.0
12;329;1181;1182;1;72;2.0
12;330;1182;1190;8;72;2.0
12;331;1190;1196;6;72;2.0
12;332;1196;1201;5;72;2.0
12;333;1201;1203;2;72;2.0
12;334;1203;1207;4;72;2.0
12;335;1207;1210;3;72;2.0
12;336;1210;1216;6;72;2.0
12;337;1216;1226;10;72;2.0
12;338;1226;1227;1;72;2.0
12;339;1227;1230;3;72;2.0
12;340;1230;1231;1;72;2.0
12;341;1231;1235;4;72;2.0
12;342;1235;1236;1;72;2.0
12;343;1236;1238;2;72;2.0
12;344;1238;1251;13;72;2.0
12;345;1251;1252;1;72;2.0
12;346;1252;1255;3;72;2.0
12;347;1255;1261;6;72;2.0
12;348;1261;1270;9;72;2.0
12;349;1270;1271;1;72;2.0
12;350;1271;1273;2;72;2.0
12;351;1273;1276;3;72;2.0
12;352;1276;1277;1;72;2.0
12;353;1277;1285;8;72;2.0
12;354;1285;1286;1;72;2.0
12;355;1286;1301;15;72;2.0
12;356;1301;1304;3;72;2.0
12;357;1304;1308;4;72;2.0
12;358;1308;1310;2;72;2.0
12;359;1310;1311;1;72;2.0
12;360;1311;1321;10;72;2.0
12;361;1321;1331;10;72;2.0
12;362;1331;1332;1;72;2.0
12;363;1332;1335;3;72;2.0
12;364;1335;1336;1;72;2.0
12;365;1336;1341;5;72;2.0
12;366;1341;1346;5;72;2.0
12;367;1346;1347;1;72;2.0
12;368;1347;1351;4;72;2.0
12;369;1351;1362;11;72;2.0
12;370;1362;1364;2;72;2.0
12;371;1364;1366;2;72;2.0
12;372;1366;1381;15;72;2.0
12;373;1381;1387;6;72;2.0
12;374;1387;1402;15;72;2.0
12;375;1402;1417;15;72;2.0
12;376;1417;1432;15;72;2.0
12;377;1432;1447;15;72;2.0
12;378;1447;1462;15;72;2.0
12;379;1462;1477;15;72;2.0
12;380;1477;1492;15;72;2.0
12;381;1492;1507;15;72;2.0
12;382;1507;1522;15;72;2.0
12;383;1522;1537;15;72;2.0
12;384;1537;1552;15;72;2.0
12;385;1552;1567;15;72;2.0
12;386;1567;1582;15;72;2.0
12;387;1582;1597;15;72;2.0
12;388;1597;1612;15;72;2.0
12;389;1612;1627;15;72;2.0
12;390;1627;1642;15;72;2.0
12;391;1642;1657;15;72;2.0
12;392;1657;1672;15;72;2.0
12;393;1672;1680;8;72;2.0
13;0;249;333;84;58;2.0
13;1;333;337;4;58;2.0
13;2;337;340;3;58;2.0
13;3;340;341;1;58;2.0
13;4;341;344;3;58;2.0
13;5;344;345;1;58;2.0
13;6;345;346;1;58;2.0
13;7;346;351;5;58;2.0
13;8;351;352;1;58;2.0
13;9;352;354;2;58;2.0
13;10;354;355;1;58;2.0
13;11;355;359;4;58;2.0
13;12;359;360;1;58;2.0
13;13;360;361;1;58;2.0
13;14;361;363;2;58;2.0
13;15;363;364;1;58;2.0
13;16;364;367;3;58;2.0
13;17;367;370;3;58;2.0
13;18;370;371;1;58;2.0
13;19;371;374;3;58;2.0
13;20;374;379;5;58;2.0
13;21;379;381;2;58;2.0
13;22;381;383;2;58;2.0
13;23;383;385;2;58;2.0
13;24;385;386;1;58;2.0
13;25;386;389;3;58;2.0
13;26;389;391;2;58;2.0
13;27;391;394;3;58;2.0
13;28;394;395;1;58;2.0
13;29;395;396;1;58;2.0
13;30;396;401;5;58;2.0
13;31;401;405;4;58;2.0
13;32;405;406;1;58;2.0
13;33;406;411;5;58;2.0
13;34;411;413;2;58;2.0
13;35;413;414;1;58;2.0
13;36;414;415;1;58;2.0
13;37;415;416;1;58;2.0
13;38;416;419;3;58;2.0
13;39;419;421;2;58;2.0
13;40;421;423;2;58;2.0
13;41;423;424;1;58;2.0
13;42;424;425;1;58;2.0
13;43;425;426;1;58;2.0
13;44;426;431;5;58;2.0
13;45;431;433;2;58;2.0
13;46;433;434;1;58;2.0
13;47;434;435;1;58;2.0
13;48;435;436;1;58;2.0
13;49;436;441;5;58;2.0
13;50;441;444;3;58;2.0
13;51;444;445;1;58;2.0
13;52;445;446;1;58;2.0
13;53;446;449;3;58;2.0
13;54;449;451;2;58;2.0
13;55;451;454;3;58;2.0
13;56;454;455;1;58;2.0
13;57;455;456;1;58;2.0
13;58;456;459;3;58;2.0
13;59;459;461;2;58;2.0
13;60;461;463;2;58;2.0
13;61;463;465;2;58;2.0
13;62;465;466;1;58;2.0
13;63;466;471;5;58;2.0
13;64;471;473;2;58;2.0
13;65;473;474;1;58;2.0
13;66;474;475;1;58;2.0
13;67;475;476;1;58;2.0
13;68;476;479;3;58;2.0
13;69;479;481;2;58;2.0
13;70;481;483;2;58;2.0
13;71;483;484;1;58;2.0
13;72;484;485;1;58;2.0
13;73;485;486;1;58;2.0
13;74;486;491;5;58;2.0
13;75;491;492;1;58;2.0
13;76;492;494;2;58;2.0
13;77;494;495;1;58;2.0
13;78;495;496;1;58;2.0
13;79;496;501;5;58;2.0
13;80;501;503;2;58;2.0
13;81;503;505;2;58;2.0
13;82;505;511;6;58;2.0
13;83;511;514;3;58;2.0
13;84;514;515;1;58;2.0
13;85;515;519;4;58;2.0
13;86;519;521;2;58;2.0
13;87;521;523;2;58;2.0
13;88;523;525;2;58;2.0
13;89;525;528;3;58;2.0
13;90;528;531;3;58;2.0
13;91;531;534;3;58;2.0
13;92;534;539;5;58;2.0
13;93;539;541;2;58;2.0
13;94;541;545;4;58;2.0
13;95;545;546;1;58;2.0
13;96;546;551;5;58;2.0
13;97;551;554;3;58;2.0
13;98;554;559;5;58;2.0
13;99;559;561;2;58;2.0
13;100;561;563;2;58;2.0
13;101;563;565;2;58;2.0
13;102;565;566;1;58;2.0
13;103;566;571;5;58;2.0
13;104;571;574;3;58;2.0
13;105;574;579;5;58;2.0
13;106;579;581;2;58;2.0
13;107;581;585;4;58;2.0
13;108;585;586;1;58;2.0
13;109;586;591;5;58;2.0
13;110;591;594;3;58;2.0
13;111;594;599;5;58;2.0
13;112;599;601;2;58;2.0
13;113;601;603;2;58;2.0
13;114;603;605;2;58;2.0
13;115;605;606;1;58;2.0
13;116;606;611;5;58;2.0
13;117;611;614;3;58;2.0
13;118;614;619;5;58;2.0
13;119;619;621;2;58;2.0
13;120;621;625;4;58;2.0
13;121;625;626;1;58;2.0
13;122;626;631;5;58;2.0
13;123;631;634;3;58;2.0
13;124;634;639;5;58;2.0
13;125;639;641;2;58;2.0
13;126;641;645;4;58;2.0
13;127;645;646;1;58;2.0
13;128;646;651;5;58;2.0
13;129;651;654;3;58;2.0
13;130;654;659;5;58;2.0
13;131;659;661;2;58;2.0
13;132;661;663;2;58;2.0
13;133;663;665;2;58;2.0
13;134;665;666;1;58;2.0
13;135;666;671;5;58;2.0
13;136;671;674;3;58;2.0
13;137;674;679;5;58;2.0
13;138;679;681;2;58;2.0
13;139;681;685;4;58;2.0
13;140;685;686;1;58;2.0
13;141;686;691;5;58;2.0
13;142;691;694;3;58;2.0
13;143;694;699;5;58;2.0
13;144;699;701;2;58;2.0
13;145;701;705;4;58;2.0
13;146;705;706;1;58;2.0
13;147;706;711;5;58;2.0
13;148;711;714;3;58;2.0
13;149;714;719;5;58;2.0
13;150;719;721;2;58;2.0
13;151;721;723;2;58;2.0
13;152;723;725;2;58;2.0
13;153;725;726;1;58;2.0
13;154;726;731;5;58;2.0
13;155;731;734;3;58;2.0
13;156;734;739;5;58;2.0
13;157;739;741;2;58;2.0
13;158;741;745;4;58;2.0
13;159;745;746;1;58;2.0
13;160;746;751;5;58;2.0
13;161;751;754;3;58;2.0
13;162;754;759;5;58;2.0
13;163;759;761;2;58;2.0
13;164;761;765;4;58;2.0
13;165;765;766;1;58;2.0
13;166;766;771;5;58;2.0
13;167;771;774;3;58;2.0
13;168;774;779;5;58;2.0
13;169;779;781;2;58;2.0
13;170;781;783;2;58;2.0
13;171;783;785;2;58;2.0
13;172;785;786;1;58;2.0
13;173;786;791;5;58;2.0
13;174;791;794;3;58;2.0
13;175;794;799;5;58;2.0
13;176;799;801;2;58;2.0
13;177;801;805;4;58;2.0
13;178;805;806;1;58;2.0
13;179;806;811;5;58;2.0
13;180;811;814;3;58;2.0
13;181;814;819;5;58;2.0
13;182;819;821;2;58;2.0
13;183;821;823;2;58;2.0
13;184;823;825;2;58;2.0
13;185;825;826;1;58;2.0
13;186;826;831;5;58;2.0
13;187;831;834;3;58;2.0
13;188;834;839;5;58;2.0
13;189;839;841;2;58;2.0
13;190;841;843;2;58;2.0
13;191;843;845;2;58;2.0
13;192;845;846;1;58;2.0
13;193;846;851;5;58;2.0
13;194;851;854;3;58;2.0
13;195;854;856;2;58;2.0
13;196;856;857;1;58;2.0
13;197;857;859;2;58;2.0
13;198;859;861;2;58;2.0
13;199;861;865;4;58;2.0
13;200;865;866;1;58;2.0
13;201;866;871;5;58;2.0
13;202;871;874;3;58;2.0
13;203;874;875;1;58;2.0
13;204;875;876;1;58;2.0
13;205;876;879;3;58;2.0
13;206;879;881;2;58;2.0
13;207;881;885;4;58;2.0
13;208;885;886;1;58;2.0
13;209;886;889;3;58;2.0
13;210;889;891;2;58;2.0
13;211;891;894;3;58;2.0
13;212;894;895;1;58;2.0
13;213;895;896;1;58;2.0
13;214;896;899;3;58;2.0
13;215;899;901;2;58;2.0
13;216;901;903;2;58;2.0
13;217;903;905;2;58;2.0
13;218;905;906;1;58;2.0
13;219;906;911;5;58;2.0
13;220;911;914;3;58;2.0
13;221;914;915;1;58;2.0
13;222;915;916;1;58;2.0
13;223;916;919;3;58;2.0
13;224;919;921;2;58;2.0
13;225;921;925;4;58;2.0
13;226;925;926;1;58;2.0
13;227;926;931;5;58;2.0
13;228;931;934;3;58;2.0
13;229;934;935;1;58;2.0
13;230;935;936;1;58;2.0
13;231;936;939;3;58;2.0
13;232;939;941;2;58;2.0
13;233;941;945;4;58;2.0
13;234;945;946;1;58;2.0
13;235;946;949;3;58;2.0
13;236;949;951;2;58;2.0
13;237;951;954;3;58;2.0
13;238;954;955;1;58;2.0
13;239;955;956;1;58;2.0
13;240;956;959;3;58;2.0
13;241;959;961;2;58;2.0
13;242;961;963;2;58;2.0
13;243;963;965;2;58;2.0
13;244;965;966;1;58;2.0
13;245;966;971;5;58;2.0
13;246;971;974;3;58;2.0
13;247;974;975;1;58;2.0
13;248;975;976;1;58;2.0
13;249;976;979;3;58;2.0
13;250;979;981;2;58;2.0
13;251;981;985;4;58;2.0
13;252;985;986;1;58;2.0
13;253;986;991;5;58;2.0
13;254;991;994;3;58;2.0
13;255;994;995;1;58;2.0
13;256;995;996;1;58;2.0
13;257;996;997;1;58;2.0
13;258;997;999;2;58;2.0
13;259;999;1001;2;58;2.0
13;260;1001;1005;4;58;2.0
13;261;1005;1006;1;58;2.0
13;262;1006;1009;3;58;2.0
13;263;1009;1011;2;58;2.0
13;264;1011;1014;3;58;2.0
13;265;1014;1016;2;58;2.0
13;266;1016;1019;3;58;2.0
13;267;1019;1020;1;58;2.0
13;268;1020;1021;1;58;2.0
13;269;1021;1023;2;58;2.0
13;270;1023;1031;8;58;2.0
13;271;1031;1034;3;58;2.0
13;272;1034;1035;1;58;2.0
13;273;1035;1036;1;58;2.0
13;274;1036;1039;3;58;2.0
13;275;1039;1041;2;58;2.0
13;276;1041;1046;5;58;2.0
13;277;1046;1049;3;58;2.0
13;278;1049;1050;1;58;2.0
13;279;1050;1051;1;58;2.0
13;280;1051;1054;3;58;2.0
13;281;1054;1059;5;58;2.0
13;282;1059;1061;2;58;2.0
13;283;1061;1065;4;58;2.0
13;284;1065;1066;1;58;2.0
13;285;1066;1069;3;58;2.0
13;286;1069;1071;2;58;2.0
13;287;1071;1074;3;58;2.0
13;288;1074;1076;2;58;2.0
13;289;1076;1078;2;58;2.0
13;290;1078;1079;1;58;2.0
13;291;1079;1080;1;58;2.0
13;292;1080;1081;1;58;2.0
13;293;1081;1083;2;58;2.0
13;294;1083;1091;8;58;2.0
13;295;1091;1094;3;58;2.0
13;296;1094;1095;1;58;2.0
13;297;1095;1096;1;58;2.0
13;298;1096;1099;3;58;2.0
13;299;1099;1106;7;58;2.0
13;300;1106;1109;3;58;2.0
13;301;1109;1110;1;58;2.0
13;302;1110;1111;1;58;2.0
13;303;1111;1113;2;58;2.0
13;304;1113;1114;1;58;2.0
13;305;1114;1116;2;58;2.0
13;306;1116;1119;3;58;2.0
13;307;1119;1121;2;58;2.0
13;308;1121;1122;1;58;2.0
13;309;1122;1123;1;58;2.0
13;310;1123;1130;7;58;2.0
13;311;1130;1133;3;58;2.0
13;312;1133;1134;1;58;2.0
13;313;1134;1135;1;58;2.0
13;314;1135;1138;3;58;2.0
13;315;1138;1139;1;58;2.0
13;316;1139;1142;3;58;2.0
13;317;1142;1147;5;58;2.0
13;318;1147;1148;1;58;2.0
13;319;1148;1151;3;58;2.0
13;320;1151;1153;2;58;2.0
13;321;1153;1154;1;58;2.0
13;322;1154;1158;4;58;2.0
13;323;1158;1159;1;58;2.0
13;324;1159;1162;3;58;2.0
13;325;1162;1163;1;58;2.0
13;326;1163;1168;5;58;2.0
13;327;1168;1172;4;58;2.0
13;328;1172;1176;4;58;2.0
13;329;1176;1179;3;58;2.0
13;330;1179;1182;3;58;2.0
13;331;1182;1183;1;58;2.0
13;332;1183;1188;5;58;2.0
13;333;1188;1195;7;58;2.0
13;334;1195;1202;7;58;2.0
13;335;1202;1203;1;58;2.0
13;336;1203;1204;1;58;2.0
13;337;1204;1208;4;58;2.0
13;338;1208;1217;9;58;2.0
13;339;1217;1223;6;58;2.0
13;340;1223;1224;1;58;2.0
13;341;1224;1227;3;58;2.0
13;342;1227;1232;5;58;2.0
13;343;1232;1233;1;58;2.0
13;344;1233;1238;5;58;2.0
13;345;1238;1239;1;58;2.0
13;346;1239;1243;4;58;2.0
13;347;1243;1249;6;58;2.0
13;348;1249;1252;3;58;2.0
13;349;1252;1258;6;58;2.0
13;350;1258;1268;10;58;2.0
13;351;1268;1274;6;58;2.0
13;352;1274;1275;1;58;2.0
13;353;1275;1277;2;58;2.0
13;354;1277;1278;1;58;2.0
13;355;1278;1283;5;58;2.0
13;356;1283;1292;9;58;2.0
13;357;1292;1293;1;58;2.0
13;358;1293;1301;8;58;2.0
13;359;1301;1302;1;58;2.0
13;360;1302;1307;5;58;2.0
13;361;1307;1308;1;58;2.0
13;362;1308;1309;1;58;2.0
13;363;1309;1317;8;58;2.0
13;364;1317;1318;1;58;2.0
13;365;1318;1328;10;58;2.0
13;366;1328;1329;1;58;2.0
13;367;1329;1332;3;58;2.0
13;368;1332;1342;10;58;2.0
13;369;1342;1343;1;58;2.0
13;370;1343;1348;5;58;2.0
13;371;1348;1349;1;58;2.0
13;372;1349;1352;3;58;2.0
13;373;1352;1353;1;58;2.0
13;374;1353;1359;6;58;2.0
13;375;1359;1367;8;58;2.0
13;376;1367;1369;2;58;2.0
13;377;1369;1371;2;58;2.0
13;378;1371;1384;13;58;2.0
13;379;1384;1388;4;58;2.0
13;380;1388;1403;15;58;2.0
13;381;1403;1418;15;58;2.0
13;382;1418;1433;15;58;2.0
13;383;1433;1448;15;58;2.0
13;384;1448;1463;15;58;2.0
13;385;1463;1478;15;58;2.0
13;386;1478;1493;15;58;2.0
13;387;1493;1508;15;58;2.0
13;388;1508;1523;15;58;2.0
13;389;1523;1538;15;58;2.0
13;390;1538;1553;15;58;2.0
13;391;1553;1568;15;58;2.0
13;392;1568;1583;15;58;2.0
13;393;1583;1598;15;58;2.0
13;394;1598;1613;15;58;2.0
13;395;1613;1628;15;58;2.0
13;396;1628;1643;15;58;2.0
13;397;1643;1658;15;58;2.0
13;398;1658;1680;22;58;2.0
14;0;257;338;81;115;2.0
14;1;338;344;6;115;2.0
14;2;344;350;6;115;2.0
14;3;350;351;1;115;2.0
14;4;351;352;1;115;2.0
14;5;352;355;3;115;2.0
14;6;355;357;2;115;2.0
14;7;357;359;2;115;2.0
14;8;359;361;2;115;2.0
14;9;361;363;2;115;2.0
14;10;363;364;1;115;2.0
14;11;364;366;2;115;2.0
14;12;366;367;1;115;2.0
14;13;367;368;1;115;2.0
14;14;368;374;6;115;2.0
14;15;374;375;1;115;2.0
14;16;375;379;4;115;2.0
14;17;379;381;2;115;2.0
14;18;381;382;1;115;2.0
14;19;382;388;6;115;2.0
14;20;388;390;2;115;2.0
14;21;390;391;1;115;2.0
14;22;391;393;2;115;2.0
14;23;393;394;1;115;2.0
14;24;394;397;3;115;2.0
14;25;397;398;1;115;2.0
14;26;398;401;3;115;2.0
14;27;401;405;4;115;2.0
14;28;405;407;2;115;2.0
14;29;407;408;1;115;2.0
14;30;408;411;3;115;2.0
14;31;411;413;2;115;2.0
14;32;413;417;4;115;2.0
14;33;417;418;1;115;2.0
14;34;418;421;3;115;2.0
14;35;421;422;1;115;2.0
14;36;422;424;2;115;2.0
14;37;424;425;1;115;2.0
14;38;425;427;2;115;2.0
14;39;427;428;1;115;2.0
14;40;428;430;2;115;2.0
14;41;430;431;1;115;2.0
14;42;431;433;2;115;2.0
14;43;433;435;2;115;2.0
14;44;435;437;2;115;2.0
14;45;437;438;1;115;2.0
14;46;438;441;3;115;2.0
14;47;441;442;1;115;2.0
14;48;442;447;5;115;2.0
14;49;447;448;1;115;2.0
14;50;448;451;3;115;2.0
14;51;451;452;1;115;2.0
14;52;452;453;1;115;2.0
14;53;453;454;1;115;2.0
14;54;454;455;1;115;2.0
14;55;455;457;2;115;2.0
14;56;457;458;1;115;2.0
14;57;458;461;3;115;2.0
14;58;461;465;4;115;2.0
14;59;465;467;2;115;2.0
14;60;467;468;1;115;2.0
14;61;468;470;2;115;2.0
14;62;470;471;1;115;2.0
14;63;471;473;2;115;2.0
14;64;473;477;4;115;2.0
14;65;477;478;1;115;2.0
14;66;478;481;3;115;2.0
14;67;481;482;1;115;2.0
14;68;482;484;2;115;2.0
14;69;484;485;1;115;2.0
14;70;485;487;2;115;2.0
14;71;487;488;1;115;2.0
14;72;488;490;2;115;2.0
14;73;490;491;1;115;2.0
14;74;491;493;2;115;2.0
14;75;493;495;2;115;2.0
14;76;495;497;2;115;2.0
14;77;497;498;1;115;2.0
14;78;498;501;3;115;2.0
14;79;501;502;1;115;2.0
14;80;502;505;3;115;2.0
14;81;505;507;2;115;2.0
14;82;507;508;1;115;2.0
14;83;508;512;4;115;2.0
14;84;512;513;1;115;2.0
14;85;513;516;3;115;2.0
14;86;516;517;1;115;2.0
14;87;517;518;1;115;2.0
14;88;518;521;3;115;2.0
14;89;521;525;4;115;2.0
14;90;525;527;2;115;2.0
14;91;527;528;1;115;2.0
14;92;528;530;2;115;2.0
14;93;530;533;3;115;2.0
14;94;533;537;4;115;2.0
14;95;537;538;1;115;2.0
14;96;538;541;3;115;2.0
14;97;541;542;1;115;2.0
14;98;542;544;2;115;2.0
14;99;544;550;6;115;2.0
14;100;550;551;1;115;2.0
14;101;551;553;2;115;2.0
14;102;553;557;4;115;2.0
14;103;557;558;1;115;2.0
14;104;558;561;3;115;2.0
14;105;561;568;7;115;2.0
14;106;568;570;2;115;2.0
14;107;570;571;1;115;2.0
14;108;571;573;2;115;2.0
14;109;573;577;4;115;2.0
14;110;577;578;1;115;2.0
14;111;578;581;3;115;2.0
14;112;581;582;1;115;2.0
14;113;582;585;3;115;2.0
14;114;585;590;5;115;2.0
14;115;590;591;1;115;2.0
14;116;591;593;2;115;2.0
14;117;593;597;4;115;2.0
14;118;597;598;1;115;2.0
14;119;598;601;3;115;2.0
14;120;601;604;3;115;2.0
14;121;604;608;4;115;2.0
14;122;608;610;2;115;2.0
14;123;610;611;1;115;2.0
14;124;611;613;2;115;2.0
14;125;613;617;4;115;2.0
14;126;617;618;1;115;2.0
14;127;618;621;3;115;2.0
14;128;621;622;1;115;2.0
14;129;622;630;8;115;2.0
14;130;630;631;1;115;2.0
14;131;631;633;2;115;2.0
14;132;633;637;4;115;2.0
14;133;637;638;1;115;2.0
14;134;638;641;3;115;2.0
14;135;641;642;1;115;2.0
14;136;642;645;3;115;2.0
14;137;645;650;5;115;2.0
14;138;650;651;1;115;2.0
14;139;651;653;2;115;2.0
14;140;653;657;4;115;2.0
14;141;657;658;1;115;2.0
14;142;658;661;3;115;2.0
14;143;661;664;3;115;2.0
14;144;664;668;4;115;2.0
14;145;668;670;2;115;2.0
14;146;670;671;1;115;2.0
14;147;671;673;2;115;2.0
14;148;673;677;4;115;2.0
14;149;677;678;1;115;2.0
14;150;678;681;3;115;2.0
14;151;681;682;1;115;2.0
14;152;682;690;8;115;2.0
14;153;690;691;1;115;2.0
14;154;691;693;2;115;2.0
14;155;693;697;4;115;2.0
14;156;697;698;1;115;2.0
14;157;698;701;3;115;2.0
14;158;701;702;1;115;2.0
14;159;702;705;3;115;2.0
14;160;705;710;5;115;2.0
14;161;710;711;1;115;2.0
14;162;711;713;2;115;2.0
14;163;713;717;4;115;2.0
14;164;717;718;1;115;2.0
14;165;718;721;3;115;2.0
14;166;721;724;3;115;2.0
14;167;724;728;4;115;2.0
14;168;728;730;2;115;2.0
14;169;730;731;1;115;2.0
14;170;731;733;2;115;2.0
14;171;733;737;4;115;2.0
14;172;737;738;1;115;2.0
14;173;738;741;3;115;2.0
14;174;741;742;1;115;2.0
14;175;742;750;8;115;2.0
14;176;750;751;1;115;2.0
14;177;751;753;2;115;2.0
14;178;753;757;4;115;2.0
14;179;757;758;1;115;2.0
14;180;758;761;3;115;2.0
14;181;761;762;1;115;2.0
14;182;762;765;3;115;2.0
14;183;765;770;5;115;2.0
14;184;770;771;1;115;2.0
14;185;771;773;2;115;2.0
14;186;773;777;4;115;2.0
14;187;777;778;1;115;2.0
14;188;778;781;3;115;2.0
14;189;781;784;3;115;2.0
14;190;784;788;4;115;2.0
14;191;788;790;2;115;2.0
14;192;790;791;1;115;2.0
14;193;791;793;2;115;2.0
14;194;793;797;4;115;2.0
14;195;797;798;1;115;2.0
14;196;798;801;3;115;2.0
14;197;801;802;1;115;2.0
14;198;802;808;6;115;2.0
14;199;808;810;2;115;2.0
14;200;810;811;1;115;2.0
14;201;811;813;2;115;2.0
14;202;813;817;4;115;2.0
14;203;817;818;1;115;2.0
14;204;818;821;3;115;2.0
14;205;821;824;3;115;2.0
14;206;824;825;1;115;2.0
14;207;825;828;3;115;2.0
14;208;828;830;2;115;2.0
14;209;830;831;1;115;2.0
14;210;831;833;2;115;2.0
14;211;833;837;4;115;2.0
14;212;837;838;1;115;2.0
14;213;838;841;3;115;2.0
14;214;841;842;1;115;2.0
14;215;842;844;2;115;2.0
14;216;844;848;4;115;2.0
14;217;848;850;2;115;2.0
14;218;850;851;1;115;2.0
14;219;851;853;2;115;2.0
14;220;853;857;4;115;2.0
14;221;857;858;1;115;2.0
14;222;858;859;1;115;2.0
14;223;859;861;2;115;2.0
14;224;861;862;1;115;2.0
14;225;862;868;6;115;2.0
14;226;868;870;2;115;2.0
14;227;870;871;1;115;2.0
14;228;871;873;2;115;2.0
14;229;873;877;4;115;2.0
14;230;877;878;1;115;2.0
14;231;878;881;3;115;2.0
14;232;881;882;1;115;2.0
14;233;882;884;2;115;2.0
14;234;884;885;1;115;2.0
14;235;885;887;2;115;2.0
14;236;887;888;1;115;2.0
14;237;888;890;2;115;2.0
14;238;890;891;1;115;2.0
14;239;891;893;2;115;2.0
14;240;893;897;4;115;2.0
14;241;897;898;1;115;2.0
14;242;898;900;2;115;2.0
14;243;900;901;1;115;2.0
14;244;901;902;1;115;2.0
14;245;902;904;2;115;2.0
14;246;904;907;3;115;2.0
14;247;907;908;1;115;2.0
14;248;908;910;2;115;2.0
14;249;910;911;1;115;2.0
14;250;911;913;2;115;2.0
14;251;913;917;4;115;2.0
14;252;917;918;1;115;2.0
14;253;918;919;1;115;2.0
14;254;919;921;2;115;2.0
14;255;921;922;1;115;2.0
14;256;922;925;3;115;2.0
14;257;925;927;2;115;2.0
14;258;927;928;1;115;2.0
14;259;928;930;2;115;2.0
14;260;930;931;1;115;2.0
14;261;931;933;2;115;2.0
14;262;933;937;4;115;2.0
14;263;937;938;1;115;2.0
14;264;938;941;3;115;2.0
14;265;941;942;1;115;2.0
14;266;942;944;2;115;2.0
14;267;944;945;1;115;2.0
14;268;945;947;2;115;2.0
14;269;947;948;1;115;2.0
14;270;948;950;2;115;2.0
14;271;950;951;1;115;2.0
14;272;951;953;2;115;2.0
14;273;953;957;4;115;2.0
14;274;957;958;1;115;2.0
14;275;958;960;2;115;2.0
14;276;960;961;1;115;2.0
14;277;961;962;1;115;2.0
14;278;962;964;2;115;2.0
14;279;964;967;3;115;2.0
14;280;967;968;1;115;2.0
14;281;968;970;2;115;2.0
14;282;970;971;1;115;2.0
14;283;971;973;2;115;2.0
14;284;973;977;4;115;2.0
14;285;977;978;1;115;2.0
14;286;978;979;1;115;2.0
14;287;979;981;2;115;2.0
14;288;981;982;1;115;2.0
14;289;982;985;3;115;2.0
14;290;985;987;2;115;2.0
14;291;987;988;1;115;2.0
14;292;988;990;2;115;2.0
14;293;990;991;1;115;2.0
14;294;991;993;2;115;2.0
14;295;993;997;4;115;2.0
14;296;997;998;1;115;2.0
14;297;998;1001;3;115;2.0
14;298;1001;1002;1;115;2.0
14;299;1002;1007;5;115;2.0
14;300;1007;1008;1;115;2.0
14;301;1008;1010;2;115;2.0
14;302;1010;1011;1;115;2.0
14;303;1011;1013;2;115;2.0
14;304;1013;1017;4;115;2.0
14;305;1017;1018;1;115;2.0
14;306;1018;1019;1;115;2.0
14;307;1019;1020;1;115;2.0
14;308;1020;1021;1;115;2.0
14;309;1021;1022;1;115;2.0
14;310;1022;1028;6;115;2.0
14;311;1028;1030;2;115;2.0
14;312;1030;1032;2;115;2.0
14;313;1032;1033;1;115;2.0
14;314;1033;1036;3;115;2.0
14;315;1036;1039;3;115;2.0
14;316;1039;1041;2;115;2.0
14;317;1041;1042;1;115;2.0
14;318;1042;1043;1;115;2.0
14;319;1043;1047;4;115;2.0
14;320;1047;1050;3;115;2.0
14;321;1050;1051;1;115;2.0
14;322;1051;1053;2;115;2.0
14;323;1053;1058;5;115;2.0
14;324;1058;1060;2;115;2.0
14;325;1060;1061;1;115;2.0
14;326;1061;1062;1;115;2.0
14;327;1062;1066;4;115;2.0
14;328;1066;1070;4;115;2.0
14;329;1070;1073;3;115;2.0
14;330;1073;1077;4;115;2.0
14;331;1077;1080;3;115;2.0
14;332;1080;1081;1;115;2.0
14;333;1081;1082;1;115;2.0
14;334;1082;1083;1;115;2.0
14;335;1083;1088;5;115;2.0
14;336;1088;1090;2;115;2.0
14;337;1090;1092;2;115;2.0
14;338;1092;1093;1;115;2.0
14;339;1093;1096;3;115;2.0
14;340;1096;1101;5;115;2.0
14;341;1101;1102;1;115;2.0
14;342;1102;1103;1;115;2.0
14;343;1103;1107;4;115;2.0
14;344;1107;1110;3;115;2.0
14;345;1110;1111;1;115;2.0
14;346;1111;1118;7;115;2.0
14;347;1118;1121;3;115;2.0
14;348;1121;1122;1;115;2.0
14;349;1122;1123;1;115;2.0
14;350;1123;1125;2;115;2.0
14;351;1125;1126;1;115;2.0
14;352;1126;1130;4;115;2.0
14;353;1130;1134;4;115;2.0
14;354;1134;1138;4;115;2.0
14;355;1138;1140;2;115;2.0
14;356;1140;1141;1;115;2.0
14;357;1141;1145;4;115;2.0
14;358;1145;1146;1;115;2.0
14;359;1146;1150;4;115;2.0
14;360;1150;1152;2;115;2.0
14;361;1152;1153;1;115;2.0
14;362;1153;1154;1;115;2.0
14;363;1154;1158;4;115;2.0
14;364;1158;1160;2;115;2.0
14;365;1160;1166;6;115;2.0
14;366;1166;1168;2;115;2.0
14;367;1168;1170;2;115;2.0
14;368;1170;1174;4;115;2.0
14;369;1174;1175;1;115;2.0
14;370;1175;1183;8;115;2.0
14;371;1183;1188;5;115;2.0
14;372;1188;1190;2;115;2.0
14;373;1190;1191;1;115;2.0
14;374;1191;1194;3;115;2.0
14;375;1194;1195;1;115;2.0
14;376;1195;1200;5;115;2.0
14;377;1200;1208;8;115;2.0
14;378;1208;1210;2;115;2.0
14;379;1210;1214;4;115;2.0
14;380;1214;1215;1;115;2.0
14;381;1215;1216;1;115;2.0
14;382;1216;1222;6;115;2.0
14;383;1222;1228;6;115;2.0
14;384;1228;1235;7;115;2.0
14;385;1235;1239;4;115;2.0
14;386;1239;1240;1;115;2.0
14;387;1240;1241;1;115;2.0
14;388;1241;1243;2;115;2.0
14;389;1243;1245;2;115;2.0
14;390;1245;1248;3;115;2.0
14;391;1248;1251;3;115;2.0
14;392;1251;1260;9;115;2.0
14;393;1260;1264;4;115;2.0
14;394;1264;1265;1;115;2.0
14;395;1265;1266;1;115;2.0
14;396;1266;1273;7;115;2.0
14;397;1273;1280;7;115;2.0
14;398;1280;1285;5;115;2.0
14;399;1285;1286;1;115;2.0
14;400;1286;1289;3;115;2.0
14;401;1289;1290;1;115;2.0
14;402;1290;1297;7;115;2.0
14;403;1297;1298;1;115;2.0
14;404;1298;1312;14;115;2.0
14;405;1312;1314;2;115;2.0
14;406;1314;1315;1;115;2.0
14;407;1315;1318;3;115;2.0
14;408;1318;1321;3;115;2.0
14;409;1321;1322;1;115;2.0
14;410;1322;1323;1;115;2.0
14;411;1323;1325;2;115;2.0
14;412;1325;1335;10;115;2.0
14;413;1335;1340;5;115;2.0
14;414;1340;1344;4;115;2.0
14;415;1344;1347;3;115;2.0
14;416;1347;1348;1;115;2.0
14;417;1348;1354;6;115;2.0
14;418;1354;1355;1;115;2.0
14;419;1355;1360;5;115;2.0
14;420;1360;1364;4;115;2.0
14;421;1364;1370;6;115;2.0
14;422;1370;1376;6;115;2.0
14;423;1376;1379;3;115;2.0
14;424;1379;1393;14;115;2.0
14;425;1393;1395;2;115;2.0
14;426;1395;1410;15;115;2.0
14;427;1410;1425;15;115;2.0
14;428;1425;1440;15;115;2.0
14;429;1440;1455;15;115;2.0
14;430;1455;1470;15;115;2.0
14;431;1470;1485;15;115;2.0
14;432;1485;1500;15;115;2.0
14;433;1500;1515;15;115;2.0
14;434;1515;1530;15;115;2.0
14;435;1530;1545;15;115;2.0
14;436;1545;1560;15;115;2.0
14;437;1560;1575;15;115;2.0
14;438;1575;1590;15;115;2.0
14;439;1590;1605;15;115;2.0
14;440;1605;1620;15;115;2.0
14;441;1620;1635;15;115;2.0
14;442;1635;1650;15;115;2.0
14;443;1650;1680;30;115;2.0
15;0;260;344;84;159;2.0
15;1;344;349;5;159;2.0
15;2;349;352;3;159;2.0
15;3;352;354;2;159;2.0
15;4;354;355;1;159;2.0
15;5;355;356;1;159;2.0
15;6;356;357;1;159;2.0
15;7;357;361;4;159;2.0
15;8;361;364;3;159;2.0
15;9;364;366;2;159;2.0
15;10;366;370;4;159;2.0
15;11;370;372;2;159;2.0
15;12;372;374;2;159;2.0
15;13;374;379;5;159;2.0
15;14;379;385;6;159;2.0
15;15;385;386;1;159;2.0
15;16;386;387;1;159;2.0
15;17;387;393;6;159;2.0
15;18;393;394;1;159;2.0
15;19;394;396;2;159;2.0
15;20;396;397;1;159;2.0
15;21;397;400;3;159;2.0
15;22;400;402;2;159;2.0
15;23;402;403;1;159;2.0
15;24;403;404;1;159;2.0
15;25;404;406;2;159;2.0
15;26;406;407;1;159;2.0
15;27;407;410;3;159;2.0
15;28;410;413;3;159;2.0
15;29;413;416;3;159;2.0
15;30;416;417;1;159;2.0
15;31;417;419;2;159;2.0
15;32;419;420;1;159;2.0
15;33;420;422;2;159;2.0
15;34;422;423;1;159;2.0
15;35;423;424;1;159;2.0
15;36;424;426;2;159;2.0
15;37;426;427;1;159;2.0
15;38;427;428;1;159;2.0
15;39;428;430;2;159;2.0
15;40;430;432;2;159;2.0
15;41;432;433;1;159;2.0
15;42;433;434;1;159;2.0
15;43;434;436;2;159;2.0
15;44;436;437;1;159;2.0
15;45;437;439;2;159;2.0
15;46;439;440;1;159;2.0
15;47;440;443;3;159;2.0
15;48;443;444;1;159;2.0
15;49;444;446;2;159;2.0
15;50;446;447;1;159;2.0
15;51;447;449;2;159;2.0
15;52;449;450;1;159;2.0
15;53;450;452;2;159;2.0
15;54;452;453;1;159;2.0
15;55;453;456;3;159;2.0
15;56;456;457;1;159;2.0
15;57;457;460;3;159;2.0
15;58;460;462;2;159;2.0
15;59;462;463;1;159;2.0
15;60;463;464;1;159;2.0
15;61;464;466;2;159;2.0
15;62;466;467;1;159;2.0
15;63;467;470;3;159;2.0
15;64;470;473;3;159;2.0
15;65;473;474;1;159;2.0
15;66;474;476;2;159;2.0
15;67;476;477;1;159;2.0
15;68;477;479;2;159;2.0
15;69;479;480;1;159;2.0
15;70;480;482;2;159;2.0
15;71;482;483;1;159;2.0
15;72;483;484;1;159;2.0
15;73;484;486;2;159;2.0
15;74;486;487;1;159;2.0
15;75;487;488;1;159;2.0
15;76;488;490;2;159;2.0
15;77;490;492;2;159;2.0
15;78;492;493;1;159;2.0
15;79;493;494;1;159;2.0
15;80;494;496;2;159;2.0
15;81;496;497;1;159;2.0
15;82;497;499;2;159;2.0
15;83;499;500;1;159;2.0
15;84;500;501;1;159;2.0
15;85;501;502;1;159;2.0
15;86;502;503;1;159;2.0
15;87;503;506;3;159;2.0
15;88;506;507;1;159;2.0
15;89;507;509;2;159;2.0
15;90;509;510;1;159;2.0
15;91;510;514;4;159;2.0
15;92;514;516;2;159;2.0
15;93;516;520;4;159;2.0
15;94;520;522;2;159;2.0
15;95;522;523;1;159;2.0
15;96;523;526;3;159;2.0
15;97;526;527;1;159;2.0
15;98;527;530;3;159;2.0
15;99;530;534;4;159;2.0
15;100;534;536;2;159;2.0
15;101;536;539;3;159;2.0
15;102;539;540;1;159;2.0
15;103;540;543;3;159;2.0
15;104;543;546;3;159;2.0
15;105;546;547;1;159;2.0
15;106;547;550;3;159;2.0
15;107;550;556;6;159;2.0
15;108;556;557;1;159;2.0
15;109;557;560;3;159;2.0
15;110;560;563;3;159;2.0
15;111;563;566;3;159;2.0
15;112;566;567;1;159;2.0
15;113;567;568;1;159;2.0
15;114;568;574;6;159;2.0
15;115;574;576;2;159;2.0
15;116;576;577;1;159;2.0
15;117;577;580;3;159;2.0
15;118;580;582;2;159;2.0
15;119;582;583;1;159;2.0
15;120;583;586;3;159;2.0
15;121;586;587;1;159;2.0
15;122;587;596;9;159;2.0
15;123;596;597;1;159;2.0
15;124;597;600;3;159;2.0
15;125;600;603;3;159;2.0
15;126;603;606;3;159;2.0
15;127;606;607;1;159;2.0
15;128;607;610;3;159;2.0
15;129;610;614;4;159;2.0
15;130;614;616;2;159;2.0
15;131;616;617;1;159;2.0
15;132;617;620;3;159;2.0
15;133;620;623;3;159;2.0
15;134;623;626;3;159;2.0
15;135;626;627;1;159;2.0
15;136;627;628;1;159;2.0
15;137;628;636;8;159;2.0
15;138;636;637;1;159;2.0
15;139;637;640;3;159;2.0
15;140;640;642;2;159;2.0
15;141;642;643;1;159;2.0
15;142;643;646;3;159;2.0
15;143;646;647;1;159;2.0
15;144;647;656;9;159;2.0
15;145;656;657;1;159;2.0
15;146;657;660;3;159;2.0
15;147;660;663;3;159;2.0
15;148;663;666;3;159;2.0
15;149;666;667;1;159;2.0
15;150;667;670;3;159;2.0
15;151;670;674;4;159;2.0
15;152;674;676;2;159;2.0
15;153;676;677;1;159;2.0
15;154;677;680;3;159;2.0
15;155;680;683;3;159;2.0
15;156;683;686;3;159;2.0
15;157;686;687;1;159;2.0
15;158;687;696;9;159;2.0
15;159;696;697;1;159;2.0
15;160;697;700;3;159;2.0
15;161;700;702;2;159;2.0
15;162;702;703;1;159;2.0
15;163;703;706;3;159;2.0
15;164;706;707;1;159;2.0
15;165;707;716;9;159;2.0
15;166;716;717;1;159;2.0
15;167;717;720;3;159;2.0
15;168;720;723;3;159;2.0
15;169;723;726;3;159;2.0
15;170;726;727;1;159;2.0
15;171;727;730;3;159;2.0
15;172;730;734;4;159;2.0
15;173;734;736;2;159;2.0
15;174;736;737;1;159;2.0
15;175;737;740;3;159;2.0
15;176;740;743;3;159;2.0
15;177;743;746;3;159;2.0
15;178;746;747;1;159;2.0
15;179;747;756;9;159;2.0
15;180;756;757;1;159;2.0
15;181;757;760;3;159;2.0
15;182;760;762;2;159;2.0
15;183;762;763;1;159;2.0
15;184;763;766;3;159;2.0
15;185;766;767;1;159;2.0
15;186;767;776;9;159;2.0
15;187;776;777;1;159;2.0
15;188;777;780;3;159;2.0
15;189;780;783;3;159;2.0
15;190;783;786;3;159;2.0
15;191;786;787;1;159;2.0
15;192;787;790;3;159;2.0
15;193;790;794;4;159;2.0
15;194;794;796;2;159;2.0
15;195;796;797;1;159;2.0
15;196;797;800;3;159;2.0
15;197;800;803;3;159;2.0
15;198;803;806;3;159;2.0
15;199;806;807;1;159;2.0
15;200;807;808;1;159;2.0
15;201;808;813;5;159;2.0
15;202;813;816;3;159;2.0
15;203;816;817;1;159;2.0
15;204;817;820;3;159;2.0
15;205;820;822;2;159;2.0
15;206;822;823;1;159;2.0
15;207;823;826;3;159;2.0
15;208;826;827;1;159;2.0
15;209;827;830;3;159;2.0
15;210;830;833;3;159;2.0
15;211;833;834;1;159;2.0
15;212;834;836;2;159;2.0
15;213;836;837;1;159;2.0
15;214;837;839;2;159;2.0
15;215;839;840;1;159;2.0
15;216;840;843;3;159;2.0
15;217;843;846;3;159;2.0
15;218;846;847;1;159;2.0
15;219;847;850;3;159;2.0
15;220;850;853;3;159;2.0
15;221;853;854;1;159;2.0
15;222;854;856;2;159;2.0
15;223;856;857;1;159;2.0
15;224;857;859;2;159;2.0
15;225;859;860;1;159;2.0
15;226;860;863;3;159;2.0
15;227;863;865;2;159;2.0
15;228;865;866;1;159;2.0
15;229;866;867;1;159;2.0
15;230;867;868;1;159;2.0
15;231;868;873;5;159;2.0
15;232;873;876;3;159;2.0
15;233;876;877;1;159;2.0
15;234;877;879;2;159;2.0
15;235;879;880;1;159;2.0
15;236;880;882;2;159;2.0
15;237;882;883;1;159;2.0
15;238;883;886;3;159;2.0
15;239;886;887;1;159;2.0
15;240;887;890;3;159;2.0
15;241;890;893;3;159;2.0
15;242;893;896;3;159;2.0
15;243;896;897;1;159;2.0
15;244;897;899;2;159;2.0
15;245;899;900;1;159;2.0
15;246;900;903;3;159;2.0
15;247;903;906;3;159;2.0
15;248;906;907;1;159;2.0
15;249;907;910;3;159;2.0
15;250;910;913;3;159;2.0
15;251;913;914;1;159;2.0
15;252;914;916;2;159;2.0
15;253;916;917;1;159;2.0
15;254;917;919;2;159;2.0
15;255;919;920;1;159;2.0
15;256;920;922;2;159;2.0
15;257;922;923;1;159;2.0
15;258;923;925;2;159;2.0
15;259;925;926;1;159;2.0
15;260;926;927;1;159;2.0
15;261;927;928;1;159;2.0
15;262;928;930;2;159;2.0
15;263;930;933;3;159;2.0
15;264;933;936;3;159;2.0
15;265;936;937;1;159;2.0
15;266;937;939;2;159;2.0
15;267;939;940;1;159;2.0
15;268;940;942;2;159;2.0
15;269;942;943;1;159;2.0
15;270;943;946;3;159;2.0
15;271;946;947;1;159;2.0
15;272;947;950;3;159;2.0
15;273;950;953;3;159;2.0
15;274;953;956;3;159;2.0
15;275;956;957;1;159;2.0
15;276;957;959;2;159;2.0
15;277;959;960;1;159;2.0
15;278;960;963;3;159;2.0
15;279;963;966;3;159;2.0
15;280;966;967;1;159;2.0
15;281;967;970;3;159;2.0
15;282;970;973;3;159;2.0
15;283;973;974;1;159;2.0
15;284;974;976;2;159;2.0
15;285;976;977;1;159;2.0
15;286;977;979;2;159;2.0
15;287;979;980;1;159;2.0
15;288;980;982;2;159;2.0
15;289;982;983;1;159;2.0
15;290;983;985;2;159;2.0
15;291;985;986;1;159;2.0
15;292;986;987;1;159;2.0
15;293;987;988;1;159;2.0
15;294;988;990;2;159;2.0
15;295;990;993;3;159;2.0
15;296;993;996;3;159;2.0
15;297;996;997;1;159;2.0
15;298;997;999;2;159;2.0
15;299;999;1000;1;159;2.0
15;300;1000;1003;3;159;2.0
15;301;1003;1005;2;159;2.0
15;302;1005;1006;1;159;2.0
15;303;1006;1007;1;159;2.0
15;304;1007;1010;3;159;2.0
15;305;1010;1013;3;159;2.0
15;306;1013;1016;3;159;2.0
15;307;1016;1017;1;159;2.0
15;308;1017;1019;2;159;2.0
15;309;1019;1020;1;159;2.0
15;310;1020;1023;3;159;2.0
15;311;1023;1025;2;159;2.0
15;312;1025;1026;1;159;2.0
15;313;1026;1027;1;159;2.0
15;314;1027;1033;6;159;2.0
15;315;1033;1034;1;159;2.0
15;316;1034;1035;1;159;2.0
15;317;1035;1036;1;159;2.0
15;318;1036;1039;3;159;2.0
15;319;1039;1042;3;159;2.0
15;320;1042;1045;3;159;2.0
15;321;1045;1046;1;159;2.0
15;322;1046;1047;1;159;2.0
15;323;1047;1048;1;159;2.0
15;324;1048;1050;2;159;2.0
15;325;1050;1056;6;159;2.0
15;326;1056;1057;1;159;2.0
15;327;1057;1059;2;159;2.0
15;328;1059;1063;4;159;2.0
15;329;1063;1065;2;159;2.0
15;330;1065;1066;1;159;2.0
15;331;1066;1067;1;159;2.0
15;332;1067;1072;5;159;2.0
15;333;1072;1076;4;159;2.0
15;334;1076;1077;1;159;2.0
15;335;1077;1078;1;159;2.0
15;336;1078;1079;1;159;2.0
15;337;1079;1080;1;159;2.0
15;338;1080;1086;6;159;2.0
15;339;1086;1087;1;159;2.0
15;340;1087;1089;2;159;2.0
15;341;1089;1093;4;159;2.0
15;342;1093;1094;1;159;2.0
15;343;1094;1095;1;159;2.0
15;344;1095;1096;1;159;2.0
15;345;1096;1099;3;159;2.0
15;346;1099;1102;3;159;2.0
15;347;1102;1106;4;159;2.0
15;348;1106;1107;1;159;2.0
15;349;1107;1108;1;159;2.0
15;350;1108;1110;2;159;2.0
15;351;1110;1117;7;159;2.0
15;352;1117;1119;2;159;2.0
15;353;1119;1122;3;159;2.0
15;354;1122;1123;1;159;2.0
15;355;1123;1124;1;159;2.0
15;356;1124;1125;1;159;2.0
15;357;1125;1127;2;159;2.0
15;358;1127;1128;1;159;2.0
15;359;1128;1132;4;159;2.0
15;360;1132;1135;3;159;2.0
15;361;1135;1137;2;159;2.0
15;362;1137;1138;1;159;2.0
15;363;1138;1144;6;159;2.0
15;364;1144;1146;2;159;2.0
15;365;1146;1147;1;159;2.0
15;366;1147;1149;2;159;2.0
15;367;1149;1150;1;159;2.0
15;368;1150;1157;7;159;2.0
15;369;1157;1158;1;159;2.0
15;370;1158;1159;1;159;2.0
15;371;1159;1163;4;159;2.0
15;372;1163;1165;2;159;2.0
15;373;1165;1167;2;159;2.0
15;374;1167;1169;2;159;2.0
15;375;1169;1170;1;159;2.0
15;376;1170;1174;4;159;2.0
15;377;1174;1177;3;159;2.0
15;378;1177;1180;3;159;2.0
15;379;1180;1187;7;159;2.0
15;380;1187;1188;1;159;2.0
15;381;1188;1194;6;159;2.0
15;382;1194;1195;1;159;2.0
15;383;1195;1197;2;159;2.0
15;384;1197;1200;3;159;2.0
15;385;1200;1206;6;159;2.0
15;386;1206;1212;6;159;2.0
15;387;1212;1214;2;159;2.0
15;388;1214;1215;1;159;2.0
15;389;1215;1217;2;159;2.0
15;390;1217;1219;2;159;2.0
15;391;1219;1220;1;159;2.0
15;392;1220;1228;8;159;2.0
15;393;1228;1232;4;159;2.0
15;394;1232;1234;2;159;2.0
15;395;1234;1240;6;159;2.0
15;396;1240;1242;2;159;2.0
15;397;1242;1245;3;159;2.0
15;398;1245;1250;5;159;2.0
15;399;1250;1254;4;159;2.0
15;400;1254;1257;3;159;2.0
15;401;1257;1267;10;159;2.0
15;402;1267;1270;3;159;2.0
15;403;1270;1279;9;159;2.0
15;404;1279;1282;3;159;2.0
15;405;1282;1286;4;159;2.0
15;406;1286;1289;3;159;2.0
15;407;1289;1290;1;159;2.0
15;408;1290;1292;2;159;2.0
15;409;1292;1295;3;159;2.0
15;410;1295;1303;8;159;2.0
15;411;1303;1304;1;159;2.0
15;412;1304;1309;5;159;2.0
15;413;1309;1315;6;159;2.0
15;414;1315;1317;2;159;2.0
15;415;1317;1320;3;159;2.0
15;416;1320;1324;4;159;2.0
15;417;1324;1328;4;159;2.0
15;418;1328;1329;1;159;2.0
15;419;1329;1330;1;159;2.0
15;420;1330;1337;7;159;2.0
15;421;1337;1340;3;159;2.0
15;422;1340;1347;7;159;2.0
15;423;1347;1353;6;159;2.0
15;424;1353;1354;1;159;2.0
15;425;1354;1356;2;159;2.0
15;426;1356;1360;4;159;2.0
15;427;1360;1365;5;159;2.0
15;428;1365;1367;2;159;2.0
15;429;1367;1381;14;159;2.0
15;430;1381;1382;1;159;2.0
15;431;1382;1392;10;159;2.0
15;432;1392;1399;7;159;2.0
15;433;1399;1414;15;159;2.0
15;434;1414;1429;15;159;2.0
15;435;1429;1444;15;159;2.0
15;436;1444;1459;15;159;2.0
15;437;1459;1474;15;159;2.0
15;438;1474;1489;15;159;2.0
15;439;1489;1504;15;159;2.0
15;440;1504;1519;15;159;2.0
15;441;1519;1534;15;159;2.0
15;442;1534;1549;15;159;2.0
15;443;1549;1564;15;159;2.0
15;444;1564;1579;15;159;2.0
15;445;1579;1594;15;159;2.0
15;446;1594;1609;15;159;2.0
15;447;1609;1624;15;159;2.0
15;448;1624;1639;15;159;2.0
15;449;1639;1654;15;159;2.0
15;450;1654;1680;26;159;2.0
16;0;247;333;86;14;2.0
16;1;333;338;5;14;2.0
16;2;338;343;5;14;2.0
16;3;343;345;2;14;2.0
16;4;345;346;1;14;2.0
16;5;346;348;2;14;2.0
16;6;348;353;5;14;2.0
16;7;353;355;2;14;2.0
16;8;355;357;2;14;2.0
16;9;357;358;1;14;2.0
16;10;358;361;3;14;2.0
16;11;361;363;2;14;2.0
16;12;363;366;3;14;2.0
16;13;366;368;2;14;2.0
16;14;368;373;5;14;2.0
16;15;373;374;1;14;2.0
16;16;374;375;1;14;2.0
16;17;375;376;1;14;2.0
16;18;376;381;5;14;2.0
16;19;381;382;1;14;2.0
16;20;382;383;1;14;2.0
16;21;383;386;3;14;2.0
16;22;386;387;1;14;2.0
16;23;387;388;1;14;2.0
16;24;388;391;3;14;2.0
16;25;391;392;1;14;2.0
16;26;392;395;3;14;2.0
16;27;395;396;1;14;2.0
16;28;396;398;2;14;2.0
16;29;398;401;3;14;2.0
16;30;401;402;1;14;2.0
16;31;402;406;4;14;2.0
16;32;406;407;1;14;2.0
16;33;407;411;4;14;2.0
16;34;411;412;1;14;2.0
16;35;412;413;1;14;2.0
16;36;413;415;2;14;2.0
16;37;415;416;1;14;2.0
16;38;416;418;2;14;2.0
16;39;418;421;3;14;2.0
16;40;421;422;1;14;2.0
16;41;422;423;1;14;2.0
16;42;423;426;3;14;2.0
16;43;426;427;1;14;2.0
16;44;427;431;4;14;2.0
16;45;431;432;1;14;2.0
16;46;432;433;1;14;2.0
16;47;433;435;2;14;2.0
16;48;435;436;1;14;2.0
16;49;436;441;5;14;2.0
16;50;441;442;1;14;2.0
16;51;442;443;1;14;2.0
16;52;443;446;3;14;2.0
16;53;446;447;1;14;2.0
16;54;447;448;1;14;2.0
16;55;448;451;3;14;2.0
16;56;451;452;1;14;2.0
16;57;452;455;3;14;2.0
16;58;455;456;1;14;2.0
16;59;456;458;2;14;2.0
16;60;458;461;3;14;2.0
16;61;461;462;1;14;2.0
16;62;462;463;1;14;2.0
16;63;463;466;3;14;2.0
16;64;466;467;1;14;2.0
16;65;467;471;4;14;2.0
16;66;471;472;1;14;2.0
16;67;472;473;1;14;2.0
16;68;473;475;2;14;2.0
16;69;475;476;1;14;2.0
16;70;476;478;2;14;2.0
16;71;478;481;3;14;2.0
16;72;481;482;1;14;2.0
16;73;482;483;1;14;2.0
16;74;483;486;3;14;2.0
16;75;486;487;1;14;2.0
16;76;487;491;4;14;2.0
16;77;491;492;1;14;2.0
16;78;492;493;1;14;2.0
16;79;493;495;2;14;2.0
16;80;495;496;1;14;2.0
16;81;496;501;5;14;2.0
16;82;501;503;2;14;2.0
16;83;503;507;4;14;2.0
16;84;507;511;4;14;2.0
16;85;511;512;1;14;2.0
16;86;512;515;3;14;2.0
16;87;515;516;1;14;2.0
16;88;516;521;5;14;2.0
16;89;521;523;2;14;2.0
16;90;523;527;4;14;2.0
16;91;527;528;1;14;2.0
16;92;528;531;3;14;2.0
16;93;531;532;1;14;2.0
16;94;532;535;3;14;2.0
16;95;535;536;1;14;2.0
16;96;536;538;2;14;2.0
16;97;538;541;3;14;2.0
16;98;541;546;5;14;2.0
16;99;546;547;1;14;2.0
16;100;547;551;4;14;2.0
16;101;551;552;1;14;2.0
16;102;552;555;3;14;2.0
16;103;555;561;6;14;2.0
16;104;561;562;1;14;2.0
16;105;562;563;1;14;2.0
16;106;563;566;3;14;2.0
16;107;566;567;1;14;2.0
16;108;567;571;4;14;2.0
16;109;571;572;1;14;2.0
16;110;572;575;3;14;2.0
16;111;575;576;1;14;2.0
16;112;576;581;5;14;2.0
16;113;581;586;5;14;2.0
16;114;586;587;1;14;2.0
16;115;587;591;4;14;2.0
16;116;591;592;1;14;2.0
16;117;592;595;3;14;2.0
16;118;595;598;3;14;2.0
16;119;598;601;3;14;2.0
16;120;601;603;2;14;2.0
16;121;603;606;3;14;2.0
16;122;606;607;1;14;2.0
16;123;607;611;4;14;2.0
16;124;611;612;1;14;2.0
16;125;612;615;3;14;2.0
16;126;615;616;1;14;2.0
16;127;616;621;5;14;2.0
16;128;621;622;1;14;2.0
16;129;622;626;4;14;2.0
16;130;626;627;1;14;2.0
16;131;627;631;4;14;2.0
16;132;631;632;1;14;2.0
16;133;632;635;3;14;2.0
16;134;635;636;1;14;2.0
16;135;636;641;5;14;2.0
16;136;641;646;5;14;2.0
16;137;646;647;1;14;2.0
16;138;647;651;4;14;2.0
16;139;651;652;1;14;2.0
16;140;652;655;3;14;2.0
16;141;655;658;3;14;2.0
16;142;658;661;3;14;2.0
16;143;661;663;2;14;2.0
16;144;663;666;3;14;2.0
16;145;666;667;1;14;2.0
16;146;667;671;4;14;2.0
16;147;671;672;1;14;2.0
16;148;672;675;3;14;2.0
16;149;675;676;1;14;2.0
16;150;676;681;5;14;2.0
16;151;681;686;5;14;2.0
16;152;686;687;1;14;2.0
16;153;687;691;4;14;2.0
16;154;691;692;1;14;2.0
16;155;692;695;3;14;2.0
16;156;695;696;1;14;2.0
16;157;696;701;5;14;2.0
16;158;701;706;5;14;2.0
16;159;706;707;1;14;2.0
16;160;707;711;4;14;2.0
16;161;711;712;1;14;2.0
16;162;712;715;3;14;2.0
16;163;715;718;3;14;2.0
16;164;718;721;3;14;2.0
16;165;721;723;2;14;2.0
16;166;723;726;3;14;2.0
16;167;726;727;1;14;2.0
16;168;727;731;4;14;2.0
16;169;731;732;1;14;2.0
16;170;732;735;3;14;2.0
16;171;735;736;1;14;2.0
16;172;736;741;5;14;2.0
16;173;741;746;5;14;2.0
16;174;746;747;1;14;2.0
16;175;747;751;4;14;2.0
16;176;751;752;1;14;2.0
16;177;752;755;3;14;2.0
16;178;755;756;1;14;2.0
16;179;756;761;5;14;2.0
16;180;761;766;5;14;2.0
16;181;766;767;1;14;2.0
16;182;767;771;4;14;2.0
16;183;771;772;1;14;2.0
16;184;772;775;3;14;2.0
16;185;775;778;3;14;2.0
16;186;778;781;3;14;2.0
16;187;781;783;2;14;2.0
16;188;783;786;3;14;2.0
16;189;786;787;1;14;2.0
16;190;787;791;4;14;2.0
16;191;791;792;1;14;2.0
16;192;792;795;3;14;2.0
16;193;795;796;1;14;2.0
16;194;796;801;5;14;2.0
16;195;801;802;1;14;2.0
16;196;802;806;4;14;2.0
16;197;806;807;1;14;2.0
16;198;807;811;4;14;2.0
16;199;811;812;1;14;2.0
16;200;812;815;3;14;2.0
16;201;815;816;1;14;2.0
16;202;816;818;2;14;2.0
16;203;818;821;3;14;2.0
16;204;821;822;1;14;2.0
16;205;822;823;1;14;2.0
16;206;823;826;3;14;2.0
16;207;826;827;1;14;2.0
16;208;827;831;4;14;2.0
16;209;831;832;1;14;2.0
16;210;832;833;1;14;2.0
16;211;833;835;2;14;2.0
16;212;835;838;3;14;2.0
16;213;838;841;3;14;2.0
16;214;841;842;1;14;2.0
16;215;842;843;1;14;2.0
16;216;843;846;3;14;2.0
16;217;846;847;1;14;2.0
16;218;847;851;4;14;2.0
16;219;851;852;1;14;2.0
16;220;852;853;1;14;2.0
16;221;853;855;2;14;2.0
16;222;855;856;1;14;2.0
16;223;856;859;3;14;2.0
16;224;859;861;2;14;2.0
16;225;861;862;1;14;2.0
16;226;862;866;4;14;2.0
16;227;866;867;1;14;2.0
16;228;867;871;4;14;2.0
16;229;871;872;1;14;2.0
16;230;872;873;1;14;2.0
16;231;873;875;2;14;2.0
16;232;875;876;1;14;2.0
16;233;876;878;2;14;2.0
16;234;878;881;3;14;2.0
16;235;881;882;1;14;2.0
16;236;882;886;4;14;2.0
16;237;886;887;1;14;2.0
16;238;887;891;4;14;2.0
16;239;891;892;1;14;2.0
16;240;892;893;1;14;2.0
16;241;893;895;2;14;2.0
16;242;895;896;1;14;2.0
16;243;896;898;2;14;2.0
16;244;898;901;3;14;2.0
16;245;901;902;1;14;2.0
16;246;902;903;1;14;2.0
16;247;903;906;3;14;2.0
16;248;906;907;1;14;2.0
16;249;907;911;4;14;2.0
16;250;911;912;1;14;2.0
16;251;912;913;1;14;2.0
16;252;913;915;2;14;2.0
16;253;915;916;1;14;2.0
16;254;916;921;5;14;2.0
16;255;921;922;1;14;2.0
16;256;922;926;4;14;2.0
16;257;926;927;1;14;2.0
16;258;927;931;4;14;2.0
16;259;931;932;1;14;2.0
16;260;932;933;1;14;2.0
16;261;933;935;2;14;2.0
16;262;935;936;1;14;2.0
16;263;936;938;2;14;2.0
16;264;938;941;3;14;2.0
16;265;941;942;1;14;2.0
16;266;942;946;4;14;2.0
16;267;946;947;1;14;2.0
16;268;947;951;4;14;2.0
16;269;951;952;1;14;2.0
16;270;952;953;1;14;2.0
16;271;953;955;2;14;2.0
16;272;955;956;1;14;2.0
16;273;956;958;2;14;2.0
16;274;958;961;3;14;2.0
16;275;961;962;1;14;2.0
16;276;962;963;1;14;2.0
16;277;963;966;3;14;2.0
16;278;966;967;1;14;2.0
16;279;967;971;4;14;2.0
16;280;971;972;1;14;2.0
16;281;972;973;1;14;2.0
16;282;973;975;2;14;2.0
16;283;975;976;1;14;2.0
16;284;976;981;5;14;2.0
16;285;981;982;1;14;2.0
16;286;982;986;4;14;2.0
16;287;986;987;1;14;2.0
16;288;987;991;4;14;2.0
16;289;991;992;1;14;2.0
16;290;992;993;1;14;2.0
16;291;993;995;2;14;2.0
16;292;995;996;1;14;2.0
16;293;996;999;3;14;2.0
16;294;999;1001;2;14;2.0
16;295;1001;1002;1;14;2.0
16;296;1002;1006;4;14;2.0
16;297;1006;1007;1;14;2.0
16;298;1007;1011;4;14;2.0
16;299;1011;1012;1;14;2.0
16;300;1012;1013;1;14;2.0
16;301;1013;1015;2;14;2.0
16;302;1015;1016;1;14;2.0
16;303;1016;1021;5;14;2.0
16;304;1021;1022;1;14;2.0
16;305;1022;1023;1;14;2.0
16;306;1023;1026;3;14;2.0
16;307;1026;1027;1;14;2.0
16;308;1027;1031;4;14;2.0
16;309;1031;1033;2;14;2.0
16;310;1033;1035;2;14;2.0
16;311;1035;1036;1;14;2.0
16;312;1036;1037;1;14;2.0
16;313;1037;1041;4;14;2.0
16;314;1041;1046;5;14;2.0
16;315;1046;1047;1;14;2.0
16;316;1047;1051;4;14;2.0
16;317;1051;1052;1;14;2.0
16;318;1052;1053;1;14;2.0
16;319;1053;1055;2;14;2.0
16;320;1055;1056;1;14;2.0
16;321;1056;1061;5;14;2.0
16;322;1061;1067;6;14;2.0
16;323;1067;1071;4;14;2.0
16;324;1071;1073;2;14;2.0
16;325;1073;1075;2;14;2.0
16;326;1075;1076;1;14;2.0
16;327;1076;1077;1;14;2.0
16;328;1077;1081;4;14;2.0
16;329;1081;1082;1;14;2.0
16;330;1082;1083;1;14;2.0
16;331;1083;1086;3;14;2.0
16;332;1086;1087;1;14;2.0
16;333;1087;1091;4;14;2.0
16;334;1091;1093;2;14;2.0
16;335;1093;1095;2;14;2.0
16;336;1095;1096;1;14;2.0
16;337;1096;1097;1;14;2.0
16;338;1097;1101;4;14;2.0
16;339;1101;1106;5;14;2.0
16;340;1106;1112;6;14;2.0
16;341;1112;1113;1;14;2.0
16;342;1113;1115;2;14;2.0
16;343;1115;1116;1;14;2.0
16;344;1116;1117;1;14;2.0
16;345;1117;1121;4;14;2.0
16;346;1121;1124;3;14;2.0
16;347;1124;1128;4;14;2.0
16;348;1128;1132;4;14;2.0
16;349;1132;1133;1;14;2.0
16;350;1133;1134;1;14;2.0
16;351;1134;1139;5;14;2.0
16;352;1139;1140;1;14;2.0
16;353;1140;1141;1;14;2.0
16;354;1141;1147;6;14;2.0
16;355;1147;1148;1;14;2.0
16;356;1148;1152;4;14;2.0
16;357;1152;1154;2;14;2.0
16;358;1154;1160;6;14;2.0
16;359;1160;1161;1;14;2.0
16;360;1161;1163;2;14;2.0
16;361;1163;1168;5;14;2.0
16;362;1168;1169;1;14;2.0
16;363;1169;1174;5;14;2.0
16;364;1174;1177;3;14;2.0
16;365;1177;1181;4;14;2.0
16;366;1181;1183;2;14;2.0
16;367;1183;1185;2;14;2.0
16;368;1185;1188;3;14;2.0
16;369;1188;1189;1;14;2.0
16;370;1189;1194;5;14;2.0
16;371;1194;1203;9;14;2.0
16;372;1203;1204;1;14;2.0
16;373;1204;1206;2;14;2.0
16;374;1206;1208;2;14;2.0
16;375;1208;1209;1;14;2.0
16;376;1209;1210;1;14;2.0
16;377;1210;1217;7;14;2.0
16;378;1217;1223;6;14;2.0
16;379;1223;1226;3;14;2.0
16;380;1226;1233;7;14;2.0
16;381;1233;1234;1;14;2.0
16;382;1234;1235;1;14;2.0
16;383;1235;1239;4;14;2.0
16;384;1239;1243;4;14;2.0
16;385;1243;1245;2;14;2.0
16;386;1245;1251;6;14;2.0
16;387;1251;1258;7;14;2.0
16;388;1258;1259;1;14;2.0
16;389;1259;1260;1;14;2.0
16;390;1260;1268;8;14;2.0
16;391;1268;1274;6;14;2.0
16;392;1274;1276;2;14;2.0
16;393;1276;1279;3;14;2.0
16;394;1279;1280;1;14;2.0
16;395;1280;1283;3;14;2.0
16;396;1283;1284;1;14;2.0
16;397;1284;1292;8;14;2.0
16;398;1292;1293;1;14;2.0
16;399;1293;1303;10;14;2.0
16;400;1303;1308;5;14;2.0
16;401;1308;1309;1;14;2.0
16;402;1309;1315;6;14;2.0
16;403;1315;1317;2;14;2.0
16;404;1317;1318;1;14;2.0
16;405;1318;1319;1;14;2.0
16;406;1319;1329;10;14;2.0
16;407;1329;1331;2;14;2.0
16;408;1331;1338;7;14;2.0
16;409;1338;1342;4;14;2.0
16;410;1342;1343;1;14;2.0
16;411;1343;1346;3;14;2.0
16;412;1346;1349;3;14;2.0
16;413;1349;1354;5;14;2.0
16;414;1354;1358;4;14;2.0
16;415;1358;1361;3;14;2.0
16;416;1361;1370;9;14;2.0
16;417;1370;1371;1;14;2.0
16;418;1371;1373;2;14;2.0
16;419;1373;1386;13;14;2.0
16;420;1386;1388;2;14;2.0
16;421;1388;1403;15;14;2.0
16;422;1403;1418;15;14;2.0
16;423;1418;1433;15;14;2.0
16;424;1433;1448;15;14;2.0
16;425;1448;1463;15;14;2.0
16;426;1463;1478;15;14;2.0
16;427;1478;1493;15;14;2.0
16;428;1493;1508;15;14;2.0
16;429;1508;1523;15;14;2.0
16;430;1523;1538;15;14;2.0
16;431;1538;1553;15;14;2.0
16;432;1553;1568;15;14;2.0
16;433;1568;1583;15;14;2.0
16;434;1583;1598;15;14;2.0
16;435;1598;1613;15;14;2.0
16;436;1613;1628;15;14;2.0
16;437;1628;1643;15;14;2.0
16;438;1643;1658;15;14;2.0
16;439;1658;1680;22;14;2.0
17;0;252;337;85;99;2.0
17;1;337;342;5;99;2.0
17;2;342;346;4;99;2.0
17;3;346;349;3;99;2.0
17;4;349;350;1;99;2.0
17;5;350;351;1;99;2.0
17;6;351;357;6;99;2.0
17;7;357;358;1;99;2.0
17;8;358;359;1;99;2.0
17;9;359;360;1;99;2.0
17;10;360;363;3;99;2.0
17;11;363;364;1;99;2.0
17;12;364;365;1;99;2.0
17;13;365;367;2;99;2.0
17;14;367;369;2;99;2.0
17;15;369;372;3;99;2.0
17;16;372;376;4;99;2.0
17;17;376;378;2;99;2.0
17;18;378;379;1;99;2.0
17;19;379;384;5;99;2.0
17;20;384;386;2;99;2.0
17;21;386;387;1;99;2.0
17;22;387;390;3;99;2.0
17;23;390;393;3;99;2.0
17;24;393;394;1;99;2.0
17;25;394;396;2;99;2.0
17;26;396;399;3;99;2.0
17;27;399;400;1;99;2.0
17;28;400;401;1;99;2.0
17;29;401;404;3;99;2.0
17;30;404;406;2;99;2.0
17;31;406;410;4;99;2.0
17;32;410;414;4;99;2.0
17;33;414;416;2;99;2.0
17;34;416;417;1;99;2.0
17;35;417;419;2;99;2.0
17;36;419;420;1;99;2.0
17;37;420;423;3;99;2.0
17;38;423;424;1;99;2.0
17;39;424;425;1;99;2.0
17;40;425;426;1;99;2.0
17;41;426;427;1;99;2.0
17;42;427;429;2;99;2.0
17;43;429;430;1;99;2.0
17;44;430;434;4;99;2.0
17;45;434;436;2;99;2.0
17;46;436;437;1;99;2.0
17;47;437;439;2;99;2.0
17;48;439;440;1;99;2.0
17;49;440;444;4;99;2.0
17;50;444;446;2;99;2.0
17;51;446;449;3;99;2.0
17;52;449;450;1;99;2.0
17;53;450;453;3;99;2.0
17;54;453;454;1;99;2.0
17;55;454;456;2;99;2.0
17;56;456;459;3;99;2.0
17;57;459;460;1;99;2.0
17;58;460;461;1;99;2.0
17;59;461;464;3;99;2.0
17;60;464;466;2;99;2.0
17;61;466;467;1;99;2.0
17;62;467;470;3;99;2.0
17;63;470;474;4;99;2.0
17;64;474;476;2;99;2.0
17;65;476;477;1;99;2.0
17;66;477;479;2;99;2.0
17;67;479;480;1;99;2.0
17;68;480;483;3;99;2.0
17;69;483;484;1;99;2.0
17;70;484;485;1;99;2.0
17;71;485;486;1;99;2.0
17;72;486;487;1;99;2.0
17;73;487;489;2;99;2.0
17;74;489;490;1;99;2.0
17;75;490;494;4;99;2.0
17;76;494;496;2;99;2.0
17;77;496;499;3;99;2.0
17;78;499;500;1;99;2.0
17;79;500;504;4;99;2.0
17;80;504;506;2;99;2.0
17;81;506;507;1;99;2.0
17;82;507;510;3;99;2.0
17;83;510;514;4;99;2.0
17;84;514;515;1;99;2.0
17;85;515;516;1;99;2.0
17;86;516;519;3;99;2.0
17;87;519;524;5;99;2.0
17;88;524;527;3;99;2.0
17;89;527;530;3;99;2.0
17;90;530;532;2;99;2.0
17;91;532;534;2;99;2.0
17;92;534;536;2;99;2.0
17;93;536;539;3;99;2.0
17;94;539;540;1;99;2.0
17;95;540;543;3;99;2.0
17;96;543;544;1;99;2.0
17;97;544;550;6;99;2.0
17;98;550;554;4;99;2.0
17;99;554;556;2;99;2.0
17;100;556;559;3;99;2.0
17;101;559;564;5;99;2.0
17;102;564;565;1;99;2.0
17;103;565;567;2;99;2.0
17;104;567;570;3;99;2.0
17;105;570;574;4;99;2.0
17;106;574;576;2;99;2.0
17;107;576;579;3;99;2.0
17;108;579;580;1;99;2.0
17;109;580;584;4;99;2.0
17;110;584;590;6;99;2.0
17;111;590;594;4;99;2.0
17;112;594;596;2;99;2.0
17;113;596;599;3;99;2.0
17;114;599;603;4;99;2.0
17;115;603;604;1;99;2.0
17;116;604;607;3;99;2.0
17;117;607;610;3;99;2.0
17;118;610;614;4;99;2.0
17;119;614;616;2;99;2.0
17;120;616;619;3;99;2.0
17;121;619;620;1;99;2.0
17;122;620;624;4;99;2.0
17;123;624;625;1;99;2.0
17;124;625;630;5;99;2.0
17;125;630;634;4;99;2.0
17;126;634;636;2;99;2.0
17;127;636;639;3;99;2.0
17;128;639;640;1;99;2.0
17;129;640;644;4;99;2.0
17;130;644;650;6;99;2.0
17;131;650;654;4;99;2.0
17;132;654;656;2;99;2.0
17;133;656;659;3;99;2.0
17;134;659;663;4;99;2.0
17;135;663;664;1;99;2.0
17;136;664;667;3;99;2.0
17;137;667;670;3;99;2.0
17;138;670;674;4;99;2.0
17;139;674;676;2;99;2.0
17;140;676;679;3;99;2.0
17;141;679;680;1;99;2.0
17;142;680;684;4;99;2.0
17;143;684;690;6;99;2.0
17;144;690;694;4;99;2.0
17;145;694;696;2;99;2.0
17;146;696;699;3;99;2.0
17;147;699;700;1;99;2.0
17;148;700;704;4;99;2.0
17;149;704;710;6;99;2.0
17;150;710;714;4;99;2.0
17;151;714;716;2;99;2.0
17;152;716;719;3;99;2.0
17;153;719;723;4;99;2.0
17;154;723;724;1;99;2.0
17;155;724;727;3;99;2.0
17;156;727;730;3;99;2.0
17;157;730;734;4;99;2.0
17;158;734;736;2;99;2.0
17;159;736;739;3;99;2.0
17;160;739;740;1;99;2.0
17;161;740;744;4;99;2.0
17;162;744;750;6;99;2.0
17;163;750;754;4;99;2.0
17;164;754;756;2;99;2.0
17;165;756;759;3;99;2.0
17;166;759;760;1;99;2.0
17;167;760;764;4;99;2.0
17;168;764;770;6;99;2.0
17;169;770;774;4;99;2.0
17;170;774;776;2;99;2.0
17;171;776;779;3;99;2.0
17;172;779;783;4;99;2.0
17;173;783;784;1;99;2.0
17;174;784;787;3;99;2.0
17;175;787;790;3;99;2.0
17;176;790;794;4;99;2.0
17;177;794;796;2;99;2.0
17;178;796;799;3;99;2.0
17;179;799;800;1;99;2.0
17;180;800;804;4;99;2.0
17;181;804;805;1;99;2.0
17;182;805;806;1;99;2.0
17;183;806;810;4;99;2.0
17;184;810;814;4;99;2.0
17;185;814;816;2;99;2.0
17;186;816;819;3;99;2.0
17;187;819;823;4;99;2.0
17;188;823;824;1;99;2.0
17;189;824;826;2;99;2.0
17;190;826;827;1;99;2.0
17;191;827;830;3;99;2.0
17;192;830;834;4;99;2.0
17;193;834;836;2;99;2.0
17;194;836;839;3;99;2.0
17;195;839;843;4;99;2.0
17;196;843;844;1;99;2.0
17;197;844;846;2;99;2.0
17;198;846;847;1;99;2.0
17;199;847;850;3;99;2.0
17;200;850;854;4;99;2.0
17;201;854;856;2;99;2.0
17;202;856;858;2;99;2.0
17;203;858;859;1;99;2.0
17;204;859;860;1;99;2.0
17;205;860;862;2;99;2.0
17;206;862;864;2;99;2.0
17;207;864;865;1;99;2.0
17;208;865;866;1;99;2.0
17;209;866;870;4;99;2.0
17;210;870;874;4;99;2.0
17;211;874;876;2;99;2.0
17;212;876;879;3;99;2.0
17;213;879;880;1;99;2.0
17;214;880;883;3;99;2.0
17;215;883;884;1;99;2.0
17;216;884;886;2;99;2.0
17;217;886;890;4;99;2.0
17;218;890;894;4;99;2.0
17;219;894;896;2;99;2.0
17;220;896;899;3;99;2.0
17;221;899;900;1;99;2.0
17;222;900;903;3;99;2.0
17;223;903;904;1;99;2.0
17;224;904;906;2;99;2.0
17;225;906;907;1;99;2.0
17;226;907;910;3;99;2.0
17;227;910;914;4;99;2.0
17;228;914;916;2;99;2.0
17;229;916;918;2;99;2.0
17;230;918;919;1;99;2.0
17;231;919;920;1;99;2.0
17;232;920;924;4;99;2.0
17;233;924;925;1;99;2.0
17;234;925;926;1;99;2.0
17;235;926;930;4;99;2.0
17;236;930;934;4;99;2.0
17;237;934;936;2;99;2.0
17;238;936;939;3;99;2.0
17;239;939;940;1;99;2.0
17;240;940;943;3;99;2.0
17;241;943;944;1;99;2.0
17;242;944;946;2;99;2.0
17;243;946;950;4;99;2.0
17;244;950;954;4;99;2.0
17;245;954;956;2;99;2.0
17;246;956;959;3;99;2.0
17;247;959;960;1;99;2.0
17;248;960;963;3;99;2.0
17;249;963;964;1;99;2.0
17;250;964;966;2;99;2.0
17;251;966;967;1;99;2.0
17;252;967;970;3;99;2.0
17;253;970;974;4;99;2.0
17;254;974;976;2;99;2.0
17;255;976;978;2;99;2.0
17;256;978;979;1;99;2.0
17;257;979;980;1;99;2.0
17;258;980;984;4;99;2.0
17;259;984;985;1;99;2.0
17;260;985;986;1;99;2.0
17;261;986;990;4;99;2.0
17;262;990;994;4;99;2.0
17;263;994;996;2;99;2.0
17;264;996;999;3;99;2.0
17;265;999;1000;1;99;2.0
17;266;1000;1002;2;99;2.0
17;267;1002;1004;2;99;2.0
17;268;1004;1006;2;99;2.0
17;269;1006;1010;4;99;2.0
17;270;1010;1014;4;99;2.0
17;271;1014;1016;2;99;2.0
17;272;1016;1018;2;99;2.0
17;273;1018;1019;1;99;2.0
17;274;1019;1020;1;99;2.0
17;275;1020;1024;4;99;2.0
17;276;1024;1026;2;99;2.0
17;277;1026;1027;1;99;2.0
17;278;1027;1029;2;99;2.0
17;279;1029;1030;1;99;2.0
17;280;1030;1035;5;99;2.0
17;281;1035;1036;1;99;2.0
17;282;1036;1038;2;99;2.0
17;283;1038;1039;1;99;2.0
17;284;1039;1040;1;99;2.0
17;285;1040;1041;1;99;2.0
17;286;1041;1044;3;99;2.0
17;287;1044;1050;6;99;2.0
17;288;1050;1054;4;99;2.0
17;289;1054;1056;2;99;2.0
17;290;1056;1059;3;99;2.0
17;291;1059;1060;1;99;2.0
17;292;1060;1064;4;99;2.0
17;293;1064;1065;1;99;2.0
17;294;1065;1070;5;99;2.0
17;295;1070;1071;1;99;2.0
17;296;1071;1074;3;99;2.0
17;297;1074;1076;2;99;2.0
17;298;1076;1079;3;99;2.0
17;299;1079;1080;1;99;2.0
17;300;1080;1082;2;99;2.0
17;301;1082;1084;2;99;2.0
17;302;1084;1086;2;99;2.0
17;303;1086;1087;1;99;2.0
17;304;1087;1089;2;99;2.0
17;305;1089;1090;1;99;2.0
17;306;1090;1095;5;99;2.0
17;307;1095;1096;1;99;2.0
17;308;1096;1099;3;99;2.0
17;309;1099;1100;1;99;2.0
17;310;1100;1101;1;99;2.0
17;311;1101;1104;3;99;2.0
17;312;1104;1110;6;99;2.0
17;313;1110;1116;6;99;2.0
17;314;1116;1118;2;99;2.0
17;315;1118;1119;1;99;2.0
17;316;1119;1121;2;99;2.0
17;317;1121;1124;3;99;2.0
17;318;1124;1125;1;99;2.0
17;319;1125;1128;3;99;2.0
17;320;1128;1131;3;99;2.0
17;321;1131;1135;4;99;2.0
17;322;1135;1137;2;99;2.0
17;323;1137;1139;2;99;2.0
17;324;1139;1143;4;99;2.0
17;325;1143;1144;1;99;2.0
17;326;1144;1151;7;99;2.0
17;327;1151;1152;1;99;2.0
17;328;1152;1156;4;99;2.0
17;329;1156;1158;2;99;2.0
17;330;1158;1163;5;99;2.0
17;331;1163;1164;1;99;2.0
17;332;1164;1167;3;99;2.0
17;333;1167;1171;4;99;2.0
17;334;1171;1173;2;99;2.0
17;335;1173;1177;4;99;2.0
17;336;1177;1181;4;99;2.0
17;337;1181;1184;3;99;2.0
17;338;1184;1187;3;99;2.0
17;339;1187;1188;1;99;2.0
17;340;1188;1189;1;99;2.0
17;341;1189;1191;2;99;2.0
17;342;1191;1193;2;99;2.0
17;343;1193;1199;6;99;2.0
17;344;1199;1207;8;99;2.0
17;345;1207;1208;1;99;2.0
17;346;1208;1209;1;99;2.0
17;347;1209;1211;2;99;2.0
17;348;1211;1213;2;99;2.0
17;349;1213;1221;8;99;2.0
17;350;1221;1227;6;99;2.0
17;351;1227;1229;2;99;2.0
17;352;1229;1236;7;99;2.0
17;353;1236;1237;1;99;2.0
17;354;1237;1238;1;99;2.0
17;355;1238;1239;1;99;2.0
17;356;1239;1243;4;99;2.0
17;357;1243;1247;4;99;2.0
17;358;1247;1248;1;99;2.0
17;359;1248;1254;6;99;2.0
17;360;1254;1261;7;99;2.0
17;361;1261;1263;2;99;2.0
17;362;1263;1264;1;99;2.0
17;363;1264;1272;8;99;2.0
17;364;1272;1279;7;99;2.0
17;365;1279;1283;4;99;2.0
17;366;1283;1286;3;99;2.0
17;367;1286;1288;2;99;2.0
17;368;1288;1296;8;99;2.0
17;369;1296;1297;1;99;2.0
17;370;1297;1306;9;99;2.0
17;371;1306;1311;5;99;2.0
17;372;1311;1312;1;99;2.0
17;373;1312;1313;1;99;2.0
17;374;1313;1318;5;99;2.0
17;375;1318;1321;3;99;2.0
17;376;1321;1322;1;99;2.0
17;377;1322;1323;1;99;2.0
17;378;1323;1333;10;99;2.0
17;379;1333;1334;1;99;2.0
17;380;1334;1341;7;99;2.0
17;381;1341;1346;5;99;2.0
17;382;1346;1347;1;99;2.0
17;383;1347;1349;2;99;2.0
17;384;1349;1353;4;99;2.0
17;385;1353;1358;5;99;2.0
17;386;1358;1361;3;99;2.0
17;387;1361;1364;3;99;2.0
17;388;1364;1374;10;99;2.0
17;389;1374;1375;1;99;2.0
17;390;1375;1376;1;99;2.0
17;391;1376;1389;13;99;2.0
17;392;1389;1392;3;99;2.0
17;393;1392;1407;15;99;2.0
17;394;1407;1422;15;99;2.0
17;395;1422;1437;15;99;2.0
17;396;1437;1452;15;99;2.0
17;397;1452;1467;15;99;2.0
17;398;1467;1482;15;99;2.0
17;399;1482;1497;15;99;2.0
17;400;1497;1512;15;99;2.0
17;401;1512;1527;15;99;2.0
17;402;1527;1542;15;99;2.0
17;403;1542;1557;15;99;2.0
17;404;1557;1572;15;99;2.0
17;405;1572;1587;15;99;2.0
17;406;1587;1602;15;99;2.0
17;407;1602;1617;15;99;2.0
17;408;1617;1632;15;99;2.0
17;409;1632;1647;15;99;2.0
17;410;1647;1662;15;99;2.0
17;411;1662;1680;18;99;2.0
18;0;246;327;81;501;2.0
18;1;327;332;5;501;2.0
18;2;332;338;6;501;2.0
18;3;338;339;1;501;2.0
18;4;339;340;1;501;2.0
18;5;340;343;3;501;2.0
18;6;343;346;3;501;2.0
18;7;346;347;1;501;2.0
18;8;347;348;1;501;2.0
18;9;348;349;1;501;2.0
18;10;349;353;4;501;2.0
18;11;353;354;1;501;2.0
18;12;354;355;1;501;2.0
18;13;355;356;1;501;2.0
18;14;356;357;1;501;2.0
18;15;357;362;5;501;2.0
18;16;362;366;4;501;2.0
18;17;366;368;2;501;2.0
18;18;368;369;1;501;2.0
18;19;369;373;4;501;2.0
18;20;373;376;3;501;2.0
18;21;376;377;1;501;2.0
18;22;377;379;2;501;2.0
18;23;379;380;1;501;2.0
18;24;380;381;1;501;2.0
18;25;381;383;2;501;2.0
18;26;383;384;1;501;2.0
18;27;384;386;2;501;2.0
18;28;386;389;3;501;2.0
18;29;389;390;1;501;2.0
18;30;390;393;3;501;2.0
18;31;393;396;3;501;2.0
18;32;396;398;2;501;2.0
18;33;398;399;1;501;2.0
18;34;399;400;1;501;2.0
18;35;400;403;3;501;2.0
18;36;403;406;3;501;2.0
18;37;406;407;1;501;2.0
18;38;407;409;2;501;2.0
18;39;409;410;1;501;2.0
18;40;410;413;3;501;2.0
18;41;413;414;1;501;2.0
18;42;414;416;2;501;2.0
18;43;416;417;1;501;2.0
18;44;417;419;2;501;2.0
18;45;419;420;1;501;2.0
18;46;420;423;3;501;2.0
18;47;423;426;3;501;2.0
18;48;426;427;1;501;2.0
18;49;427;429;2;501;2.0
18;50;429;430;1;501;2.0
18;51;430;433;3;501;2.0
18;52;433;436;3;501;2.0
18;53;436;439;3;501;2.0
18;54;439;440;1;501;2.0
18;55;440;443;3;501;2.0
18;56;443;444;1;501;2.0
18;57;444;446;2;501;2.0
18;58;446;449;3;501;2.0
18;59;449;450;1;501;2.0
18;60;450;453;3;501;2.0
18;61;453;456;3;501;2.0
18;62;456;457;1;501;2.0
18;63;457;458;1;501;2.0
18;64;458;459;1;501;2.0
18;65;459;460;1;501;2.0
18;66;460;461;1;501;2.0
18;67;461;463;2;501;2.0
18;68;463;466;3;501;2.0
18;69;466;467;1;501;2.0
18;70;467;469;2;501;2.0
18;71;469;470;1;501;2.0
18;72;470;473;3;501;2.0
18;73;473;474;1;501;2.0
18;74;474;476;2;501;2.0
18;75;476;477;1;501;2.0
18;76;477;479;2;501;2.0
18;77;479;480;1;501;2.0
18;78;480;483;3;501;2.0
18;79;483;486;3;501;2.0
18;80;486;489;3;501;2.0
18;81;489;490;1;501;2.0
18;82;490;492;2;501;2.0
18;83;492;493;1;501;2.0
18;84;493;496;3;501;2.0
18;85;496;497;1;501;2.0
18;86;497;499;2;501;2.0
18;87;499;503;4;501;2.0
18;88;503;505;2;501;2.0
18;89;505;506;1;501;2.0
18;90;506;509;3;501;2.0
18;91;509;513;4;501;2.0
18;92;513;516;3;501;2.0
18;93;516;517;1;501;2.0
18;94;517;519;2;501;2.0
18;95;519;521;2;501;2.0
18;96;521;522;1;501;2.0
18;97;522;523;1;501;2.0
18;98;523;526;3;501;2.0
18;99;526;529;3;501;2.0
18;100;529;534;5;501;2.0
18;101;534;539;5;501;2.0
18;102;539;540;1;501;2.0
18;103;540;541;1;501;2.0
18;104;541;543;2;501;2.0
18;105;543;546;3;501;2.0
18;106;546;549;3;501;2.0
18;107;549;557;8;501;2.0
18;108;557;559;2;501;2.0
18;109;559;560;1;501;2.0
18;110;560;561;1;501;2.0
18;111;561;563;2;501;2.0
18;112;563;566;3;501;2.0
18;113;566;569;3;501;2.0
18;114;569;576;7;501;2.0
18;115;576;579;3;501;2.0
18;116;579;580;1;501;2.0
18;117;580;581;1;501;2.0
18;118;581;583;2;501;2.0
18;119;583;586;3;501;2.0
18;120;586;589;3;501;2.0
18;121;589;594;5;501;2.0
18;122;594;597;3;501;2.0
18;123;597;599;2;501;2.0
18;124;599;600;1;501;2.0
18;125;600;601;1;501;2.0
18;126;601;603;2;501;2.0
18;127;603;606;3;501;2.0
18;128;606;609;3;501;2.0
18;129;609;619;10;501;2.0
18;130;619;620;1;501;2.0
18;131;620;621;1;501;2.0
18;132;621;623;2;501;2.0
18;133;623;626;3;501;2.0
18;134;626;629;3;501;2.0
18;135;629;636;7;501;2.0
18;136;636;639;3;501;2.0
18;137;639;640;1;501;2.0
18;138;640;641;1;501;2.0
18;139;641;643;2;501;2.0
18;140;643;646;3;501;2.0
18;141;646;649;3;501;2.0
18;142;649;654;5;501;2.0
18;143;654;657;3;501;2.0
18;144;657;659;2;501;2.0
18;145;659;660;1;501;2.0
18;146;660;661;1;501;2.0
18;147;661;663;2;501;2.0
18;148;663;666;3;501;2.0
18;149;666;669;3;501;2.0
18;150;669;679;10;501;2.0
18;151;679;680;1;501;2.0
18;152;680;681;1;501;2.0
18;153;681;683;2;501;2.0
18;154;683;686;3;501;2.0
18;155;686;689;3;501;2.0
18;156;689;696;7;501;2.0
18;157;696;699;3;501;2.0
18;158;699;700;1;501;2.0
18;159;700;701;1;501;2.0
18;160;701;703;2;501;2.0
18;161;703;706;3;501;2.0
18;162;706;709;3;501;2.0
18;163;709;714;5;501;2.0
18;164;714;717;3;501;2.0
18;165;717;719;2;501;2.0
18;166;719;720;1;501;2.0
18;167;720;721;1;501;2.0
18;168;721;723;2;501;2.0
18;169;723;726;3;501;2.0
18;170;726;729;3;501;2.0
18;171;729;739;10;501;2.0
18;172;739;740;1;501;2.0
18;173;740;741;1;501;2.0
18;174;741;743;2;501;2.0
18;175;743;746;3;501;2.0
18;176;746;749;3;501;2.0
18;177;749;756;7;501;2.0
18;178;756;759;3;501;2.0
18;179;759;760;1;501;2.0
18;180;760;761;1;501;2.0
18;181;761;763;2;501;2.0
18;182;763;766;3;501;2.0
18;183;766;769;3;501;2.0
18;184;769;774;5;501;2.0
18;185;774;777;3;501;2.0
18;186;777;779;2;501;2.0
18;187;779;780;1;501;2.0
18;188;780;781;1;501;2.0
18;189;781;783;2;501;2.0
18;190;783;786;3;501;2.0
18;191;786;789;3;501;2.0
18;192;789;796;7;501;2.0
18;193;796;799;3;501;2.0
18;194;799;800;1;501;2.0
18;195;800;801;1;501;2.0
18;196;801;803;2;501;2.0
18;197;803;806;3;501;2.0
18;198;806;809;3;501;2.0
18;199;809;814;5;501;2.0
18;200;814;816;2;501;2.0
18;201;816;817;1;501;2.0
18;202;817;819;2;501;2.0
18;203;819;820;1;501;2.0
18;204;820;821;1;501;2.0
18;205;821;823;2;501;2.0
18;206;823;826;3;501;2.0
18;207;826;829;3;501;2.0
18;208;829;833;4;501;2.0
18;209;833;834;1;501;2.0
18;210;834;836;2;501;2.0
18;211;836;837;1;501;2.0
18;212;837;839;2;501;2.0
18;213;839;840;1;501;2.0
18;214;840;841;1;501;2.0
18;215;841;843;2;501;2.0
18;216;843;846;3;501;2.0
18;217;846;849;3;501;2.0
18;218;849;850;1;501;2.0
18;219;850;853;3;501;2.0
18;220;853;856;3;501;2.0
18;221;856;859;3;501;2.0
18;222;859;860;1;501;2.0
18;223;860;861;1;501;2.0
18;224;861;863;2;501;2.0
18;225;863;866;3;501;2.0
18;226;866;869;3;501;2.0
18;227;869;870;1;501;2.0
18;228;870;873;3;501;2.0
18;229;873;874;1;501;2.0
18;230;874;876;2;501;2.0
18;231;876;879;3;501;2.0
18;232;879;880;1;501;2.0
18;233;880;881;1;501;2.0
18;234;881;883;2;501;2.0
18;235;883;886;3;501;2.0
18;236;886;889;3;501;2.0
18;237;889;890;1;501;2.0
18;238;890;891;1;501;2.0
18;239;891;893;2;501;2.0
18;240;893;894;1;501;2.0
18;241;894;896;2;501;2.0
18;242;896;897;1;501;2.0
18;243;897;899;2;501;2.0
18;244;899;900;1;501;2.0
18;245;900;901;1;501;2.0
18;246;901;903;2;501;2.0
18;247;903;906;3;501;2.0
18;248;906;909;3;501;2.0
18;249;909;910;1;501;2.0
18;250;910;913;3;501;2.0
18;251;913;916;3;501;2.0
18;252;916;919;3;501;2.0
18;253;919;920;1;501;2.0
18;254;920;921;1;501;2.0
18;255;921;923;2;501;2.0
18;256;923;926;3;501;2.0
18;257;926;929;3;501;2.0
18;258;929;930;1;501;2.0
18;259;930;933;3;501;2.0
18;260;933;934;1;501;2.0
18;261;934;936;2;501;2.0
18;262;936;939;3;501;2.0
18;263;939;940;1;501;2.0
18;264;940;941;1;501;2.0
18;265;941;943;2;501;2.0
18;266;943;946;3;501;2.0
18;267;946;949;3;501;2.0
18;268;949;950;1;501;2.0
18;269;950;951;1;501;2.0
18;270;951;953;2;501;2.0
18;271;953;954;1;501;2.0
18;272;954;956;2;501;2.0
18;273;956;957;1;501;2.0
18;274;957;959;2;501;2.0
18;275;959;960;1;501;2.0
18;276;960;961;1;501;2.0
18;277;961;963;2;501;2.0
18;278;963;966;3;501;2.0
18;279;966;969;3;501;2.0
18;280;969;970;1;501;2.0
18;281;970;973;3;501;2.0
18;282;973;976;3;501;2.0
18;283;976;979;3;501;2.0
18;284;979;980;1;501;2.0
18;285;980;981;1;501;2.0
18;286;981;983;2;501;2.0
18;287;983;986;3;501;2.0
18;288;986;989;3;501;2.0
18;289;989;990;1;501;2.0
18;290;990;993;3;501;2.0
18;291;993;996;3;501;2.0
18;292;996;999;3;501;2.0
18;293;999;1000;1;501;2.0
18;294;1000;1001;1;501;2.0
18;295;1001;1003;2;501;2.0
18;296;1003;1006;3;501;2.0
18;297;1006;1009;3;501;2.0
18;298;1009;1010;1;501;2.0
18;299;1010;1011;1;501;2.0
18;300;1011;1013;2;501;2.0
18;301;1013;1016;3;501;2.0
18;302;1016;1017;1;501;2.0
18;303;1017;1018;1;501;2.0
18;304;1018;1019;1;501;2.0
18;305;1019;1021;2;501;2.0
18;306;1021;1025;4;501;2.0
18;307;1025;1029;4;501;2.0
18;308;1029;1031;2;501;2.0
18;309;1031;1033;2;501;2.0
18;310;1033;1039;6;501;2.0
18;311;1039;1040;1;501;2.0
18;312;1040;1041;1;501;2.0
18;313;1041;1046;5;501;2.0
18;314;1046;1048;2;501;2.0
18;315;1048;1049;1;501;2.0
18;316;1049;1051;2;501;2.0
18;317;1051;1053;2;501;2.0
18;318;1053;1055;2;501;2.0
18;319;1055;1059;4;501;2.0
18;320;1059;1061;2;501;2.0
18;321;1061;1063;2;501;2.0
18;322;1063;1069;6;501;2.0
18;323;1069;1070;1;501;2.0
18;324;1070;1071;1;501;2.0
18;325;1071;1073;2;501;2.0
18;326;1073;1076;3;501;2.0
18;327;1076;1077;1;501;2.0
18;328;1077;1078;1;501;2.0
18;329;1078;1079;1;501;2.0
18;330;1079;1081;2;501;2.0
18;331;1081;1085;4;501;2.0
18;332;1085;1089;4;501;2.0
18;333;1089;1091;2;501;2.0
18;334;1091;1093;2;501;2.0
18;335;1093;1100;7;501;2.0
18;336;1100;1101;1;501;2.0
18;337;1101;1106;5;501;2.0
18;338;1106;1107;1;501;2.0
18;339;1107;1108;1;501;2.0
18;340;1108;1111;3;501;2.0
18;341;1111;1113;2;501;2.0
18;342;1113;1115;2;501;2.0
18;343;1115;1116;1;501;2.0
18;344;1116;1118;2;501;2.0
18;345;1118;1120;2;501;2.0
18;346;1120;1121;1;501;2.0
18;347;1121;1127;6;501;2.0
18;348;1127;1130;3;501;2.0
18;349;1130;1132;2;501;2.0
18;350;1132;1133;1;501;2.0
18;351;1133;1140;7;501;2.0
18;352;1140;1141;1;501;2.0
18;353;1141;1142;1;501;2.0
18;354;1142;1146;4;501;2.0
18;355;1146;1148;2;501;2.0
18;356;1148;1152;4;501;2.0
18;357;1152;1153;1;501;2.0
18;358;1153;1157;4;501;2.0
18;359;1157;1160;3;501;2.0
18;360;1160;1161;1;501;2.0
18;361;1161;1163;2;501;2.0
18;362;1163;1171;8;501;2.0
18;363;1171;1174;3;501;2.0
18;364;1174;1177;3;501;2.0
18;365;1177;1178;1;501;2.0
18;366;1178;1180;2;501;2.0
18;367;1180;1181;1;501;2.0
18;368;1181;1183;2;501;2.0
18;369;1183;1190;7;501;2.0
18;370;1190;1197;7;501;2.0
18;371;1197;1198;1;501;2.0
18;372;1198;1200;2;501;2.0
18;373;1200;1202;2;501;2.0
18;374;1202;1203;1;501;2.0
18;375;1203;1206;3;501;2.0
18;376;1206;1211;5;501;2.0
18;377;1211;1217;6;501;2.0
18;378;1217;1225;8;501;2.0
18;379;1225;1226;1;501;2.0
18;380;1226;1228;2;501;2.0
18;381;1228;1233;5;501;2.0
18;382;1233;1234;1;501;2.0
18;383;1234;1237;3;501;2.0
18;384;1237;1250;13;501;2.0
18;385;1250;1251;1;501;2.0
18;386;1251;1253;2;501;2.0
18;387;1253;1262;9;501;2.0
18;388;1262;1270;8;501;2.0
18;389;1270;1272;2;501;2.0
18;390;1272;1273;1;501;2.0
18;391;1273;1275;2;501;2.0
18;392;1275;1276;1;501;2.0
18;393;1276;1278;2;501;2.0
18;394;1278;1286;8;501;2.0
18;395;1286;1287;1;501;2.0
18;396;1287;1300;13;501;2.0
18;397;1300;1303;3;501;2.0
18;398;1303;1307;4;501;2.0
18;399;1307;1309;2;501;2.0
18;400;1309;1311;2;501;2.0
18;401;1311;1312;1;501;2.0
18;402;1312;1313;1;501;2.0
18;403;1313;1323;10;501;2.0
18;404;1323;1330;7;501;2.0
18;405;1330;1331;1;501;2.0
18;406;1331;1336;5;501;2.0
18;407;1336;1337;1;501;2.0
18;408;1337;1343;6;501;2.0
18;409;1343;1346;3;501;2.0
18;410;1346;1348;2;501;2.0
18;411;1348;1350;2;501;2.0
18;412;1350;1361;11;501;2.0
18;413;1361;1364;3;501;2.0
18;414;1364;1365;1;501;2.0
18;415;1365;1382;17;501;2.0
18;416;1382;1386;4;501;2.0
18;417;1386;1401;15;501;2.0
18;418;1401;1416;15;501;2.0
18;419;1416;1431;15;501;2.0
18;420;1431;1446;15;501;2.0
18;421;1446;1461;15;501;2.0
18;422;1461;1476;15;501;2.0
18;423;1476;1491;15;501;2.0
18;424;1491;1506;15;501;2.0
18;425;1506;1521;15;501;2.0
18;426;1521;1536;15;501;2.0
18;427;1536;1551;15;501;2.0
18;428;1551;1566;15;501;2.0
18;429;1566;1581;15;501;2.0
18;430;1581;1596;15;501;2.0
18;431;1596;1611;15;501;2.0
18;432;1611;1626;15;501;2.0
18;433;1626;1641;15;501;2.0
18;434;1641;1656;15;501;2.0
18;435;1656;1671;15;501;2.0
18;436;1671;1680;9;501;2.0
19;0;250;332;82;66;2.0
19;1;332;338;6;66;2.0
19;2;338;344;6;66;2.0
19;3;344;345;1;66;2.0
19;4;345;347;2;66;2.0
19;5;347;350;3;66;2.0
19;6;350;353;3;66;2.0
19;7;353;355;2;66;2.0
19;8;355;358;3;66;2.0
19;9;358;359;1;66;2.0
19;10;359;360;1;66;2.0
19;11;360;361;1;66;2.0
19;12;361;362;1;66;2.0
19;13;362;363;1;66;2.0
19;14;363;368;5;66;2.0
19;15;368;373;5;66;2.0
19;16;373;375;2;66;2.0
19;17;375;377;2;66;2.0
19;18;377;380;3;66;2.0
19;19;380;382;2;66;2.0
19;20;382;385;3;66;2.0
19;21;385;388;3;66;2.0
19;22;388;389;1;66;2.0
19;23;389;392;3;66;2.0
19;24;392;395;3;66;2.0
19;25;395;402;7;66;2.0
19;26;402;403;1;66;2.0
19;27;403;405;2;66;2.0
19;28;405;408;3;66;2.0
19;29;408;412;4;66;2.0
19;30;412;415;3;66;2.0
19;31;415;419;4;66;2.0
19;32;419;420;1;66;2.0
19;33;420;422;2;66;2.0
19;34;422;423;1;66;2.0
19;35;423;425;2;66;2.0
19;36;425;428;3;66;2.0
19;37;428;430;2;66;2.0
19;38;430;432;2;66;2.0
19;39;432;433;1;66;2.0
19;40;433;435;2;66;2.0
19;41;435;440;5;66;2.0
19;42;440;442;2;66;2.0
19;43;442;445;3;66;2.0
19;44;445;448;3;66;2.0
19;45;448;449;1;66;2.0
19;46;449;450;1;66;2.0
19;47;450;452;2;66;2.0
19;48;452;453;1;66;2.0
19;49;453;455;2;66;2.0
19;50;455;462;7;66;2.0
19;51;462;463;1;66;2.0
19;52;463;465;2;66;2.0
19;53;465;468;3;66;2.0
19;54;468;472;4;66;2.0
19;55;472;475;3;66;2.0
19;56;475;479;4;66;2.0
19;57;479;480;1;66;2.0
19;58;480;482;2;66;2.0
19;59;482;483;1;66;2.0
19;60;483;485;2;66;2.0
19;61;485;488;3;66;2.0
19;62;488;490;2;66;2.0
19;63;490;492;2;66;2.0
19;64;492;493;1;66;2.0
19;65;493;495;2;66;2.0
19;66;495;499;4;66;2.0
19;67;499;500;1;66;2.0
19;68;500;502;2;66;2.0
19;69;502;503;1;66;2.0
19;70;503;508;5;66;2.0
19;71;508;510;2;66;2.0
19;72;510;512;2;66;2.0
19;73;512;515;3;66;2.0
19;74;515;522;7;66;2.0
19;75;522;523;1;66;2.0
19;76;523;527;4;66;2.0
19;77;527;528;1;66;2.0
19;78;528;532;4;66;2.0
19;79;532;535;3;66;2.0
19;80;535;538;3;66;2.0
19;81;538;539;1;66;2.0
19;82;539;545;6;66;2.0
19;83;545;548;3;66;2.0
19;84;548;552;4;66;2.0
19;85;552;555;3;66;2.0
19;86;555;562;7;66;2.0
19;87;562;565;3;66;2.0
19;88;565;568;3;66;2.0
19;89;568;570;2;66;2.0
19;90;570;572;2;66;2.0
19;91;572;575;3;66;2.0
19;92;575;578;3;66;2.0
19;93;578;583;5;66;2.0
19;94;583;585;2;66;2.0
19;95;585;588;3;66;2.0
19;96;588;592;4;66;2.0
19;97;592;595;3;66;2.0
19;98;595;599;4;66;2.0
19;99;599;602;3;66;2.0
19;100;602;605;3;66;2.0
19;101;605;608;3;66;2.0
19;102;608;612;4;66;2.0
19;103;612;615;3;66;2.0
19;104;615;618;3;66;2.0
19;105;618;625;7;66;2.0
19;106;625;628;3;66;2.0
19;107;628;630;2;66;2.0
19;108;630;632;2;66;2.0
19;109;632;635;3;66;2.0
19;110;635;638;3;66;2.0
19;111;638;643;5;66;2.0
19;112;643;645;2;66;2.0
19;113;645;648;3;66;2.0
19;114;648;652;4;66;2.0
19;115;652;655;3;66;2.0
19;116;655;659;4;66;2.0
19;117;659;662;3;66;2.0
19;118;662;665;3;66;2.0
19;119;665;668;3;66;2.0
19;120;668;672;4;66;2.0
19;121;672;675;3;66;2.0
19;122;675;678;3;66;2.0
19;123;678;685;7;66;2.0
19;124;685;688;3;66;2.0
19;125;688;692;4;66;2.0
19;126;692;695;3;66;2.0
19;127;695;698;3;66;2.0
19;128;698;703;5;66;2.0
19;129;703;705;2;66;2.0
19;130;705;708;3;66;2.0
19;131;708;712;4;66;2.0
19;132;712;715;3;66;2.0
19;133;715;719;4;66;2.0
19;134;719;722;3;66;2.0
19;135;722;725;3;66;2.0
19;136;725;728;3;66;2.0
19;137;728;732;4;66;2.0
19;138;732;735;3;66;2.0
19;139;735;738;3;66;2.0
19;140;738;745;7;66;2.0
19;141;745;748;3;66;2.0
19;142;748;752;4;66;2.0
19;143;752;755;3;66;2.0
19;144;755;758;3;66;2.0
19;145;758;763;5;66;2.0
19;146;763;765;2;66;2.0
19;147;765;768;3;66;2.0
19;148;768;772;4;66;2.0
19;149;772;775;3;66;2.0
19;150;775;779;4;66;2.0
19;151;779;782;3;66;2.0
19;152;782;785;3;66;2.0
19;153;785;788;3;66;2.0
19;154;788;792;4;66;2.0
19;155;792;795;3;66;2.0
19;156;795;798;3;66;2.0
19;157;798;802;4;66;2.0
19;158;802;805;3;66;2.0
19;159;805;808;3;66;2.0
19;160;808;810;2;66;2.0
19;161;810;812;2;66;2.0
19;162;812;815;3;66;2.0
19;163;815;819;4;66;2.0
19;164;819;822;3;66;2.0
19;165;822;823;1;66;2.0
19;166;823;825;2;66;2.0
19;167;825;828;3;66;2.0
19;168;828;832;4;66;2.0
19;169;832;835;3;66;2.0
19;170;835;839;4;66;2.0
19;171;839;840;1;66;2.0
19;172;840;842;2;66;2.0
19;173;842;845;3;66;2.0
19;174;845;848;3;66;2.0
19;175;848;852;4;66;2.0
19;176;852;854;2;66;2.0
19;177;854;855;1;66;2.0
19;178;855;858;3;66;2.0
19;179;858;860;2;66;2.0
19;180;860;862;2;66;2.0
19;181;862;865;3;66;2.0
19;182;865;866;1;66;2.0
19;183;866;868;2;66;2.0
19;184;868;870;2;66;2.0
19;185;870;872;2;66;2.0
19;186;872;875;3;66;2.0
19;187;875;878;3;66;2.0
19;188;878;879;1;66;2.0
19;189;879;880;1;66;2.0
19;190;880;882;2;66;2.0
19;191;882;883;1;66;2.0
19;192;883;885;2;66;2.0
19;193;885;888;3;66;2.0
19;194;888;892;4;66;2.0
19;195;892;895;3;66;2.0
19;196;895;898;3;66;2.0
19;197;898;899;1;66;2.0
19;198;899;900;1;66;2.0
19;199;900;902;2;66;2.0
19;200;902;905;3;66;2.0
19;201;905;908;3;66;2.0
19;202;908;912;4;66;2.0
19;203;912;914;2;66;2.0
19;204;914;915;1;66;2.0
19;205;915;918;3;66;2.0
19;206;918;920;2;66;2.0
19;207;920;922;2;66;2.0
19;208;922;923;1;66;2.0
19;209;923;925;2;66;2.0
19;210;925;928;3;66;2.0
19;211;928;930;2;66;2.0
19;212;930;932;2;66;2.0
19;213;932;935;3;66;2.0
19;214;935;938;3;66;2.0
19;215;938;939;1;66;2.0
19;216;939;940;1;66;2.0
19;217;940;942;2;66;2.0
19;218;942;943;1;66;2.0
19;219;943;945;2;66;2.0
19;220;945;948;3;66;2.0
19;221;948;952;4;66;2.0
19;222;952;955;3;66;2.0
19;223;955;958;3;66;2.0
19;224;958;959;1;66;2.0
19;225;959;960;1;66;2.0
19;226;960;962;2;66;2.0
19;227;962;965;3;66;2.0
19;228;965;968;3;66;2.0
19;229;968;972;4;66;2.0
19;230;972;974;2;66;2.0
19;231;974;975;1;66;2.0
19;232;975;978;3;66;2.0
19;233;978;980;2;66;2.0
19;234;980;982;2;66;2.0
19;235;982;983;1;66;2.0
19;236;983;985;2;66;2.0
19;237;985;988;3;66;2.0
19;238;988;990;2;66;2.0
19;239;990;992;2;66;2.0
19;240;992;995;3;66;2.0
19;241;995;998;3;66;2.0
19;242;998;1000;2;66;2.0
19;243;1000;1002;2;66;2.0
19;244;1002;1005;3;66;2.0
19;245;1005;1006;1;66;2.0
19;246;1006;1008;2;66;2.0
19;247;1008;1012;4;66;2.0
19;248;1012;1014;2;66;2.0
19;249;1014;1015;1;66;2.0
19;250;1015;1018;3;66;2.0
19;251;1018;1020;2;66;2.0
19;252;1020;1022;2;66;2.0
19;253;1022;1027;5;66;2.0
19;254;1027;1028;1;66;2.0
19;255;1028;1030;2;66;2.0
19;256;1030;1034;4;66;2.0
19;257;1034;1035;1;66;2.0
19;258;1035;1037;2;66;2.0
19;259;1037;1038;1;66;2.0
19;260;1038;1040;2;66;2.0
19;261;1040;1042;2;66;2.0
19;262;1042;1045;3;66;2.0
19;263;1045;1048;3;66;2.0
19;264;1048;1052;4;66;2.0
19;265;1052;1055;3;66;2.0
19;266;1055;1057;2;66;2.0
19;267;1057;1058;1;66;2.0
19;268;1058;1060;2;66;2.0
19;269;1060;1067;7;66;2.0
19;270;1067;1068;1;66;2.0
19;271;1068;1072;4;66;2.0
19;272;1072;1075;3;66;2.0
19;273;1075;1078;3;66;2.0
19;274;1078;1080;2;66;2.0
19;275;1080;1082;2;66;2.0
19;276;1082;1087;5;66;2.0
19;277;1087;1088;1;66;2.0
19;278;1088;1090;2;66;2.0
19;279;1090;1095;5;66;2.0
19;280;1095;1097;2;66;2.0
19;281;1097;1098;1;66;2.0
19;282;1098;1100;2;66;2.0
19;283;1100;1102;2;66;2.0
19;284;1102;1105;3;66;2.0
19;285;1105;1108;3;66;2.0
19;286;1108;1112;4;66;2.0
19;287;1112;1116;4;66;2.0
19;288;1116;1117;1;66;2.0
19;289;1117;1120;3;66;2.0
19;290;1120;1123;3;66;2.0
19;291;1123;1124;1;66;2.0
19;292;1124;1128;4;66;2.0
19;293;1128;1129;1;66;2.0
19;294;1129;1132;3;66;2.0
19;295;1132;1135;3;66;2.0
19;296;1135;1139;4;66;2.0
19;297;1139;1141;2;66;2.0
19;298;1141;1146;5;66;2.0
19;299;1146;1147;1;66;2.0
19;300;1147;1148;1;66;2.0
19;301;1148;1149;1;66;2.0
19;302;1149;1152;3;66;2.0
19;303;1152;1154;2;66;2.0
19;304;1154;1161;7;66;2.0
19;305;1161;1162;1;66;2.0
19;306;1162;1168;6;66;2.0
19;307;1168;1169;1;66;2.0
19;308;1169;1177;8;66;2.0
19;309;1177;1181;4;66;2.0
19;310;1181;1182;1;66;2.0
19;311;1182;1186;4;66;2.0
19;312;1186;1187;1;66;2.0
19;313;1187;1188;1;66;2.0
19;314;1188;1189;1;66;2.0
19;315;1189;1195;6;66;2.0
19;316;1195;1202;7;66;2.0
19;317;1202;1204;2;66;2.0
19;318;1204;1209;5;66;2.0
19;319;1209;1211;2;66;2.0
19;320;1211;1213;2;66;2.0
19;321;1213;1216;3;66;2.0
19;322;1216;1222;6;66;2.0
19;323;1222;1233;11;66;2.0
19;324;1233;1234;1;66;2.0
19;325;1234;1237;3;66;2.0
19;326;1237;1239;2;66;2.0
19;327;1239;1241;2;66;2.0
19;328;1241;1242;1;66;2.0
19;329;1242;1246;4;66;2.0
19;330;1246;1258;12;66;2.0
19;331;1258;1259;1;66;2.0
19;332;1259;1262;3;66;2.0
19;333;1262;1267;5;66;2.0
19;334;1267;1275;8;66;2.0
19;335;1275;1279;4;66;2.0
19;336;1279;1281;2;66;2.0
19;337;1281;1283;2;66;2.0
19;338;1283;1284;1;66;2.0
19;339;1284;1291;7;66;2.0
19;340;1291;1292;1;66;2.0
19;341;1292;1309;17;66;2.0
19;342;1309;1310;1;66;2.0
19;343;1310;1316;6;66;2.0
19;344;1316;1317;1;66;2.0
19;345;1317;1319;2;66;2.0
19;346;1319;1329;10;66;2.0
19;347;1329;1338;9;66;2.0
19;348;1338;1339;1;66;2.0
19;349;1339;1341;2;66;2.0
19;350;1341;1342;1;66;2.0
19;351;1342;1349;7;66;2.0
19;352;1349;1352;3;66;2.0
19;353;1352;1354;2;66;2.0
19;354;1354;1359;5;66;2.0
19;355;1359;1368;9;66;2.0
19;356;1368;1370;2;66;2.0
19;357;1370;1374;4;66;2.0
19;358;1374;1387;13;66;2.0
19;359;1387;1393;6;66;2.0
19;360;1393;1408;15;66;2.0
19;361;1408;1423;15;66;2.0
19;362;1423;1438;15;66;2.0
19;363;1438;1453;15;66;2.0
19;364;1453;1468;15;66;2.0
19;365;1468;1483;15;66;2.0
19;366;1483;1498;15;66;2.0
19;367;1498;1513;15;66;2.0
19;368;1513;1528;15;66;2.0
19;369;1528;1543;15;66;2.0
19;370;1543;1558;15;66;2.0
19;371;1558;1573;15;66;2.0
19;372;1573;1588;15;66;2.0
19;373;1588;1603;15;66;2.0
19;374;1603;1618;15;66;2.0
19;375;1618;1633;15;66;2.0
19;376;1633;1648;15;66;2.0
19;377;1648;1663;15;66;2.0
19;378;1663;1680;17;66;2.0
20;0;252;334;82;63;2.0
20;1;334;340;6;63;2.0
20;2;340;346;6;63;2.0
20;3;346;347;1;63;2.0
20;4;347;349;2;63;2.0
20;5;349;352;3;63;2.0
20;6;352;355;3;63;2.0
20;7;355;357;2;63;2.0
20;8;357;360;3;63;2.0
20;9;360;361;1;63;2.0
20;10;361;362;1;63;2.0
20;11;362;363;1;63;2.0
20;12;363;364;1;63;2.0
20;13;364;365;1;63;2.0
20;14;365;370;5;63;2.0
20;15;370;375;5;63;2.0
20;16;375;377;2;63;2.0
20;17;377;379;2;63;2.0
20;18;379;382;3;63;2.0
20;19;382;384;2;63;2.0
20;20;384;387;3;63;2.0
20;21;387;390;3;63;2.0
20;22;390;391;1;63;2.0
20;23;391;394;3;63;2.0
20;24;394;397;3;63;2.0
20;25;397;404;7;63;2.0
20;26;404;405;1;63;2.0
20;27;405;407;2;63;2.0
20;28;407;410;3;63;2.0
20;29;410;414;4;63;2.0
20;30;414;417;3;63;2.0
20;31;417;421;4;63;2.0
20;32;421;422;1;63;2.0
20;33;422;424;2;63;2.0
20;34;424;425;1;63;2.0
20;35;425;427;2;63;2.0
20;36;427;430;3;63;2.0
20;37;430;432;2;63;2.0
20;38;432;434;2;63;2.0
20;39;434;435;1;63;2.0
20;40;435;437;2;63;2.0
20;41;437;442;5;63;2.0
20;42;442;444;2;63;2.0
20;43;444;447;3;63;2.0
20;44;447;450;3;63;2.0
20;45;450;451;1;63;2.0
20;46;451;452;1;63;2.0
20;47;452;454;2;63;2.0
20;48;454;455;1;63;2.0
20;49;455;457;2;63;2.0
20;50;457;464;7;63;2.0
20;51;464;465;1;63;2.0
20;52;465;467;2;63;2.0
20;53;467;470;3;63;2.0
20;54;470;474;4;63;2.0
20;55;474;477;3;63;2.0
20;56;477;481;4;63;2.0
20;57;481;482;1;63;2.0
20;58;482;484;2;63;2.0
20;59;484;485;1;63;2.0
20;60;485;487;2;63;2.0
20;61;487;490;3;63;2.0
20;62;490;492;2;63;2.0
20;63;492;494;2;63;2.0
20;64;494;495;1;63;2.0
20;65;495;497;2;63;2.0
20;66;497;501;4;63;2.0
20;67;501;502;1;63;2.0
20;68;502;504;2;63;2.0
20;69;504;505;1;63;2.0
20;70;505;510;5;63;2.0
20;71;510;512;2;63;2.0
20;72;512;514;2;63;2.0
20;73;514;517;3;63;2.0
20;74;517;524;7;63;2.0
20;75;524;525;1;63;2.0
20;76;525;529;4;63;2.0
20;77;529;530;1;63;2.0
20;78;530;534;4;63;2.0
20;79;534;537;3;63;2.0
20;80;537;540;3;63;2.0
20;81;540;541;1;63;2.0
20;82;541;547;6;63;2.0
20;83;547;550;3;63;2.0
20;84;550;554;4;63;2.0
20;85;554;557;3;63;2.0
20;86;557;564;7;63;2.0
20;87;564;567;3;63;2.0
20;88;567;570;3;63;2.0
20;89;570;572;2;63;2.0
20;90;572;574;2;63;2.0
20;91;574;577;3;63;2.0
20;92;577;580;3;63;2.0
20;93;580;585;5;63;2.0
20;94;585;587;2;63;2.0
20;95;587;590;3;63;2.0
20;96;590;594;4;63;2.0
20;97;594;597;3;63;2.0
20;98;597;601;4;63;2.0
20;99;601;604;3;63;2.0
20;100;604;607;3;63;2.0
20;101;607;610;3;63;2.0
20;102;610;614;4;63;2.0
20;103;614;617;3;63;2.0
20;104;617;620;3;63;2.0
20;105;620;627;7;63;2.0
20;106;627;630;3;63;2.0
20;107;630;632;2;63;2.0
20;108;632;634;2;63;2.0
20;109;634;637;3;63;2.0
20;110;637;640;3;63;2.0
20;111;640;645;5;63;2.0
20;112;645;647;2;63;2.0
20;113;647;650;3;63;2.0
20;114;650;654;4;63;2.0
20;115;654;657;3;63;2.0
20;116;657;661;4;63;2.0
20;117;661;664;3;63;2.0
20;118;664;667;3;63;2.0
20;119;667;670;3;63;2.0
20;120;670;674;4;63;2.0
20;121;674;677;3;63;2.0
20;122;677;680;3;63;2.0
20;123;680;687;7;63;2.0
20;124;687;690;3;63;2.0
20;125;690;694;4;63;2.0
20;126;694;697;3;63;2.0
20;127;697;700;3;63;2.0
20;128;700;705;5;63;2.0
20;129;705;707;2;63;2.0
20;130;707;710;3;63;2.0
20;131;710;714;4;63;2.0
20;132;714;717;3;63;2.0
20;133;717;721;4;63;2.0
20;134;721;724;3;63;2.0
20;135;724;727;3;63;2.0
20;136;727;730;3;63;2.0
20;137;730;734;4;63;2.0
20;138;734;737;3;63;2.0
20;139;737;740;3;63;2.0
20;140;740;747;7;63;2.0
20;141;747;750;3;63;2.0
20;142;750;754;4;63;2.0
20;143;754;757;3;63;2.0
20;144;757;760;3;63;2.0
20;145;760;765;5;63;2.0
20;146;765;767;2;63;2.0
20;147;767;770;3;63;2.0
20;148;770;774;4;63;2.0
20;149;774;777;3;63;2.0
20;150;777;781;4;63;2.0
20;151;781;784;3;63;2.0
20;152;784;787;3;63;2.0
20;153;787;790;3;63;2.0
20;154;790;794;4;63;2.0
20;155;794;797;3;63;2.0
20;156;797;800;3;63;2.0
20;157;800;804;4;63;2.0
20;158;804;807;3;63;2.0
20;159;807;810;3;63;2.0
20;160;810;812;2;63;2.0
20;161;812;814;2;63;2.0
20;162;814;817;3;63;2.0
20;163;817;821;4;63;2.0
20;164;821;824;3;63;2.0
20;165;824;825;1;63;2.0
20;166;825;827;2;63;2.0
20;167;827;830;3;63;2.0
20;168;830;834;4;63;2.0
20;169;834;837;3;63;2.0
20;170;837;841;4;63;2.0
20;171;841;842;1;63;2.0
20;172;842;844;2;63;2.0
20;173;844;847;3;63;2.0
20;174;847;850;3;63;2.0
20;175;850;854;4;63;2.0
20;176;854;856;2;63;2.0
20;177;856;857;1;63;2.0
20;178;857;860;3;63;2.0
20;179;860;862;2;63;2.0
20;180;862;864;2;63;2.0
20;181;864;867;3;63;2.0
20;182;867;868;1;63;2.0
20;183;868;870;2;63;2.0
20;184;870;872;2;63;2.0
20;185;872;874;2;63;2.0
20;186;874;877;3;63;2.0
20;187;877;880;3;63;2.0
20;188;880;881;1;63;2.0
20;189;881;882;1;63;2.0
20;190;882;884;2;63;2.0
20;191;884;885;1;63;2.0
20;192;885;887;2;63;2.0
20;193;887;890;3;63;2.0
20;194;890;894;4;63;2.0
20;195;894;897;3;63;2.0
20;196;897;900;3;63;2.0
20;197;900;901;1;63;2.0
20;198;901;902;1;63;2.0
20;199;902;904;2;63;2.0
20;200;904;907;3;63;2.0
20;201;907;910;3;63;2.0
20;202;910;914;4;63;2.0
20;203;914;916;2;63;2.0
20;204;916;917;1;63;2.0
20;205;917;920;3;63;2.0
20;206;920;922;2;63;2.0
20;207;922;924;2;63;2.0
20;208;924;925;1;63;2.0
20;209;925;927;2;63;2.0
20;210;927;930;3;63;2.0
20;211;930;932;2;63;2.0
20;212;932;934;2;63;2.0
20;213;934;937;3;63;2.0
20;214;937;940;3;63;2.0
20;215;940;941;1;63;2.0
20;216;941;942;1;63;2.0
20;217;942;944;2;63;2.0
20;218;944;945;1;63;2.0
20;219;945;947;2;63;2.0
20;220;947;950;3;63;2.0
20;221;950;954;4;63;2.0
20;222;954;957;3;63;2.0
20;223;957;960;3;63;2.0
20;224;960;961;1;63;2.0
20;225;961;962;1;63;2.0
20;226;962;964;2;63;2.0
20;227;964;967;3;63;2.0
20;228;967;970;3;63;2.0
20;229;970;974;4;63;2.0
20;230;974;976;2;63;2.0
20;231;976;977;1;63;2.0
20;232;977;980;3;63;2.0
20;233;980;982;2;63;2.0
20;234;982;984;2;63;2.0
20;235;984;985;1;63;2.0
20;236;985;987;2;63;2.0
20;237;987;990;3;63;2.0
20;238;990;992;2;63;2.0
20;239;992;994;2;63;2.0
20;240;994;997;3;63;2.0
20;241;997;1000;3;63;2.0
20;242;1000;1002;2;63;2.0
20;243;1002;1004;2;63;2.0
20;244;1004;1007;3;63;2.0
20;245;1007;1008;1;63;2.0
20;246;1008;1010;2;63;2.0
20;247;1010;1014;4;63;2.0
20;248;1014;1016;2;63;2.0
20;249;1016;1017;1;63;2.0
20;250;1017;1020;3;63;2.0
20;251;1020;1022;2;63;2.0
20;252;1022;1024;2;63;2.0
20;253;1024;1029;5;63;2.0
20;254;1029;1030;1;63;2.0
20;255;1030;1032;2;63;2.0
20;256;1032;1036;4;63;2.0
20;257;1036;1037;1;63;2.0
20;258;1037;1039;2;63;2.0
20;259;1039;1040;1;63;2.0
20;260;1040;1042;2;63;2.0
20;261;1042;1044;2;63;2.0
20;262;1044;1047;3;63;2.0
20;263;1047;1050;3;63;2.0
20;264;1050;1054;4;63;2.0
20;265;1054;1057;3;63;2.0
20;266;1057;1059;2;63;2.0
20;267;1059;1060;1;63;2.0
20;268;1060;1062;2;63;2.0
20;269;1062;1069;7;63;2.0
20;270;1069;1070;1;63;2.0
20;271;1070;1074;4;63;2.0
20;272;1074;1077;3;63;2.0
20;273;1077;1080;3;63;2.0
20;274;1080;1082;2;63;2.0
20;275;1082;1084;2;63;2.0
20;276;1084;1089;5;63;2.0
20;277;1089;1090;1;63;2.0
20;278;1090;1092;2;63;2.0
20;279;1092;1097;5;63;2.0
20;280;1097;1099;2;63;2.0
20;281;1099;1100;1;63;2.0
20;282;1100;1102;2;63;2.0
20;283;1102;1104;2;63;2.0
20;284;1104;1107;3;63;2.0
20;285;1107;1110;3;63;2.0
20;286;1110;1114;4;63;2.0
20;287;1114;1118;4;63;2.0
20;288;1118;1119;1;63;2.0
20;289;1119;1122;3;63;2.0
20;290;1122;1125;3;63;2.0
20;291;1125;1126;1;63;2.0
20;292;1126;1130;4;63;2.0
20;293;1130;1131;1;63;2.0
20;294;1131;1134;3;63;2.0
20;295;1134;1137;3;63;2.0
20;296;1137;1141;4;63;2.0
20;297;1141;1143;2;63;2.0
20;298;1143;1148;5;63;2.0
20;299;1148;1149;1;63;2.0
20;300;1149;1150;1;63;2.0
20;301;1150;1151;1;63;2.0
20;302;1151;1154;3;63;2.0
20;303;1154;1156;2;63;2.0
20;304;1156;1163;7;63;2.0
20;305;1163;1164;1;63;2.0
20;306;1164;1170;6;63;2.0
20;307;1170;1171;1;63;2.0
20;308;1171;1179;8;63;2.0
20;309;1179;1183;4;63;2.0
20;310;1183;1184;1;63;2.0
20;311;1184;1188;4;63;2.0
20;312;1188;1189;1;63;2.0
20;313;1189;1190;1;63;2.0
20;314;1190;1191;1;63;2.0
20;315;1191;1197;6;63;2.0
20;316;1197;1204;7;63;2.0
20;317;1204;1206;2;63;2.0
20;318;1206;1211;5;63;2.0
20;319;1211;1213;2;63;2.0
20;320;1213;1215;2;63;2.0
20;321;1215;1218;3;63;2.0
20;322;1218;1224;6;63;2.0
20;323;1224;1235;11;63;2.0
20;324;1235;1236;1;63;2.0
20;325;1236;1239;3;63;2.0
20;326;1239;1241;2;63;2.0
20;327;1241;1243;2;63;2.0
20;328;1243;1244;1;63;2.0
20;329;1244;1248;4;63;2.0
20;330;1248;1260;12;63;2.0
20;331;1260;1261;1;63;2.0
20;332;1261;1264;3;63;2.0
20;333;1264;1269;5;63;2.0
20;334;1269;1277;8;63;2.0
20;335;1277;1281;4;63;2.0
20;336;1281;1283;2;63;2.0
20;337;1283;1285;2;63;2.0
20;338;1285;1286;1;63;2.0
20;339;1286;1293;7;63;2.0
20;340;1293;1294;1;63;2.0
20;341;1294;1311;17;63;2.0
20;342;1311;1312;1;63;2.0
20;343;1312;1318;6;63;2.0
20;344;1318;1319;1;63;2.0
20;345;1319;1321;2;63;2.0
20;346;1321;1331;10;63;2.0
20;347;1331;1340;9;63;2.0
20;348;1340;1341;1;63;2.0
20;349;1341;1343;2;63;2.0
20;350;1343;1344;1;63;2.0
20;351;1344;1351;7;63;2.0
20;352;1351;1354;3;63;2.0
20;353;1354;1356;2;63;2.0
20;354;1356;1361;5;63;2.0
20;355;1361;1370;9;63;2.0
20;356;1370;1372;2;63;2.0
20;357;1372;1376;4;63;2.0
20;358;1376;1389;13;63;2.0
20;359;1389;1395;6;63;2.0
20;360;1395;1410;15;63;2.0
20;361;1410;1425;15;63;2.0
20;362;1425;1440;15;63;2.0
20;363;1440;1455;15;63;2.0
20;364;1455;1470;15;63;2.0
20;365;1470;1485;15;63;2.0
20;366;1485;1500;15;63;2.0
20;367;1500;1515;15;63;2.0
20;368;1515;1530;15;63;2.0
20;369;1530;1545;15;63;2.0
20;370;1545;1560;15;63;2.0
20;371;1560;1575;15;63;2.0
20;372;1575;1590;15;63;2.0
20;373;1590;1605;15;63;2.0
20;374;1605;1620;15;63;2.0
20;375;1620;1635;15;63;2.0
20;376;1635;1650;15;63;2.0
20;377;1650;1665;15;63;2.0
20;378;1665;1680;15;63;2.0
21;0;249;333;84;114;2.0
21;1;333;337;4;114;2.0
21;2;337;338;1;114;2.0
21;3;338;340;2;114;2.0
21;4;340;342;2;114;2.0
21;5;342;343;1;114;2.0
21;6;343;345;2;114;2.0
21;7;345;346;1;114;2.0
21;8;346;349;3;114;2.0
21;9;349;353;4;114;2.0
21;10;353;354;1;114;2.0
21;11;354;355;1;114;2.0
21;12;355;358;3;114;2.0
21;13;358;360;2;114;2.0
21;14;360;361;1;114;2.0
21;15;361;363;2;114;2.0
21;16;363;367;4;114;2.0
21;17;367;368;1;114;2.0
21;18;368;373;5;114;2.0
21;19;373;374;1;114;2.0
21;20;374;375;1;114;2.0
21;21;375;382;7;114;2.0
21;22;382;383;1;114;2.0
21;23;383;384;1;114;2.0
21;24;384;386;2;114;2.0
21;25;386;388;2;114;2.0
21;26;388;390;2;114;2.0
21;27;390;392;2;114;2.0
21;28;392;395;3;114;2.0
21;29;395;396;1;114;2.0
21;30;396;398;2;114;2.0
21;31;398;402;4;114;2.0
21;32;402;404;2;114;2.0
21;33;404;406;2;114;2.0
21;34;406;407;1;114;2.0
21;35;407;408;1;114;2.0
21;36;408;410;2;114;2.0
21;37;410;412;2;114;2.0
21;38;412;413;1;114;2.0
21;39;413;415;2;114;2.0
21;40;415;416;1;114;2.0
21;41;416;418;2;114;2.0
21;42;418;420;2;114;2.0
21;43;420;422;2;114;2.0
21;44;422;423;1;114;2.0
21;45;423;424;1;114;2.0
21;46;424;426;2;114;2.0
21;47;426;427;1;114;2.0
21;48;427;428;1;114;2.0
21;49;428;432;4;114;2.0
21;50;432;433;1;114;2.0
21;51;433;435;2;114;2.0
21;52;435;436;1;114;2.0
21;53;436;437;1;114;2.0
21;54;437;438;1;114;2.0
21;55;438;440;2;114;2.0
21;56;440;442;2;114;2.0
21;57;442;444;2;114;2.0
21;58;444;446;2;114;2.0
21;59;446;448;2;114;2.0
21;60;448;450;2;114;2.0
21;61;450;452;2;114;2.0
21;62;452;455;3;114;2.0
21;63;455;456;1;114;2.0
21;64;456;458;2;114;2.0
21;65;458;462;4;114;2.0
21;66;462;463;1;114;2.0
21;67;463;464;1;114;2.0
21;68;464;466;2;114;2.0
21;69;466;467;1;114;2.0
21;70;467;468;1;114;2.0
21;71;468;470;2;114;2.0
21;72;470;472;2;114;2.0
21;73;472;473;1;114;2.0
21;74;473;475;2;114;2.0
21;75;475;476;1;114;2.0
21;76;476;478;2;114;2.0
21;77;478;480;2;114;2.0
21;78;480;482;2;114;2.0
21;79;482;483;1;114;2.0
21;80;483;484;1;114;2.0
21;81;484;486;2;114;2.0
21;82;486;487;1;114;2.0
21;83;487;488;1;114;2.0
21;84;488;490;2;114;2.0
21;85;490;492;2;114;2.0
21;86;492;495;3;114;2.0
21;87;495;496;1;114;2.0
21;88;496;497;1;114;2.0
21;89;497;498;1;114;2.0
21;90;498;503;5;114;2.0
21;91;503;504;1;114;2.0
21;92;504;508;4;114;2.0
21;93;508;510;2;114;2.0
21;94;510;511;1;114;2.0
21;95;511;512;1;114;2.0
21;96;512;515;3;114;2.0
21;97;515;518;3;114;2.0
21;98;518;523;5;114;2.0
21;99;523;524;1;114;2.0
21;100;524;528;4;114;2.0
21;101;528;532;4;114;2.0
21;102;532;535;3;114;2.0
21;103;535;540;5;114;2.0
21;104;540;544;4;114;2.0
21;105;544;546;2;114;2.0
21;106;546;548;2;114;2.0
21;107;548;552;4;114;2.0
21;108;552;555;3;114;2.0
21;109;555;556;1;114;2.0
21;110;556;563;7;114;2.0
21;111;563;564;1;114;2.0
21;112;564;566;2;114;2.0
21;113;566;568;2;114;2.0
21;114;568;570;2;114;2.0
21;115;570;572;2;114;2.0
21;116;572;575;3;114;2.0
21;117;575;584;9;114;2.0
21;118;584;586;2;114;2.0
21;119;586;588;2;114;2.0
21;120;588;592;4;114;2.0
21;121;592;595;3;114;2.0
21;122;595;600;5;114;2.0
21;123;600;603;3;114;2.0
21;124;603;604;1;114;2.0
21;125;604;606;2;114;2.0
21;126;606;608;2;114;2.0
21;127;608;612;4;114;2.0
21;128;612;615;3;114;2.0
21;129;615;616;1;114;2.0
21;130;616;624;8;114;2.0
21;131;624;626;2;114;2.0
21;132;626;628;2;114;2.0
21;133;628;630;2;114;2.0
21;134;630;632;2;114;2.0
21;135;632;635;3;114;2.0
21;136;635;644;9;114;2.0
21;137;644;646;2;114;2.0
21;138;646;648;2;114;2.0
21;139;648;652;4;114;2.0
21;140;652;655;3;114;2.0
21;141;655;660;5;114;2.0
21;142;660;663;3;114;2.0
21;143;663;664;1;114;2.0
21;144;664;666;2;114;2.0
21;145;666;668;2;114;2.0
21;146;668;672;4;114;2.0
21;147;672;675;3;114;2.0
21;148;675;684;9;114;2.0
21;149;684;686;2;114;2.0
21;150;686;688;2;114;2.0
21;151;688;690;2;114;2.0
21;152;690;692;2;114;2.0
21;153;692;695;3;114;2.0
21;154;695;704;9;114;2.0
21;155;704;706;2;114;2.0
21;156;706;708;2;114;2.0
21;157;708;712;4;114;2.0
21;158;712;715;3;114;2.0
21;159;715;720;5;114;2.0
21;160;720;723;3;114;2.0
21;161;723;724;1;114;2.0
21;162;724;726;2;114;2.0
21;163;726;728;2;114;2.0
21;164;728;732;4;114;2.0
21;165;732;735;3;114;2.0
21;166;735;744;9;114;2.0
21;167;744;746;2;114;2.0
21;168;746;748;2;114;2.0
21;169;748;750;2;114;2.0
21;170;750;752;2;114;2.0
21;171;752;755;3;114;2.0
21;172;755;764;9;114;2.0
21;173;764;766;2;114;2.0
21;174;766;768;2;114;2.0
21;175;768;772;4;114;2.0
21;176;772;775;3;114;2.0
21;177;775;780;5;114;2.0
21;178;780;783;3;114;2.0
21;179;783;784;1;114;2.0
21;180;784;786;2;114;2.0
21;181;786;788;2;114;2.0
21;182;788;792;4;114;2.0
21;183;792;795;3;114;2.0
21;184;795;796;1;114;2.0
21;185;796;802;6;114;2.0
21;186;802;804;2;114;2.0
21;187;804;806;2;114;2.0
21;188;806;808;2;114;2.0
21;189;808;810;2;114;2.0
21;190;810;812;2;114;2.0
21;191;812;815;3;114;2.0
21;192;815;820;5;114;2.0
21;193;820;822;2;114;2.0
21;194;822;823;1;114;2.0
21;195;823;824;1;114;2.0
21;196;824;826;2;114;2.0
21;197;826;827;1;114;2.0
21;198;827;828;1;114;2.0
21;199;828;832;4;114;2.0
21;200;832;835;3;114;2.0
21;201;835;840;5;114;2.0
21;202;840;842;2;114;2.0
21;203;842;843;1;114;2.0
21;204;843;844;1;114;2.0
21;205;844;846;2;114;2.0
21;206;846;847;1;114;2.0
21;207;847;848;1;114;2.0
21;208;848;852;4;114;2.0
21;209;852;853;1;114;2.0
21;210;853;855;2;114;2.0
21;211;855;856;1;114;2.0
21;212;856;862;6;114;2.0
21;213;862;864;2;114;2.0
21;214;864;866;2;114;2.0
21;215;866;867;1;114;2.0
21;216;867;868;1;114;2.0
21;217;868;870;2;114;2.0
21;218;870;872;2;114;2.0
21;219;872;875;3;114;2.0
21;220;875;876;1;114;2.0
21;221;876;878;2;114;2.0
21;222;878;880;2;114;2.0
21;223;880;882;2;114;2.0
21;224;882;884;2;114;2.0
21;225;884;885;1;114;2.0
21;226;885;886;1;114;2.0
21;227;886;887;1;114;2.0
21;228;887;888;1;114;2.0
21;229;888;892;4;114;2.0
21;230;892;895;3;114;2.0
21;231;895;896;1;114;2.0
21;232;896;898;2;114;2.0
21;233;898;900;2;114;2.0
21;234;900;902;2;114;2.0
21;235;902;903;1;114;2.0
21;236;903;904;1;114;2.0
21;237;904;906;2;114;2.0
21;238;906;907;1;114;2.0
21;239;907;908;1;114;2.0
21;240;908;910;2;114;2.0
21;241;910;912;2;114;2.0
21;242;912;915;3;114;2.0
21;243;915;916;1;114;2.0
21;244;916;918;2;114;2.0
21;245;918;922;4;114;2.0
21;246;922;924;2;114;2.0
21;247;924;926;2;114;2.0
21;248;926;927;1;114;2.0
21;249;927;928;1;114;2.0
21;250;928;930;2;114;2.0
21;251;930;932;2;114;2.0
21;252;932;935;3;114;2.0
21;253;935;936;1;114;2.0
21;254;936;938;2;114;2.0
21;255;938;940;2;114;2.0
21;256;940;942;2;114;2.0
21;257;942;944;2;114;2.0
21;258;944;945;1;114;2.0
21;259;945;946;1;114;2.0
21;260;946;947;1;114;2.0
21;261;947;948;1;114;2.0
21;262;948;952;4;114;2.0
21;263;952;955;3;114;2.0
21;264;955;956;1;114;2.0
21;265;956;958;2;114;2.0
21;266;958;960;2;114;2.0
21;267;960;962;2;114;2.0
21;268;962;963;1;114;2.0
21;269;963;964;1;114;2.0
21;270;964;966;2;114;2.0
21;271;966;967;1;114;2.0
21;272;967;968;1;114;2.0
21;273;968;970;2;114;2.0
21;274;970;972;2;114;2.0
21;275;972;975;3;114;2.0
21;276;975;976;1;114;2.0
21;277;976;978;2;114;2.0
21;278;978;982;4;114;2.0
21;279;982;984;2;114;2.0
21;280;984;986;2;114;2.0
21;281;986;987;1;114;2.0
21;282;987;988;1;114;2.0
21;283;988;992;4;114;2.0
21;284;992;993;1;114;2.0
21;285;993;995;2;114;2.0
21;286;995;996;1;114;2.0
21;287;996;998;2;114;2.0
21;288;998;1002;4;114;2.0
21;289;1002;1004;2;114;2.0
21;290;1004;1005;1;114;2.0
21;291;1005;1006;1;114;2.0
21;292;1006;1007;1;114;2.0
21;293;1007;1008;1;114;2.0
21;294;1008;1012;4;114;2.0
21;295;1012;1015;3;114;2.0
21;296;1015;1016;1;114;2.0
21;297;1016;1022;6;114;2.0
21;298;1022;1023;1;114;2.0
21;299;1023;1024;1;114;2.0
21;300;1024;1027;3;114;2.0
21;301;1027;1031;4;114;2.0
21;302;1031;1035;4;114;2.0
21;303;1035;1037;2;114;2.0
21;304;1037;1038;1;114;2.0
21;305;1038;1044;6;114;2.0
21;306;1044;1045;1;114;2.0
21;307;1045;1046;1;114;2.0
21;308;1046;1047;1;114;2.0
21;309;1047;1052;5;114;2.0
21;310;1052;1053;1;114;2.0
21;311;1053;1055;2;114;2.0
21;312;1055;1061;6;114;2.0
21;313;1061;1064;3;114;2.0
21;314;1064;1065;1;114;2.0
21;315;1065;1067;2;114;2.0
21;316;1067;1068;1;114;2.0
21;317;1068;1075;7;114;2.0
21;318;1075;1076;1;114;2.0
21;319;1076;1079;3;114;2.0
21;320;1079;1082;3;114;2.0
21;321;1082;1083;1;114;2.0
21;322;1083;1084;1;114;2.0
21;323;1084;1087;3;114;2.0
21;324;1087;1091;4;114;2.0
21;325;1091;1095;4;114;2.0
21;326;1095;1097;2;114;2.0
21;327;1097;1098;1;114;2.0
21;328;1098;1106;8;114;2.0
21;329;1106;1107;1;114;2.0
21;330;1107;1110;3;114;2.0
21;331;1110;1112;2;114;2.0
21;332;1112;1113;1;114;2.0
21;333;1113;1114;1;114;2.0
21;334;1114;1115;1;114;2.0
21;335;1115;1117;2;114;2.0
21;336;1117;1121;4;114;2.0
21;337;1121;1124;3;114;2.0
21;338;1124;1125;1;114;2.0
21;339;1125;1126;1;114;2.0
21;340;1126;1133;7;114;2.0
21;341;1133;1135;2;114;2.0
21;342;1135;1136;1;114;2.0
21;343;1136;1137;1;114;2.0
21;344;1137;1139;2;114;2.0
21;345;1139;1145;6;114;2.0
21;346;1145;1147;2;114;2.0
21;347;1147;1148;1;114;2.0
21;348;1148;1152;4;114;2.0
21;349;1152;1154;2;114;2.0
21;350;1154;1155;1;114;2.0
21;351;1155;1157;2;114;2.0
21;352;1157;1159;2;114;2.0
21;353;1159;1163;4;114;2.0
21;354;1163;1165;2;114;2.0
21;355;1165;1168;3;114;2.0
21;356;1168;1169;1;114;2.0
21;357;1169;1175;6;114;2.0
21;358;1175;1177;2;114;2.0
21;359;1177;1182;5;114;2.0
21;360;1182;1183;1;114;2.0
21;361;1183;1184;1;114;2.0
21;362;1184;1185;1;114;2.0
21;363;1185;1189;4;114;2.0
21;364;1189;1196;7;114;2.0
21;365;1196;1200;4;114;2.0
21;366;1200;1203;3;114;2.0
21;367;1203;1204;1;114;2.0
21;368;1204;1205;1;114;2.0
21;369;1205;1207;2;114;2.0
21;370;1207;1209;2;114;2.0
21;371;1209;1217;8;114;2.0
21;372;1217;1220;3;114;2.0
21;373;1220;1223;3;114;2.0
21;374;1223;1228;5;114;2.0
21;375;1228;1230;2;114;2.0
21;376;1230;1234;4;114;2.0
21;377;1234;1239;5;114;2.0
21;378;1239;1242;3;114;2.0
21;379;1242;1243;1;114;2.0
21;380;1243;1245;2;114;2.0
21;381;1245;1255;10;114;2.0
21;382;1255;1259;4;114;2.0
21;383;1259;1268;9;114;2.0
21;384;1268;1270;2;114;2.0
21;385;1270;1276;6;114;2.0
21;386;1276;1277;1;114;2.0
21;387;1277;1279;2;114;2.0
21;388;1279;1280;1;114;2.0
21;389;1280;1284;4;114;2.0
21;390;1284;1292;8;114;2.0
21;391;1292;1293;1;114;2.0
21;392;1293;1297;4;114;2.0
21;393;1297;1303;6;114;2.0
21;394;1303;1305;2;114;2.0
21;395;1305;1309;4;114;2.0
21;396;1309;1312;3;114;2.0
21;397;1312;1317;5;114;2.0
21;398;1317;1318;1;114;2.0
21;399;1318;1319;1;114;2.0
21;400;1319;1325;6;114;2.0
21;401;1325;1329;4;114;2.0
21;402;1329;1335;6;114;2.0
21;403;1335;1342;7;114;2.0
21;404;1342;1343;1;114;2.0
21;405;1343;1347;4;114;2.0
21;406;1347;1349;2;114;2.0
21;407;1349;1354;5;114;2.0
21;408;1354;1355;1;114;2.0
21;409;1355;1370;15;114;2.0
21;410;1370;1371;1;114;2.0
21;411;1371;1380;9;114;2.0
21;412;1380;1388;8;114;2.0
21;413;1388;1403;15;114;2.0
21;414;1403;1418;15;114;2.0
21;415;1418;1433;15;114;2.0
21;416;1433;1448;15;114;2.0
21;417;1448;1463;15;114;2.0
21;418;1463;1478;15;114;2.0
21;419;1478;1493;15;114;2.0
21;420;1493;1508;15;114;2.0
21;421;1508;1523;15;114;2.0
21;422;1523;1538;15;114;2.0
21;423;1538;1553;15;114;2.0
21;424;1553;1568;15;114;2.0
21;425;1568;1583;15;114;2.0
21;426;1583;1598;15;114;2.0
21;427;1598;1613;15;114;2.0
21;428;1613;1628;15;114;2.0
21;429;1628;1643;15;114;2.0
21;430;1643;1658;15;114;2.0
21;431;1658;1680;22;114;2.0
22;0;243;329;86;42;2.0
22;1;329;335;6;42;2.0
22;2;335;341;6;42;2.0
22;3;341;342;1;42;2.0
22;4;342;344;2;42;2.0
22;5;344;346;2;42;2.0
22;6;346;350;4;42;2.0
22;7;350;352;2;42;2.0
22;8;352;353;1;42;2.0
22;9;353;355;2;42;2.0
22;10;355;356;1;42;2.0
22;11;356;357;1;42;2.0
22;12;357;358;1;42;2.0
22;13;358;359;1;42;2.0
22;14;359;364;5;42;2.0
22;15;364;365;1;42;2.0
22;16;365;370;5;42;2.0
22;17;370;371;1;42;2.0
22;18;371;372;1;42;2.0
22;19;372;379;7;42;2.0
22;20;379;382;3;42;2.0
22;21;382;385;3;42;2.0
22;22;385;386;1;42;2.0
22;23;386;389;3;42;2.0
22;24;389;392;3;42;2.0
22;25;392;394;2;42;2.0
22;26;394;396;2;42;2.0
22;27;396;399;3;42;2.0
22;28;399;402;3;42;2.0
22;29;402;406;4;42;2.0
22;30;406;409;3;42;2.0
22;31;409;411;2;42;2.0
22;32;411;412;1;42;2.0
22;33;412;414;2;42;2.0
22;34;414;415;1;42;2.0
22;35;415;416;1;42;2.0
22;36;416;419;3;42;2.0
22;37;419;420;1;42;2.0
22;38;420;422;2;42;2.0
22;39;422;424;2;42;2.0
22;40;424;426;2;42;2.0
22;41;426;429;3;42;2.0
22;42;429;431;2;42;2.0
22;43;431;432;1;42;2.0
22;44;432;436;4;42;2.0
22;45;436;439;3;42;2.0
22;46;439;441;2;42;2.0
22;47;441;442;1;42;2.0
22;48;442;444;2;42;2.0
22;49;444;445;1;42;2.0
22;50;445;446;1;42;2.0
22;51;446;449;3;42;2.0
22;52;449;452;3;42;2.0
22;53;452;454;2;42;2.0
22;54;454;456;2;42;2.0
22;55;456;459;3;42;2.0
22;56;459;462;3;42;2.0
22;57;462;466;4;42;2.0
22;58;466;469;3;42;2.0
22;59;469;471;2;42;2.0
22;60;471;472;1;42;2.0
22;61;472;474;2;42;2.0
22;62;474;475;1;42;2.0
22;63;475;476;1;42;2.0
22;64;476;479;3;42;2.0
22;65;479;480;1;42;2.0
22;66;480;482;2;42;2.0
22;67;482;484;2;42;2.0
22;68;484;486;2;42;2.0
22;69;486;489;3;42;2.0
22;70;489;491;2;42;2.0
22;71;491;492;1;42;2.0
22;72;492;494;2;42;2.0
22;73;494;496;2;42;2.0
22;74;496;499;3;42;2.0
22;75;499;501;2;42;2.0
22;76;501;502;1;42;2.0
22;77;502;506;4;42;2.0
22;78;506;507;1;42;2.0
22;79;507;509;2;42;2.0
22;80;509;512;3;42;2.0
22;81;512;514;2;42;2.0
22;82;514;516;2;42;2.0
22;83;516;519;3;42;2.0
22;84;519;522;3;42;2.0
22;85;522;524;2;42;2.0
22;86;524;526;2;42;2.0
22;87;526;529;3;42;2.0
22;88;529;532;3;42;2.0
22;89;532;535;3;42;2.0
22;90;535;539;4;42;2.0
22;91;539;542;3;42;2.0
22;92;542;546;4;42;2.0
22;93;546;549;3;42;2.0
22;94;549;552;3;42;2.0
22;95;552;559;7;42;2.0
22;96;559;560;1;42;2.0
22;97;560;562;2;42;2.0
22;98;562;566;4;42;2.0
22;99;566;569;3;42;2.0
22;100;569;572;3;42;2.0
22;101;572;574;2;42;2.0
22;102;574;579;5;42;2.0
22;103;579;582;3;42;2.0
22;104;582;586;4;42;2.0
22;105;586;589;3;42;2.0
22;106;589;592;3;42;2.0
22;107;592;595;3;42;2.0
22;108;595;599;4;42;2.0
22;109;599;602;3;42;2.0
22;110;602;606;4;42;2.0
22;111;606;609;3;42;2.0
22;112;609;612;3;42;2.0
22;113;612;619;7;42;2.0
22;114;619;620;1;42;2.0
22;115;620;622;2;42;2.0
22;116;622;626;4;42;2.0
22;117;626;629;3;42;2.0
22;118;629;632;3;42;2.0
22;119;632;634;2;42;2.0
22;120;634;639;5;42;2.0
22;121;639;642;3;42;2.0
22;122;642;646;4;42;2.0
22;123;646;649;3;42;2.0
22;124;649;652;3;42;2.0
22;125;652;655;3;42;2.0
22;126;655;659;4;42;2.0
22;127;659;662;3;42;2.0
22;128;662;666;4;42;2.0
22;129;666;669;3;42;2.0
22;130;669;672;3;42;2.0
22;131;672;679;7;42;2.0
22;132;679;682;3;42;2.0
22;133;682;686;4;42;2.0
22;134;686;689;3;42;2.0
22;135;689;692;3;42;2.0
22;136;692;694;2;42;2.0
22;137;694;699;5;42;2.0
22;138;699;702;3;42;2.0
22;139;702;706;4;42;2.0
22;140;706;709;3;42;2.0
22;141;709;712;3;42;2.0
22;142;712;715;3;42;2.0
22;143;715;719;4;42;2.0
22;144;719;722;3;42;2.0
22;145;722;726;4;42;2.0
22;146;726;729;3;42;2.0
22;147;729;732;3;42;2.0
22;148;732;739;7;42;2.0
22;149;739;742;3;42;2.0
22;150;742;746;4;42;2.0
22;151;746;749;3;42;2.0
22;152;749;752;3;42;2.0
22;153;752;754;2;42;2.0
22;154;754;759;5;42;2.0
22;155;759;762;3;42;2.0
22;156;762;766;4;42;2.0
22;157;766;769;3;42;2.0
22;158;769;772;3;42;2.0
22;159;772;775;3;42;2.0
22;160;775;779;4;42;2.0
22;161;779;782;3;42;2.0
22;162;782;786;4;42;2.0
22;163;786;789;3;42;2.0
22;164;789;792;3;42;2.0
22;165;792;799;7;42;2.0
22;166;799;800;1;42;2.0
22;167;800;802;2;42;2.0
22;168;802;806;4;42;2.0
22;169;806;809;3;42;2.0
22;170;809;812;3;42;2.0
22;171;812;814;2;42;2.0
22;172;814;815;1;42;2.0
22;173;815;819;4;42;2.0
22;174;819;822;3;42;2.0
22;175;822;826;4;42;2.0
22;176;826;829;3;42;2.0
22;177;829;831;2;42;2.0
22;178;831;832;1;42;2.0
22;179;832;835;3;42;2.0
22;180;835;839;4;42;2.0
22;181;839;842;3;42;2.0
22;182;842;846;4;42;2.0
22;183;846;849;3;42;2.0
22;184;849;850;1;42;2.0
22;185;850;851;1;42;2.0
22;186;851;852;1;42;2.0
22;187;852;857;5;42;2.0
22;188;857;859;2;42;2.0
22;189;859;860;1;42;2.0
22;190;860;862;2;42;2.0
22;191;862;866;4;42;2.0
22;192;866;869;3;42;2.0
22;193;869;871;2;42;2.0
22;194;871;872;1;42;2.0
22;195;872;874;2;42;2.0
22;196;874;875;1;42;2.0
22;197;875;876;1;42;2.0
22;198;876;879;3;42;2.0
22;199;879;882;3;42;2.0
22;200;882;886;4;42;2.0
22;201;886;889;3;42;2.0
22;202;889;891;2;42;2.0
22;203;891;892;1;42;2.0
22;204;892;895;3;42;2.0
22;205;895;896;1;42;2.0
22;206;896;899;3;42;2.0
22;207;899;902;3;42;2.0
22;208;902;906;4;42;2.0
22;209;906;909;3;42;2.0
22;210;909;910;1;42;2.0
22;211;910;911;1;42;2.0
22;212;911;912;1;42;2.0
22;213;912;914;2;42;2.0
22;214;914;916;2;42;2.0
22;215;916;919;3;42;2.0
22;216;919;920;1;42;2.0
22;217;920;922;2;42;2.0
22;218;922;926;4;42;2.0
22;219;926;929;3;42;2.0
22;220;929;931;2;42;2.0
22;221;931;932;1;42;2.0
22;222;932;934;2;42;2.0
22;223;934;935;1;42;2.0
22;224;935;936;1;42;2.0
22;225;936;939;3;42;2.0
22;226;939;942;3;42;2.0
22;227;942;946;4;42;2.0
22;228;946;949;3;42;2.0
22;229;949;951;2;42;2.0
22;230;951;952;1;42;2.0
22;231;952;955;3;42;2.0
22;232;955;956;1;42;2.0
22;233;956;959;3;42;2.0
22;234;959;962;3;42;2.0
22;235;962;966;4;42;2.0
22;236;966;969;3;42;2.0
22;237;969;970;1;42;2.0
22;238;970;971;1;42;2.0
22;239;971;972;1;42;2.0
22;240;972;974;2;42;2.0
22;241;974;976;2;42;2.0
22;242;976;979;3;42;2.0
22;243;979;980;1;42;2.0
22;244;980;982;2;42;2.0
22;245;982;986;4;42;2.0
22;246;986;989;3;42;2.0
22;247;989;991;2;42;2.0
22;248;991;992;1;42;2.0
22;249;992;996;4;42;2.0
22;250;996;997;1;42;2.0
22;251;997;999;2;42;2.0
22;252;999;1002;3;42;2.0
22;253;1002;1006;4;42;2.0
22;254;1006;1009;3;42;2.0
22;255;1009;1010;1;42;2.0
22;256;1010;1011;1;42;2.0
22;257;1011;1012;1;42;2.0
22;258;1012;1019;7;42;2.0
22;259;1019;1021;2;42;2.0
22;260;1021;1022;1;42;2.0
22;261;1022;1027;5;42;2.0
22;262;1027;1030;3;42;2.0
22;263;1030;1031;1;42;2.0
22;264;1031;1032;1;42;2.0
22;265;1032;1034;2;42;2.0
22;266;1034;1036;2;42;2.0
22;267;1036;1039;3;42;2.0
22;268;1039;1042;3;42;2.0
22;269;1042;1049;7;42;2.0
22;270;1049;1051;2;42;2.0
22;271;1051;1052;1;42;2.0
22;272;1052;1057;5;42;2.0
22;273;1057;1059;2;42;2.0
22;274;1059;1062;3;42;2.0
22;275;1062;1064;2;42;2.0
22;276;1064;1066;2;42;2.0
22;277;1066;1069;3;42;2.0
22;278;1069;1071;2;42;2.0
22;279;1071;1072;1;42;2.0
22;280;1072;1074;2;42;2.0
22;281;1074;1079;5;42;2.0
22;282;1079;1081;2;42;2.0
22;283;1081;1082;1;42;2.0
22;284;1082;1087;5;42;2.0
22;285;1087;1091;4;42;2.0
22;286;1091;1092;1;42;2.0
22;287;1092;1094;2;42;2.0
22;288;1094;1096;2;42;2.0
22;289;1096;1099;3;42;2.0
22;290;1099;1102;3;42;2.0
22;291;1102;1109;7;42;2.0
22;292;1109;1110;1;42;2.0
22;293;1110;1111;1;42;2.0
22;294;1111;1114;3;42;2.0
22;295;1114;1117;3;42;2.0
22;296;1117;1119;2;42;2.0
22;297;1119;1121;2;42;2.0
22;298;1121;1123;2;42;2.0
22;299;1123;1129;6;42;2.0
22;300;1129;1130;1;42;2.0
22;301;1130;1131;1;42;2.0
22;302;1131;1135;4;42;2.0
22;303;1135;1136;1;42;2.0
22;304;1136;1139;3;42;2.0
22;305;1139;1143;4;42;2.0
22;306;1143;1144;1;42;2.0
22;307;1144;1149;5;42;2.0
22;308;1149;1151;2;42;2.0
22;309;1151;1155;4;42;2.0
22;310;1155;1156;1;42;2.0
22;311;1156;1159;3;42;2.0
22;312;1159;1163;4;42;2.0
22;313;1163;1166;3;42;2.0
22;314;1166;1172;6;42;2.0
22;315;1172;1174;2;42;2.0
22;316;1174;1179;5;42;2.0
22;317;1179;1180;1;42;2.0
22;318;1180;1181;1;42;2.0
22;319;1181;1183;2;42;2.0
22;320;1183;1186;3;42;2.0
22;321;1186;1191;5;42;2.0
22;322;1191;1199;8;42;2.0
22;323;1199;1201;2;42;2.0
22;324;1201;1203;2;42;2.0
22;325;1203;1204;1;42;2.0
22;326;1204;1205;1;42;2.0
22;327;1205;1206;1;42;2.0
22;328;1206;1213;7;42;2.0
22;329;1213;1219;6;42;2.0
22;330;1219;1224;5;42;2.0
22;331;1224;1228;4;42;2.0
22;332;1228;1231;3;42;2.0
22;333;1231;1232;1;42;2.0
22;334;1232;1236;4;42;2.0
22;335;1236;1239;3;42;2.0
22;336;1239;1240;1;42;2.0
22;337;1240;1249;9;42;2.0
22;338;1249;1253;4;42;2.0
22;339;1253;1256;3;42;2.0
22;340;1256;1264;8;42;2.0
22;341;1264;1271;7;42;2.0
22;342;1271;1274;3;42;2.0
22;343;1274;1275;1;42;2.0
22;344;1275;1276;1;42;2.0
22;345;1276;1278;2;42;2.0
22;346;1278;1281;3;42;2.0
22;347;1281;1288;7;42;2.0
22;348;1288;1289;1;42;2.0
22;349;1289;1301;12;42;2.0
22;350;1301;1303;2;42;2.0
22;351;1303;1306;3;42;2.0
22;352;1306;1307;1;42;2.0
22;353;1307;1310;3;42;2.0
22;354;1310;1313;3;42;2.0
22;355;1313;1314;1;42;2.0
22;356;1314;1316;2;42;2.0
22;357;1316;1326;10;42;2.0
22;358;1326;1329;3;42;2.0
22;359;1329;1333;4;42;2.0
22;360;1333;1338;5;42;2.0
22;361;1338;1339;1;42;2.0
22;362;1339;1341;2;42;2.0
22;363;1341;1346;5;42;2.0
22;364;1346;1351;5;42;2.0
22;365;1351;1353;2;42;2.0
22;366;1353;1359;6;42;2.0
22;367;1359;1367;8;42;2.0
22;368;1367;1368;1;42;2.0
22;369;1368;1384;16;42;2.0
22;370;1384;1399;15;42;2.0
22;371;1399;1414;15;42;2.0
22;372;1414;1429;15;42;2.0
22;373;1429;1444;15;42;2.0
22;374;1444;1459;15;42;2.0
22;375;1459;1474;15;42;2.0
22;376;1474;1489;15;42;2.0
22;377;1489;1504;15;42;2.0
22;378;1504;1519;15;42;2.0
22;379;1519;1534;15;42;2.0
22;380;1534;1549;15;42;2.0
22;381;1549;1564;15;42;2.0
22;382;1564;1579;15;42;2.0
22;383;1579;1594;15;42;2.0
22;384;1594;1609;15;42;2.0
22;385;1609;1624;15;42;2.0
22;386;1624;1639;15;42;2.0
22;387;1639;1654;15;42;2.0
22;388;1654;1669;15;42;2.0
22;389;1669;1680;11;42;2.0
23;0;245;330;85;25;2.0
23;1;330;335;5;25;2.0
23;2;335;340;5;25;2.0
23;3;340;341;1;25;2.0
23;4;341;342;1;25;2.0
23;5;342;343;1;25;2.0
23;6;343;345;2;25;2.0
23;7;345;350;5;25;2.0
23;8;350;352;2;25;2.0
23;9;352;353;1;25;2.0
23;10;353;356;3;25;2.0
23;11;356;358;2;25;2.0
23;12;358;360;2;25;2.0
23;13;360;363;3;25;2.0
23;14;363;365;2;25;2.0
23;15;365;370;5;25;2.0
23;16;370;371;1;25;2.0
23;17;371;372;1;25;2.0
23;18;372;378;6;25;2.0
23;19;378;379;1;25;2.0
23;20;379;380;1;25;2.0
23;21;380;382;2;25;2.0
23;22;382;383;1;25;2.0
23;23;383;386;3;25;2.0
23;24;386;389;3;25;2.0
23;25;389;392;3;25;2.0
23;26;392;393;1;25;2.0
23;27;393;395;2;25;2.0
23;28;395;396;1;25;2.0
23;29;396;399;3;25;2.0
23;30;399;402;3;25;2.0
23;31;402;403;1;25;2.0
23;32;403;406;3;25;2.0
23;33;406;409;3;25;2.0
23;34;409;410;1;25;2.0
23;35;410;412;2;25;2.0
23;36;412;413;1;25;2.0
23;37;413;416;3;25;2.0
23;38;416;419;3;25;2.0
23;39;419;420;1;25;2.0
23;40;420;422;2;25;2.0
23;41;422;423;1;25;2.0
23;42;423;426;3;25;2.0
23;43;426;429;3;25;2.0
23;44;429;430;1;25;2.0
23;45;430;432;2;25;2.0
23;46;432;433;1;25;2.0
23;47;433;436;3;25;2.0
23;48;436;439;3;25;2.0
23;49;439;440;1;25;2.0
23;50;440;442;2;25;2.0
23;51;442;443;1;25;2.0
23;52;443;446;3;25;2.0
23;53;446;449;3;25;2.0
23;54;449;452;3;25;2.0
23;55;452;453;1;25;2.0
23;56;453;455;2;25;2.0
23;57;455;456;1;25;2.0
23;58;456;458;2;25;2.0
23;59;458;459;1;25;2.0
23;60;459;460;1;25;2.0
23;61;460;462;2;25;2.0
23;62;462;463;1;25;2.0
23;63;463;466;3;25;2.0
23;64;466;469;3;25;2.0
23;65;469;470;1;25;2.0
23;66;470;472;2;25;2.0
23;67;472;473;1;25;2.0
23;68;473;476;3;25;2.0
23;69;476;479;3;25;2.0
23;70;479;480;1;25;2.0
23;71;480;482;2;25;2.0
23;72;482;483;1;25;2.0
23;73;483;486;3;25;2.0
23;74;486;488;2;25;2.0
23;75;488;489;1;25;2.0
23;76;489;490;1;25;2.0
23;77;490;492;2;25;2.0
23;78;492;493;1;25;2.0
23;79;493;496;3;25;2.0
23;80;496;500;4;25;2.0
23;81;500;502;2;25;2.0
23;82;502;506;4;25;2.0
23;83;506;508;2;25;2.0
23;84;508;509;1;25;2.0
23;85;509;512;3;25;2.0
23;86;512;513;1;25;2.0
23;87;513;516;3;25;2.0
23;88;516;518;2;25;2.0
23;89;518;520;2;25;2.0
23;90;520;522;2;25;2.0
23;91;522;525;3;25;2.0
23;92;525;526;1;25;2.0
23;93;526;529;3;25;2.0
23;94;529;532;3;25;2.0
23;95;532;536;4;25;2.0
23;96;536;538;2;25;2.0
23;97;538;542;4;25;2.0
23;98;542;543;1;25;2.0
23;99;543;546;3;25;2.0
23;100;546;549;3;25;2.0
23;101;549;552;3;25;2.0
23;102;552;558;6;25;2.0
23;103;558;560;2;25;2.0
23;104;560;562;2;25;2.0
23;105;562;563;1;25;2.0
23;106;563;566;3;25;2.0
23;107;566;569;3;25;2.0
23;108;569;572;3;25;2.0
23;109;572;573;1;25;2.0
23;110;573;578;5;25;2.0
23;111;578;582;4;25;2.0
23;112;582;583;1;25;2.0
23;113;583;586;3;25;2.0
23;114;586;589;3;25;2.0
23;115;589;592;3;25;2.0
23;116;592;596;4;25;2.0
23;117;596;598;2;25;2.0
23;118;598;600;2;25;2.0
23;119;600;602;2;25;2.0
23;120;602;603;1;25;2.0
23;121;603;606;3;25;2.0
23;122;606;609;3;25;2.0
23;123;609;612;3;25;2.0
23;124;612;618;6;25;2.0
23;125;618;620;2;25;2.0
23;126;620;622;2;25;2.0
23;127;622;623;1;25;2.0
23;128;623;626;3;25;2.0
23;129;626;629;3;25;2.0
23;130;629;632;3;25;2.0
23;131;632;633;1;25;2.0
23;132;633;638;5;25;2.0
23;133;638;642;4;25;2.0
23;134;642;643;1;25;2.0
23;135;643;646;3;25;2.0
23;136;646;649;3;25;2.0
23;137;649;652;3;25;2.0
23;138;652;656;4;25;2.0
23;139;656;658;2;25;2.0
23;140;658;660;2;25;2.0
23;141;660;662;2;25;2.0
23;142;662;663;1;25;2.0
23;143;663;666;3;25;2.0
23;144;666;669;3;25;2.0
23;145;669;672;3;25;2.0
23;146;672;678;6;25;2.0
23;147;678;682;4;25;2.0
23;148;682;683;1;25;2.0
23;149;683;686;3;25;2.0
23;150;686;689;3;25;2.0
23;151;689;692;3;25;2.0
23;152;692;693;1;25;2.0
23;153;693;698;5;25;2.0
23;154;698;702;4;25;2.0
23;155;702;703;1;25;2.0
23;156;703;706;3;25;2.0
23;157;706;709;3;25;2.0
23;158;709;712;3;25;2.0
23;159;712;716;4;25;2.0
23;160;716;718;2;25;2.0
23;161;718;720;2;25;2.0
23;162;720;722;2;25;2.0
23;163;722;723;1;25;2.0
23;164;723;726;3;25;2.0
23;165;726;729;3;25;2.0
23;166;729;732;3;25;2.0
23;167;732;738;6;25;2.0
23;168;738;742;4;25;2.0
23;169;742;743;1;25;2.0
23;170;743;746;3;25;2.0
23;171;746;749;3;25;2.0
23;172;749;752;3;25;2.0
23;173;752;753;1;25;2.0
23;174;753;758;5;25;2.0
23;175;758;762;4;25;2.0
23;176;762;763;1;25;2.0
23;177;763;766;3;25;2.0
23;178;766;769;3;25;2.0
23;179;769;772;3;25;2.0
23;180;772;776;4;25;2.0
23;181;776;778;2;25;2.0
23;182;778;780;2;25;2.0
23;183;780;782;2;25;2.0
23;184;782;783;1;25;2.0
23;185;783;786;3;25;2.0
23;186;786;789;3;25;2.0
23;187;789;792;3;25;2.0
23;188;792;798;6;25;2.0
23;189;798;799;1;25;2.0
23;190;799;800;1;25;2.0
23;191;800;802;2;25;2.0
23;192;802;803;1;25;2.0
23;193;803;806;3;25;2.0
23;194;806;809;3;25;2.0
23;195;809;812;3;25;2.0
23;196;812;813;1;25;2.0
23;197;813;816;3;25;2.0
23;198;816;818;2;25;2.0
23;199;818;819;1;25;2.0
23;200;819;820;1;25;2.0
23;201;820;822;2;25;2.0
23;202;822;823;1;25;2.0
23;203;823;826;3;25;2.0
23;204;826;829;3;25;2.0
23;205;829;830;1;25;2.0
23;206;830;832;2;25;2.0
23;207;832;836;4;25;2.0
23;208;836;838;2;25;2.0
23;209;838;839;1;25;2.0
23;210;839;840;1;25;2.0
23;211;840;842;2;25;2.0
23;212;842;843;1;25;2.0
23;213;843;846;3;25;2.0
23;214;846;849;3;25;2.0
23;215;849;850;1;25;2.0
23;216;850;851;1;25;2.0
23;217;851;852;1;25;2.0
23;218;852;853;1;25;2.0
23;219;853;856;3;25;2.0
23;220;856;858;2;25;2.0
23;221;858;859;1;25;2.0
23;222;859;860;1;25;2.0
23;223;860;862;2;25;2.0
23;224;862;863;1;25;2.0
23;225;863;866;3;25;2.0
23;226;866;869;3;25;2.0
23;227;869;870;1;25;2.0
23;228;870;872;2;25;2.0
23;229;872;873;1;25;2.0
23;230;873;876;3;25;2.0
23;231;876;878;2;25;2.0
23;232;878;879;1;25;2.0
23;233;879;882;3;25;2.0
23;234;882;883;1;25;2.0
23;235;883;886;3;25;2.0
23;236;886;888;2;25;2.0
23;237;888;889;1;25;2.0
23;238;889;890;1;25;2.0
23;239;890;892;2;25;2.0
23;240;892;893;1;25;2.0
23;241;893;896;3;25;2.0
23;242;896;898;2;25;2.0
23;243;898;899;1;25;2.0
23;244;899;900;1;25;2.0
23;245;900;902;2;25;2.0
23;246;902;903;1;25;2.0
23;247;903;906;3;25;2.0
23;248;906;909;3;25;2.0
23;249;909;910;1;25;2.0
23;250;910;911;1;25;2.0
23;251;911;912;1;25;2.0
23;252;912;913;1;25;2.0
23;253;913;916;3;25;2.0
23;254;916;918;2;25;2.0
23;255;918;919;1;25;2.0
23;256;919;920;1;25;2.0
23;257;920;922;2;25;2.0
23;258;922;923;1;25;2.0
23;259;923;926;3;25;2.0
23;260;926;929;3;25;2.0
23;261;929;930;1;25;2.0
23;262;930;932;2;25;2.0
23;263;932;933;1;25;2.0
23;264;933;936;3;25;2.0
23;265;936;938;2;25;2.0
23;266;938;939;1;25;2.0
23;267;939;942;3;25;2.0
23;268;942;943;1;25;2.0
23;269;943;946;3;25;2.0
23;270;946;948;2;25;2.0
23;271;948;949;1;25;2.0
23;272;949;950;1;25;2.0
23;273;950;952;2;25;2.0
23;274;952;953;1;25;2.0
23;275;953;956;3;25;2.0
23;276;956;958;2;25;2.0
23;277;958;959;1;25;2.0
23;278;959;960;1;25;2.0
23;279;960;962;2;25;2.0
23;280;962;963;1;25;2.0
23;281;963;966;3;25;2.0
23;282;966;969;3;25;2.0
23;283;969;970;1;25;2.0
23;284;970;971;1;25;2.0
23;285;971;972;1;25;2.0
23;286;972;973;1;25;2.0
23;287;973;976;3;25;2.0
23;288;976;978;2;25;2.0
23;289;978;979;1;25;2.0
23;290;979;980;1;25;2.0
23;291;980;982;2;25;2.0
23;292;982;983;1;25;2.0
23;293;983;986;3;25;2.0
23;294;986;989;3;25;2.0
23;295;989;990;1;25;2.0
23;296;990;992;2;25;2.0
23;297;992;993;1;25;2.0
23;298;993;996;3;25;2.0
23;299;996;998;2;25;2.0
23;300;998;999;1;25;2.0
23;301;999;1002;3;25;2.0
23;302;1002;1003;1;25;2.0
23;303;1003;1006;3;25;2.0
23;304;1006;1008;2;25;2.0
23;305;1008;1009;1;25;2.0
23;306;1009;1010;1;25;2.0
23;307;1010;1011;1;25;2.0
23;308;1011;1012;1;25;2.0
23;309;1012;1013;1;25;2.0
23;310;1013;1018;5;25;2.0
23;311;1018;1019;1;25;2.0
23;312;1019;1020;1;25;2.0
23;313;1020;1021;1;25;2.0
23;314;1021;1022;1;25;2.0
23;315;1022;1028;6;25;2.0
23;316;1028;1030;2;25;2.0
23;317;1030;1031;1;25;2.0
23;318;1031;1032;1;25;2.0
23;319;1032;1034;2;25;2.0
23;320;1034;1036;2;25;2.0
23;321;1036;1038;2;25;2.0
23;322;1038;1042;4;25;2.0
23;323;1042;1043;1;25;2.0
23;324;1043;1048;5;25;2.0
23;325;1048;1049;1;25;2.0
23;326;1049;1050;1;25;2.0
23;327;1050;1051;1;25;2.0
23;328;1051;1052;1;25;2.0
23;329;1052;1058;6;25;2.0
23;330;1058;1062;4;25;2.0
23;331;1062;1064;2;25;2.0
23;332;1064;1066;2;25;2.0
23;333;1066;1068;2;25;2.0
23;334;1068;1070;2;25;2.0
23;335;1070;1072;2;25;2.0
23;336;1072;1073;1;25;2.0
23;337;1073;1075;2;25;2.0
23;338;1075;1078;3;25;2.0
23;339;1078;1079;1;25;2.0
23;340;1079;1080;1;25;2.0
23;341;1080;1081;1;25;2.0
23;342;1081;1082;1;25;2.0
23;343;1082;1088;6;25;2.0
23;344;1088;1090;2;25;2.0
23;345;1090;1092;2;25;2.0
23;346;1092;1094;2;25;2.0
23;347;1094;1096;2;25;2.0
23;348;1096;1098;2;25;2.0
23;349;1098;1103;5;25;2.0
23;350;1103;1109;6;25;2.0
23;351;1109;1110;1;25;2.0
23;352;1110;1111;1;25;2.0
23;353;1111;1113;2;25;2.0
23;354;1113;1114;1;25;2.0
23;355;1114;1118;4;25;2.0
23;356;1118;1121;3;25;2.0
23;357;1121;1123;2;25;2.0
23;358;1123;1129;6;25;2.0
23;359;1129;1130;1;25;2.0
23;360;1130;1132;2;25;2.0
23;361;1132;1135;3;25;2.0
23;362;1135;1136;1;25;2.0
23;363;1136;1138;2;25;2.0
23;364;1138;1143;5;25;2.0
23;365;1143;1144;1;25;2.0
23;366;1144;1145;1;25;2.0
23;367;1145;1149;4;25;2.0
23;368;1149;1151;2;25;2.0
23;369;1151;1155;4;25;2.0
23;370;1155;1156;1;25;2.0
23;371;1156;1158;2;25;2.0
23;372;1158;1160;2;25;2.0
23;373;1160;1163;3;25;2.0
23;374;1163;1166;3;25;2.0
23;375;1166;1171;5;25;2.0
23;376;1171;1174;3;25;2.0
23;377;1174;1178;4;25;2.0
23;378;1178;1180;2;25;2.0
23;379;1180;1181;1;25;2.0
23;380;1181;1183;2;25;2.0
23;381;1183;1186;3;25;2.0
23;382;1186;1192;6;25;2.0
23;383;1192;1200;8;25;2.0
23;384;1200;1201;1;25;2.0
23;385;1201;1203;2;25;2.0
23;386;1203;1205;2;25;2.0
23;387;1205;1206;1;25;2.0
23;388;1206;1214;8;25;2.0
23;389;1214;1220;6;25;2.0
23;390;1220;1223;3;25;2.0
23;391;1223;1228;5;25;2.0
23;392;1228;1231;3;25;2.0
23;393;1231;1236;5;25;2.0
23;394;1236;1240;4;25;2.0
23;395;1240;1248;8;25;2.0
23;396;1248;1253;5;25;2.0
23;397;1253;1256;3;25;2.0
23;398;1256;1265;9;25;2.0
23;399;1265;1272;7;25;2.0
23;400;1272;1273;1;25;2.0
23;401;1273;1275;2;25;2.0
23;402;1275;1276;1;25;2.0
23;403;1276;1278;2;25;2.0
23;404;1278;1281;3;25;2.0
23;405;1281;1289;8;25;2.0
23;406;1289;1290;1;25;2.0
23;407;1290;1300;10;25;2.0
23;408;1300;1303;3;25;2.0
23;409;1303;1306;3;25;2.0
23;410;1306;1310;4;25;2.0
23;411;1310;1314;4;25;2.0
23;412;1314;1315;1;25;2.0
23;413;1315;1316;1;25;2.0
23;414;1316;1326;10;25;2.0
23;415;1326;1328;2;25;2.0
23;416;1328;1333;5;25;2.0
23;417;1333;1339;6;25;2.0
23;418;1339;1340;1;25;2.0
23;419;1340;1342;2;25;2.0
23;420;1342;1346;4;25;2.0
23;421;1346;1351;5;25;2.0
23;422;1351;1353;2;25;2.0
23;423;1353;1358;5;25;2.0
23;424;1358;1367;9;25;2.0
23;425;1367;1368;1;25;2.0
23;426;1368;1383;15;25;2.0
23;427;1383;1385;2;25;2.0
23;428;1385;1400;15;25;2.0
23;429;1400;1415;15;25;2.0
23;430;1415;1430;15;25;2.0
23;431;1430;1445;15;25;2.0
23;432;1445;1460;15;25;2.0
23;433;1460;1475;15;25;2.0
23;434;1475;1490;15;25;2.0
23;435;1490;1505;15;25;2.0
23;436;1505;1520;15;25;2.0
23;437;1520;1535;15;25;2.0
23;438;1535;1550;15;25;2.0
23;439;1550;1565;15;25;2.0
23;440;1565;1580;15;25;2.0
23;441;1580;1595;15;25;2.0
23;442;1595;1610;15;25;2.0
23;443;1610;1625;15;25;2.0
23;444;1625;1640;15;25;2.0
23;445;1640;1655;15;25;2.0
23;446;1655;1670;15;25;2.0
23;447;1670;1680;10;25;2.0
24;0;240;328;88;0;0.83
24;1;328;333;5;0;0.83
24;2;333;340;7;0;0.83
24;3;340;341;1;0;0.83
24;4;341;344;3;0;0.83
24;5;344;347;3;0;0.83
24;6;347;348;1;0;0.83
24;7;348;349;1;0;0.83
24;8;349;350;1;0;0.83
24;9;350;352;2;0;0.83
24;10;352;353;1;0;0.83
24;11;353;355;2;0;0.83
24;12;355;356;1;0;0.83
24;13;356;358;2;0;0.83
24;14;358;363;5;0;0.83
24;15;363;367;4;0;0.83
24;16;367;369;2;0;0.83
24;17;369;370;1;0;0.83
24;18;370;371;1;0;0.83
24;19;371;374;3;0;0.83
24;20;374;377;3;0;0.83
24;21;377;378;1;0;0.83
24;22;378;381;3;0;0.83
24;23;381;382;1;0;0.83
24;24;382;383;1;0;0.83
24;25;383;386;3;0;0.83
24;26;386;387;1;0;0.83
24;27;387;390;3;0;0.83
24;28;390;391;1;0;0.83
24;29;391;396;5;0;0.83
24;30;396;397;1;0;0.83
24;31;397;399;2;0;0.83
24;32;399;401;2;0;0.83
24;33;401;402;1;0;0.83
24;34;402;406;4;0;0.83
24;35;406;407;1;0;0.83
24;36;407;408;1;0;0.83
24;37;408;410;2;0;0.83
24;38;410;411;1;0;0.83
24;39;411;413;2;0;0.83
24;40;413;414;1;0;0.83
24;41;414;416;2;0;0.83
24;42;416;417;1;0;0.83
24;43;417;418;1;0;0.83
24;44;418;421;3;0;0.83
24;45;421;422;1;0;0.83
24;46;422;426;4;0;0.83
24;47;426;427;1;0;0.83
24;48;427;428;1;0;0.83
24;49;428;430;2;0;0.83
24;50;430;431;1;0;0.83
24;51;431;434;3;0;0.83
24;52;434;436;2;0;0.83
24;53;436;437;1;0;0.83
24;54;437;441;4;0;0.83
24;55;441;442;1;0;0.83
24;56;442;443;1;0;0.83
24;57;443;444;1;0;0.83
24;58;444;446;2;0;0.83
24;59;446;447;1;0;0.83
24;60;447;450;3;0;0.83
24;61;450;451;1;0;0.83
24;62;451;456;5;0;0.83
24;63;456;457;1;0;0.83
24;64;457;458;1;0;0.83
24;65;458;459;1;0;0.83
24;66;459;461;2;0;0.83
24;67;461;462;1;0;0.83
24;68;462;466;4;0;0.83
24;69;466;467;1;0;0.83
24;70;467;468;1;0;0.83
24;71;468;470;2;0;0.83
24;72;470;471;1;0;0.83
24;73;471;473;2;0;0.83
24;74;473;474;1;0;0.83
24;75;474;476;2;0;0.83
24;76;476;477;1;0;0.83
24;77;477;478;1;0;0.83
24;78;478;481;3;0;0.83
24;79;481;482;1;0;0.83
24;80;482;486;4;0;0.83
24;81;486;487;1;0;0.83
24;82;487;490;3;0;0.83
24;83;490;491;1;0;0.83
24;84;491;494;3;0;0.83
24;85;494;496;2;0;0.83
24;86;496;497;1;0;0.83
24;87;497;498;1;0;0.83
24;88;498;502;4;0;0.83
24;89;502;504;2;0;0.83
24;90;504;506;2;0;0.83
24;91;506;507;1;0;0.83
24;92;507;510;3;0;0.83
24;93;510;516;6;0;0.83
24;94;516;517;1;0;0.83
24;95;517;518;1;0;0.83
24;96;518;522;4;0;0.83
24;97;522;523;1;0;0.83
24;98;523;526;3;0;0.83
24;99;526;527;1;0;0.83
24;100;527;530;3;0;0.83
24;101;530;531;1;0;0.83
24;102;531;533;2;0;0.83
24;103;533;541;8;0;0.83
24;104;541;542;1;0;0.83
24;105;542;546;4;0;0.83
24;106;546;547;1;0;0.83
24;107;547;550;3;0;0.83
24;108;550;558;8;0;0.83
24;109;558;561;3;0;0.83
24;110;561;562;1;0;0.83
24;111;562;566;4;0;0.83
24;112;566;567;1;0;0.83
24;113;567;570;3;0;0.83
24;114;570;571;1;0;0.83
24;115;571;577;6;0;0.83
24;116;577;581;4;0;0.83
24;117;581;582;1;0;0.83
24;118;582;586;4;0;0.83
24;119;586;587;1;0;0.83
24;120;587;590;3;0;0.83
24;121;590;593;3;0;0.83
24;122;593;598;5;0;0.83
24;123;598;601;3;0;0.83
24;124;601;602;1;0;0.83
24;125;602;606;4;0;0.83
24;126;606;607;1;0;0.83
24;127;607;610;3;0;0.83
24;128;610;611;1;0;0.83
24;129;611;621;10;0;0.83
24;130;621;622;1;0;0.83
24;131;622;626;4;0;0.83
24;132;626;627;1;0;0.83
24;133;627;630;3;0;0.83
24;134;630;631;1;0;0.83
24;135;631;637;6;0;0.83
24;136;637;641;4;0;0.83
24;137;641;642;1;0;0.83
24;138;642;646;4;0;0.83
24;139;646;647;1;0;0.83
24;140;647;650;3;0;0.83
24;141;650;653;3;0;0.83
24;142;653;658;5;0;0.83
24;143;658;661;3;0;0.83
24;144;661;662;1;0;0.83
24;145;662;666;4;0;0.83
24;146;666;667;1;0;0.83
24;147;667;670;3;0;0.83
24;148;670;671;1;0;0.83
24;149;671;681;10;0;0.83
24;150;681;682;1;0;0.83
24;151;682;686;4;0;0.83
24;152;686;687;1;0;0.83
24;153;687;690;3;0;0.83
24;154;690;691;1;0;0.83
24;155;691;697;6;0;0.83
24;156;697;701;4;0;0.83
24;157;701;702;1;0;0.83
24;158;702;706;4;0;0.83
24;159;706;707;1;0;0.83
24;160;707;710;3;0;0.83
24;161;710;713;3;0;0.83
24;162;713;718;5;0;0.83
24;163;718;721;3;0;0.83
24;164;721;722;1;0;0.83
24;165;722;726;4;0;0.83
24;166;726;727;1;0;0.83
24;167;727;730;3;0;0.83
24;168;730;731;1;0;0.83
24;169;731;741;10;0;0.83
24;170;741;742;1;0;0.83
24;171;742;746;4;0;0.83
24;172;746;747;1;0;0.83
24;173;747;750;3;0;0.83
24;174;750;751;1;0;0.83
24;175;751;757;6;0;0.83
24;176;757;761;4;0;0.83
24;177;761;762;1;0;0.83
24;178;762;766;4;0;0.83
24;179;766;767;1;0;0.83
24;180;767;770;3;0;0.83
24;181;770;773;3;0;0.83
24;182;773;778;5;0;0.83
24;183;778;781;3;0;0.83
24;184;781;782;1;0;0.83
24;185;782;786;4;0;0.83
24;186;786;787;1;0;0.83
24;187;787;790;3;0;0.83
24;188;790;791;1;0;0.83
24;189;791;797;6;0;0.83
24;190;797;801;4;0;0.83
24;191;801;802;1;0;0.83
24;192;802;806;4;0;0.83
24;193;806;807;1;0;0.83
24;194;807;810;3;0;0.83
24;195;810;813;3;0;0.83
24;196;813;817;4;0;0.83
24;197;817;818;1;0;0.83
24;198;818;821;3;0;0.83
24;199;821;822;1;0;0.83
24;200;822;826;4;0;0.83
24;201;826;827;1;0;0.83
24;202;827;830;3;0;0.83
24;203;830;833;3;0;0.83
24;204;833;834;1;0;0.83
24;205;834;837;3;0;0.83
24;206;837;838;1;0;0.83
24;207;838;841;3;0;0.83
24;208;841;842;1;0;0.83
24;209;842;846;4;0;0.83
24;210;846;847;1;0;0.83
24;211;847;848;1;0;0.83
24;212;848;850;2;0;0.83
24;213;850;851;1;0;0.83
24;214;851;854;3;0;0.83
24;215;854;857;3;0;0.83
24;216;857;860;3;0;0.83
24;217;860;861;1;0;0.83
24;218;861;862;1;0;0.83
24;219;862;866;4;0;0.83
24;220;866;867;1;0;0.83
24;221;867;870;3;0;0.83
24;222;870;871;1;0;0.83
24;223;871;873;2;0;0.83
24;224;873;874;1;0;0.83
24;225;874;876;2;0;0.83
24;226;876;877;1;0;0.83
24;227;877;881;4;0;0.83
24;228;881;882;1;0;0.83
24;229;882;886;4;0;0.83
24;230;886;887;1;0;0.83
24;231;887;890;3;0;0.83
24;232;890;891;1;0;0.83
24;233;891;892;1;0;0.83
24;234;892;893;1;0;0.83
24;235;893;894;1;0;0.83
24;236;894;896;2;0;0.83
24;237;896;897;1;0;0.83
24;238;897;898;1;0;0.83
24;239;898;901;3;0;0.83
24;240;901;902;1;0;0.83
24;241;902;906;4;0;0.83
24;242;906;907;1;0;0.83
24;243;907;908;1;0;0.83
24;244;908;910;2;0;0.83
24;245;910;911;1;0;0.83
24;246;911;914;3;0;0.83
24;247;914;916;2;0;0.83
24;248;916;917;1;0;0.83
24;249;917;921;4;0;0.83
24;250;921;922;1;0;0.83
24;251;922;926;4;0;0.83
24;252;926;927;1;0;0.83
24;253;927;930;3;0;0.83
24;254;930;931;1;0;0.83
24;255;931;933;2;0;0.83
24;256;933;934;1;0;0.83
24;257;934;936;2;0;0.83
24;258;936;937;1;0;0.83
24;259;937;941;4;0;0.83
24;260;941;942;1;0;0.83
24;261;942;946;4;0;0.83
24;262;946;947;1;0;0.83
24;263;947;950;3;0;0.83
24;264;950;951;1;0;0.83
24;265;951;952;1;0;0.83
24;266;952;953;1;0;0.83
24;267;953;954;1;0;0.83
24;268;954;956;2;0;0.83
24;269;956;957;1;0;0.83
24;270;957;958;1;0;0.83
24;271;958;961;3;0;0.83
24;272;961;962;1;0;0.83
24;273;962;966;4;0;0.83
24;274;966;967;1;0;0.83
24;275;967;968;1;0;0.83
24;276;968;970;2;0;0.83
24;277;970;971;1;0;0.83
24;278;971;974;3;0;0.83
24;279;974;976;2;0;0.83
24;280;976;977;1;0;0.83
24;281;977;981;4;0;0.83
24;282;981;982;1;0;0.83
24;283;982;986;4;0;0.83
24;284;986;987;1;0;0.83
24;285;987;990;3;0;0.83
24;286;990;991;1;0;0.83
24;287;991;994;3;0;0.83
24;288;994;996;2;0;0.83
24;289;996;997;1;0;0.83
24;290;997;1000;3;0;0.83
24;291;1000;1001;1;0;0.83
24;292;1001;1002;1;0;0.83
24;293;1002;1006;4;0;0.83
24;294;1006;1007;1;0;0.83
24;295;1007;1008;1;0;0.83
24;296;1008;1010;2;0;0.83
24;297;1010;1011;1;0;0.83
24;298;1011;1012;1;0;0.83
24;299;1012;1014;2;0;0.83
24;300;1014;1017;3;0;0.83
24;301;1017;1018;1;0;0.83
24;302;1018;1021;3;0;0.83
24;303;1021;1022;1;0;0.83
24;304;1022;1026;4;0;0.83
24;305;1026;1028;2;0;0.83
24;306;1028;1030;2;0;0.83
24;307;1030;1031;1;0;0.83
24;308;1031;1032;1;0;0.83
24;309;1032;1034;2;0;0.83
24;310;1034;1036;2;0;0.83
24;311;1036;1041;5;0;0.83
24;312;1041;1042;1;0;0.83
24;313;1042;1047;5;0;0.83
24;314;1047;1050;3;0;0.83
24;315;1050;1051;1;0;0.83
24;316;1051;1052;1;0;0.83
24;317;1052;1054;2;0;0.83
24;318;1054;1056;2;0;0.83
24;319;1056;1062;6;0;0.83
24;320;1062;1066;4;0;0.83
24;321;1066;1070;4;0;0.83
24;322;1070;1071;1;0;0.83
24;323;1071;1072;1;0;0.83
24;324;1072;1074;2;0;0.83
24;325;1074;1077;3;0;0.83
24;326;1077;1078;1;0;0.83
24;327;1078;1081;3;0;0.83
24;328;1081;1082;1;0;0.83
24;329;1082;1086;4;0;0.83
24;330;1086;1090;4;0;0.83
24;331;1090;1091;1;0;0.83
24;332;1091;1092;1;0;0.83
24;333;1092;1094;2;0;0.83
24;334;1094;1096;2;0;0.83
24;335;1096;1101;5;0;0.83
24;336;1101;1102;1;0;0.83
24;337;1102;1107;5;0;0.83
24;338;1107;1110;3;0;0.83
24;339;1110;1111;1;0;0.83
24;340;1111;1112;1;0;0.83
24;341;1112;1114;2;0;0.83
24;342;1114;1116;2;0;0.83
24;343;1116;1117;1;0;0.83
24;344;1117;1119;2;0;0.83
24;345;1119;1122;3;0;0.83
24;346;1122;1123;1;0;0.83
24;347;1123;1128;5;0;0.83
24;348;1128;1129;1;0;0.83
24;349;1129;1133;4;0;0.83
24;350;1133;1134;1;0;0.83
24;351;1134;1135;1;0;0.83
24;352;1135;1142;7;0;0.83
24;353;1142;1143;1;0;0.83
24;354;1143;1147;4;0;0.83
24;355;1147;1149;2;0;0.83
24;356;1149;1155;6;0;0.83
24;357;1155;1158;3;0;0.83
24;358;1158;1162;4;0;0.83
24;359;1162;1163;1;0;0.83
24;360;1163;1164;1;0;0.83
24;361;1164;1172;8;0;0.83
24;362;1172;1175;3;0;0.83
24;363;1175;1178;3;0;0.83
24;364;1178;1180;2;0;0.83
24;365;1180;1182;2;0;0.83
24;366;1182;1183;1;0;0.83
24;367;1183;1184;1;0;0.83
24;368;1184;1189;5;0;0.83
24;369;1189;1198;9;0;0.83
24;370;1198;1199;1;0;0.83
24;371;1199;1203;4;0;0.83
24;372;1203;1204;1;0;0.83
24;373;1204;1205;1;0;0.83
24;374;1205;1207;2;0;0.83
24;375;1207;1212;5;0;0.83
24;376;1212;1218;6;0;0.83
24;377;1218;1227;9;0;0.83
24;378;1227;1228;1;0;0.83
24;379;1228;1229;1;0;0.83
24;380;1229;1230;1;0;0.83
24;381;1230;1234;4;0;0.83
24;382;1234;1235;1;0;0.83
24;383;1235;1238;3;0;0.83
24;384;1238;1240;2;0;0.83
24;385;1240;1252;12;0;0.83
24;386;1252;1253;1;0;0.83
24;387;1253;1254;1;0;0.83
24;388;1254;1255;1;0;0.83
24;389;1255;1263;8;0;0.83
24;390;1263;1269;6;0;0.83
24;391;1269;1274;5;0;0.83
24;392;1274;1275;1;0;0.83
24;393;1275;1277;2;0;0.83
24;394;1277;1278;1;0;0.83
24;395;1278;1279;1;0;0.83
24;396;1279;1287;8;0;0.83
24;397;1287;1288;1;0;0.83
24;398;1288;1303;15;0;0.83
24;399;1303;1304;1;0;0.83
24;400;1304;1310;6;0;0.83
24;401;1310;1312;2;0;0.83
24;402;1312;1313;1;0;0.83
24;403;1313;1314;1;0;0.83
24;404;1314;1324;10;0;0.83
24;405;1324;1332;8;0;0.83
24;406;1332;1333;1;0;0.83
24;407;1333;1337;4;0;0.83
24;408;1337;1338;1;0;0.83
24;409;1338;1344;6;0;0.83
24;410;1344;1349;5;0;0.83
24;411;1349;1353;4;0;0.83
24;412;1353;1362;9;0;0.83
24;413;1362;1365;3;0;0.83
24;414;1365;1366;1;0;0.83
24;415;1366;1368;2;0;0.83
24;416;1368;1383;15;0;0.83
24;417;1383;1387;4;0;0.83
24;418;1387;1402;15;0;0.83
24;419;1402;1417;15;0;0.83
24;420;1417;1432;15;0;0.83
24;421;1432;1447;15;0;0.83
24;422;1447;1462;15;0;0.83
24;423;1462;1477;15;0;0.83
24;424;1477;1492;15;0;0.83
24;425;1492;1507;15;0;0.83
24;426;1507;1522;15;0;0.83
24;427;1522;1537;15;0;0.83
24;428;1537;1552;15;0;0.83
24;429;1552;1567;15;0;0.83
24;430;1567;1582;15;0;0.83
24;431;1582;1597;15;0;0.83
24;432;1597;1612;15;0;0.83
24;433;1612;1627;15;0;0.83
24;434;1627;1642;15;0;0.83
24;435;1642;1657;15;0;0.83
24;436;1657;1672;15;0;0.83
24;437;1672;1680;8;0;0.83
25;0;240;328;88;0;0.83
25;1;328;333;5;0;0.83
25;2;333;340;7;0;0.83
25;3;340;341;1;0;0.83
25;4;341;344;3;0;0.83
25;5;344;347;3;0;0.83
25;6;347;348;1;0;0.83
25;7;348;349;1;0;0.83
25;8;349;350;1;0;0.83
25;9;350;352;2;0;0.83
25;10;352;353;1;0;0.83
25;11;353;355;2;0;0.83
25;12;355;356;1;0;0.83
25;13;356;358;2;0;0.83
25;14;358;363;5;0;0.83
25;15;363;367;4;0;0.83
25;16;367;369;2;0;0.83
25;17;369;370;1;0;0.83
25;18;370;371;1;0;0.83
25;19;371;374;3;0;0.83
25;20;374;377;3;0;0.83
25;21;377;378;1;0;0.83
25;22;378;381;3;0;0.83
25;23;381;382;1;0;0.83
25;24;382;383;1;0;0.83
25;25;383;386;3;0;0.83
25;26;386;387;1;0;0.83
25;27;387;390;3;0;0.83
25;28;390;391;1;0;0.83
25;29;391;396;5;0;0.83
25;30;396;397;1;0;0.83
25;31;397;399;2;0;0.83
25;32;399;401;2;0;0.83
25;33;401;402;1;0;0.83
25;34;402;406;4;0;0.83
25;35;406;407;1;0;0.83
25;36;407;408;1;0;0.83
25;37;408;410;2;0;0.83
25;38;410;411;1;0;0.83
25;39;411;413;2;0;0.83
25;40;413;414;1;0;0.83
25;41;414;416;2;0;0.83
25;42;416;417;1;0;0.83
25;43;417;418;1;0;0.83
25;44;418;421;3;0;0.83
25;45;421;422;1;0;0.83
25;46;422;426;4;0;0.83
25;47;426;427;1;0;0.83
25;48;427;428;1;0;0.83
25;49;428;430;2;0;0.83
25;50;430;431;1;0;0.83
25;51;431;434;3;0;0.83
25;52;434;436;2;0;0.83
25;53;436;437;1;0;0.83
25;54;437;441;4;0;0.83
25;55;441;442;1;0;0.83
25;56;442;443;1;0;0.83
25;57;443;444;1;0;0.83
25;58;444;446;2;0;0.83
25;59;446;447;1;0;0.83
25;60;447;450;3;0;0.83
25;61;450;451;1;0;0.83
25;62;451;456;5;0;0.83
25;63;456;457;1;0;0.83
25;64;457;458;1;0;0.83
25;65;458;459;1;0;0.83
25;66;459;461;2;0;0.83
25;67;461;462;1;0;0.83
25;68;462;466;4;0;0.83
25;69;466;467;1;0;0.83
25;70;467;468;1;0;0.83
25;71;468;470;2;0;0.83
25;72;470;471;1;0;0.83
25;73;471;473;2;0;0.83
25;74;473;474;1;0;0.83
25;75;474;476;2;0;0.83
25;76;476;477;1;0;0.83
25;77;477;478;1;0;0.83
25;78;478;481;3;0;0.83
25;79;481;482;1;0;0.83
25;80;482;486;4;0;0.83
25;81;486;487;1;0;0.83
25;82;487;490;3;0;0.83
25;83;490;491;1;0;0.83
25;84;491;494;3;0;0.83
25;85;494;496;2;0;0.83
25;86;496;497;1;0;0.83
25;87;497;498;1;0;0.83
25;88;498;502;4;0;0.83
25;89;502;504;2;0;0.83
25;90;504;506;2;0;0.83
25;91;506;507;1;0;0.83
25;92;507;510;3;0;0.83
25;93;510;516;6;0;0.83
25;94;516;517;1;0;0.83
25;95;517;518;1;0;0.83
25;96;518;522;4;0;0.83
25;97;522;523;1;0;0.83
25;98;523;526;3;0;0.83
25;99;526;527;1;0;0.83
25;100;527;530;3;0;0.83
25;101;530;531;1;0;0.83
25;102;531;533;2;0;0.83
25;103;533;541;8;0;0.83
25;104;541;542;1;0;0.83
25;105;542;546;4;0;0.83
25;106;546;547;1;0;0.83
25;107;547;550;3;0;0.83
25;108;550;558;8;0;0.83
25;109;558;561;3;0;0.83
25;110;561;562;1;0;0.83
25;111;562;566;4;0;0.83
25;112;566;567;1;0;0.83
25;113;567;570;3;0;0.83
25;114;570;571;1;0;0.83
25;115;571;577;6;0;0.83
25;116;577;581;4;0;0.83
25;117;581;582;1;0;0.83
25;118;582;586;4;0;0.83
25;119;586;587;1;0;0.83
25;120;587;590;3;0;0.83
25;121;590;593;3;0;0.83
25;122;593;598;5;0;0.83
25;123;598;601;3;0;0.83
25;124;601;602;1;0;0.83
25;125;602;606;4;0;0.83
25;126;606;607;1;0;0.83
25;127;607;610;3;0;0.83
25;128;610;611;1;0;0.83
25;129;611;621;10;0;0.83
25;130;621;622;1;0;0.83
25;131;622;626;4;0;0.83
25;132;626;627;1;0;0.83
25;133;627;630;3;0;0.83
25;134;630;631;1;0;0.83
25;135;631;637;6;0;0.83
25;136;637;641;4;0;0.83
25;137;641;642;1;0;0.83
25;138;642;646;4;0;0.83
25;139;646;647;1;0;0.83
25;140;647;650;3;0;0.83
25;141;650;653;3;0;0.83
25;142;653;658;5;0;0.83
25;143;658;661;3;0;0.83
25;144;661;662;1;0;0.83
25;145;662;666;4;0;0.83
25;146;666;667;1;0;0.83
25;147;667;670;3;0;0.83
25;148;670;671;1;0;0.83
25;149;671;681;10;0;0.83
25;150;681;682;1;0;0.83
25;151;682;686;4;0;0.83
25;152;686;687;1;0;0.83
25;153;687;690;3;0;0.83
25;154;690;691;1;0;0.83
25;155;691;697;6;0;0.83
25;156;697;701;4;0;0.83
25;157;701;702;1;0;0.83
25;158;702;706;4;0;0.83
25;159;706;707;1;0;0.83
25;160;707;710;3;0;0.83
25;161;710;713;3;0;0.83
25;162;713;718;5;0;0.83
25;163;718;721;3;0;0.83
25;164;721;722;1;0;0.83
25;165;722;726;4;0;0.83
25;166;726;727;1;0;0.83
25;167;727;730;3;0;0.83
25;168;730;731;1;0;0.83
25;169;731;741;10;0;0.83
25;170;741;742;1;0;0.83
25;171;742;746;4;0;0.83
25;172;746;747;1;0;0.83
25;173;747;750;3;0;0.83
25;174;750;751;1;0;0.83
25;175;751;757;6;0;0.83
25;176;757;761;4;0;0.83
25;177;761;762;1;0;0.83
25;178;762;766;4;0;0.83
25;179;766;767;1;0;0.83
25;180;767;770;3;0;0.83
25;181;770;773;3;0;0.83
25;182;773;778;5;0;0.83
25;183;778;781;3;0;0.83
25;184;781;782;1;0;0.83
25;185;782;786;4;0;0.83
25;186;786;787;1;0;0.83
25;187;787;790;3;0;0.83
25;188;790;791;1;0;0.83
25;189;791;797;6;0;0.83
25;190;797;801;4;0;0.83
25;191;801;802;1;0;0.83
25;192;802;806;4;0;0.83
25;193;806;807;1;0;0.83
25;194;807;810;3;0;0.83
25;195;810;813;3;0;0.83
25;196;813;817;4;0;0.83
25;197;817;818;1;0;0.83
25;198;818;821;3;0;0.83
25;199;821;822;1;0;0.83
25;200;822;826;4;0;0.83
25;201;826;827;1;0;0.83
25;202;827;830;3;0;0.83
25;203;830;833;3;0;0.83
25;204;833;834;1;0;0.83
25;205;834;837;3;0;0.83
25;206;837;838;1;0;0.83
25;207;838;841;3;0;0.83
25;208;841;842;1;0;0.83
25;209;842;846;4;0;0.83
25;210;846;847;1;0;0.83
25;211;847;848;1;0;0.83
25;212;848;850;2;0;0.83
25;213;850;851;1;0;0.83
25;214;851;854;3;0;0.83
25;215;854;857;3;0;0.83
25;216;857;860;3;0;0.83
25;217;860;861;1;0;0.83
25;218;861;862;1;0;0.83
25;219;862;866;4;0;0.83
25;220;866;867;1;0;0.83
25;221;867;870;3;0;0.83
25;222;870;871;1;0;0.83
25;223;871;873;2;0;0.83
25;224;873;874;1;0;0.83
25;225;874;876;2;0;0.83
25;226;876;877;1;0;0.83
25;227;877;881;4;0;0.83
25;228;881;882;1;0;0.83
25;229;882;886;4;0;0.83
25;230;886;887;1;0;0.83
25;231;887;890;3;0;0.83
25;232;890;891;1;0;0.83
25;233;891;892;1;0;0.83
25;234;892;893;1;0;0.83
25;235;893;894;1;0;0.83
25;236;894;896;2;0;0.83
25;237;896;897;1;0;0.83
25;238;897;898;1;0;0.83
25;239;898;901;3;0;0.83
25;240;901;902;1;0;0.83
25;241;902;906;4;0;0.83
25;242;906;907;1;0;0.83
25;243;907;908;1;0;0.83
25;244;908;910;2;0;0.83
25;245;910;911;1;0;0.83
25;246;911;914;3;0;0.83
25;247;914;916;2;0;0.83
25;248;916;917;1;0;0.83
25;249;917;921;4;0;0.83
25;250;921;922;1;0;0.83
25;251;922;926;4;0;0.83
25;252;926;927;1;0;0.83
25;253;927;930;3;0;0.83
25;254;930;931;1;0;0.83
25;255;931;933;2;0;0.83
25;256;933;934;1;0;0.83
25;257;934;936;2;0;0.83
25;258;936;937;1;0;0.83
25;259;937;941;4;0;0.83
25;260;941;942;1;0;0.83
25;261;942;946;4;0;0.83
25;262;946;947;1;0;0.83
25;263;947;950;3;0;0.83
25;264;950;951;1;0;0.83
25;265;951;952;1;0;0.83
25;266;952;953;1;0;0.83
25;267;953;954;1;0;0.83
25;268;954;956;2;0;0.83
25;269;956;957;1;0;0.83
25;270;957;958;1;0;0.83
25;271;958;961;3;0;0.83
25;272;961;962;1;0;0.83
25;273;962;966;4;0;0.83
25;274;966;967;1;0;0.83
25;275;967;968;1;0;0.83
25;276;968;970;2;0;0.83
25;277;970;971;1;0;0.83
25;278;971;974;3;0;0.83
25;279;974;976;2;0;0.83
25;280;976;977;1;0;0.83
25;281;977;981;4;0;0.83
25;282;981;982;1;0;0.83
25;283;982;986;4;0;0.83
25;284;986;987;1;0;0.83
25;285;987;990;3;0;0.83
25;286;990;991;1;0;0.83
25;287;991;994;3;0;0.83
25;288;994;996;2;0;0.83
25;289;996;997;1;0;0.83
25;290;997;1000;3;0;0.83
25;291;1000;1001;1;0;0.83
25;292;1001;1002;1;0;0.83
25;293;1002;1006;4;0;0.83
25;294;1006;1007;1;0;0.83
25;295;1007;1008;1;0;0.83
25;296;1008;1010;2;0;0.83
25;297;1010;1011;1;0;0.83
25;298;1011;1012;1;0;0.83
25;299;1012;1014;2;0;0.83
25;300;1014;1017;3;0;0.83
25;301;1017;1018;1;0;0.83
25;302;1018;1021;3;0;0.83
25;303;1021;1022;1;0;0.83
25;304;1022;1026;4;0;0.83
25;305;1026;1028;2;0;0.83
25;306;1028;1030;2;0;0.83
25;307;1030;1031;1;0;0.83
25;308;1031;1032;1;0;0.83
25;309;1032;1034;2;0;0.83
25;310;1034;1036;2;0;0.83
25;311;1036;1041;5;0;0.83
25;312;1041;1042;1;0;0.83
25;313;1042;1047;5;0;0.83
25;314;1047;1050;3;0;0.83
25;315;1050;1051;1;0;0.83
25;316;1051;1052;1;0;0.83
25;317;1052;1054;2;0;0.83
25;318;1054;1056;2;0;0.83
25;319;1056;1062;6;0;0.83
25;320;1062;1066;4;0;0.83
25;321;1066;1070;4;0;0.83
25;322;1070;1071;1;0;0.83
25;323;1071;1072;1;0;0.83
25;324;1072;1074;2;0;0.83
25;325;1074;1077;3;0;0.83
25;326;1077;1078;1;0;0.83
25;327;1078;1081;3;0;0.83
25;328;1081;1082;1;0;0.83
25;329;1082;1086;4;0;0.83
25;330;1086;1090;4;0;0.83
25;331;1090;1091;1;0;0.83
25;332;1091;1092;1;0;0.83
25;333;1092;1094;2;0;0.83
25;334;1094;1096;2;0;0.83
25;335;1096;1101;5;0;0.83
25;336;1101;1102;1;0;0.83
25;337;1102;1107;5;0;0.83
25;338;1107;1110;3;0;0.83
25;339;1110;1111;1;0;0.83
25;340;1111;1112;1;0;0.83
25;341;1112;1114;2;0;0.83
25;342;1114;1116;2;0;0.83
25;343;1116;1117;1;0;0.83
25;344;1117;1119;2;0;0.83
25;345;1119;1122;3;0;0.83
25;346;1122;1123;1;0;0.83
25;347;1123;1128;5;0;0.83
25;348;1128;1129;1;0;0.83
25;349;1129;1133;4;0;0.83
25;350;1133;1134;1;0;0.83
25;351;1134;1135;1;0;0.83
25;352;1135;1142;7;0;0.83
25;353;1142;1143;1;0;0.83
25;354;1143;1147;4;0;0.83
25;355;1147;1149;2;0;0.83
25;356;1149;1155;6;0;0.83
25;357;1155;1158;3;0;0.83
25;358;1158;1162;4;0;0.83
25;359;1162;1163;1;0;0.83
25;360;1163;1164;1;0;0.83
25;361;1164;1172;8;0;0.83
25;362;1172;1175;3;0;0.83
25;363;1175;1178;3;0;0.83
25;364;1178;1180;2;0;0.83
25;365;1180;1182;2;0;0.83
25;366;1182;1183;1;0;0.83
25;367;1183;1184;1;0;0.83
25;368;1184;1189;5;0;0.83
25;369;1189;1198;9;0;0.83
25;370;1198;1199;1;0;0.83
25;371;1199;1203;4;0;0.83
25;372;1203;1204;1;0;0.83
25;373;1204;1205;1;0;0.83
25;374;1205;1207;2;0;0.83
25;375;1207;1212;5;0;0.83
25;376;1212;1218;6;0;0.83
25;377;1218;1227;9;0;0.83
25;378;1227;1228;1;0;0.83
25;379;1228;1229;1;0;0.83
25;380;1229;1230;1;0;0.83
25;381;1230;1234;4;0;0.83
25;382;1234;1235;1;0;0.83
25;383;1235;1238;3;0;0.83
25;384;1238;1240;2;0;0.83
25;385;1240;1252;12;0;0.83
25;386;1252;1253;1;0;0.83
25;387;1253;1254;1;0;0.83
25;388;1254;1255;1;0;0.83
25;389;1255;1263;8;0;0.83
25;390;1263;1269;6;0;0.83
25;391;1269;1274;5;0;0.83
25;392;1274;1275;1;0;0.83
25;393;1275;1277;2;0;0.83
25;394;1277;1278;1;0;0.83
25;395;1278;1279;1;0;0.83
25;396;1279;1287;8;0;0.83
25;397;1287;1288;1;0;0.83
25;398;1288;1303;15;0;0.83
25;399;1303;1304;1;0;0.83
25;400;1304;1310;6;0;0.83
25;401;1310;1312;2;0;0.83
25;402;1312;1313;1;0;0.83
25;403;1313;1314;1;0;0.83
25;404;1314;1324;10;0;0.83
25;405;1324;1332;8;0;0.83
25;406;1332;1333;1;0;0.83
25;407;1333;1337;4;0;0.83
25;408;1337;1338;1;0;0.83
25;409;1338;1344;6;0;0.83
25;410;1344;1349;5;0;0.83
25;411;1349;1353;4;0;0.83
25;412;1353;1362;9;0;0.83
25;413;1362;1365;3;0;0.83
25;414;1365;1366;1;0;0.83
25;415;1366;1368;2;0;0.83
25;416;1368;1383;15;0;0.83
25;417;1383;1387;4;0;0.83
25;418;1387;1402;15;0;0.83
25;419;1402;1417;15;0;0.83
25;420;1417;1432;15;0;0.83
25;421;1432;1447;15;0;0.83
25;422;1447;1462;15;0;0.83
25;423;1462;1477;15;0;0.83
25;424;1477;1492;15;0;0.83
25;425;1492;1507;15;0;0.83
25;426;1507;1522;15;0;0.83
25;427;1522;1537;15;0;0.83
25;428;1537;1552;15;0;0.83
25;429;1552;1567;15;0;0.83
25;430;1567;1582;15;0;0.83
25;431;1582;1597;15;0;0.83
25;432;1597;1612;15;0;0.83
25;433;1612;1627;15;0;0.83
25;434;1627;1642;15;0;0.83
25;435;1642;1657;15;0;0.83
25;436;1657;1672;15;0;0.83
25;437;1672;1680;8;0;0.83
26;0;240;328;88;0;0.83
26;1;328;333;5;0;0.83
26;2;333;340;7;0;0.83
26;3;340;341;1;0;0.83
26;4;341;344;3;0;0.83
26;5;344;347;3;0;0.83
26;6;347;348;1;0;0.83
26;7;348;349;1;0;0.83
26;8;349;350;1;0;0.83
26;9;350;352;2;0;0.83
26;10;352;353;1;0;0.83
26;11;353;355;2;0;0.83
26;12;355;356;1;0;0.83
26;13;356;358;2;0;0.83
26;14;358;363;5;0;0.83
26;15;363;367;4;0;0.83
26;16;367;369;2;0;0.83
26;17;369;370;1;0;0.83
26;18;370;371;1;0;0.83
26;19;371;374;3;0;0.83
26;20;374;377;3;0;0.83
26;21;377;378;1;0;0.83
26;22;378;381;3;0;0.83
26;23;381;382;1;0;0.83
26;24;382;383;1;0;0.83
26;25;383;386;3;0;0.83
26;26;386;387;1;0;0.83
26;27;387;390;3;0;0.83
26;28;390;391;1;0;0.83
26;29;391;396;5;0;0.83
26;30;396;397;1;0;0.83
26;31;397;399;2;0;0.83
26;32;399;401;2;0;0.83
26;33;401;402;1;0;0.83
26;34;402;406;4;0;0.83
26;35;406;407;1;0;0.83
26;36;407;408;1;0;0.83
26;37;408;410;2;0;0.83
26;38;410;411;1;0;0.83
26;39;411;413;2;0;0.83
26;40;413;414;1;0;0.83
26;41;414;416;2;0;0.83
26;42;416;417;1;0;0.83
26;43;417;418;1;0;0.83
26;44;418;421;3;0;0.83
26;45;421;422;1;0;0.83
26;46;422;426;4;0;0.83
26;47;426;427;1;0;0.83
26;48;427;428;1;0;0.83
26;49;428;430;2;0;0.83
26;50;430;431;1;0;0.83
26;51;431;434;3;0;0.83
26;52;434;436;2;0;0.83
26;53;436;437;1;0;0.83
26;54;437;441;4;0;0.83
26;55;441;442;1;0;0.83
26;56;442;443;1;0;0.83
26;57;443;444;1;0;0.83
26;58;444;446;2;0;0.83
26;59;446;447;1;0;0.83
26;60;447;450;3;0;0.83
26;61;450;451;1;0;0.83
26;62;451;456;5;0;0.83
26;63;456;457;1;0;0.83
26;64;457;458;1;0;0.83
26;65;458;459;1;0;0.83
26;66;459;461;2;0;0.83
26;67;461;462;1;0;0.83
26;68;462;466;4;0;0.83
26;69;466;467;1;0;0.83
26;70;467;468;1;0;0.83
26;71;468;470;2;0;0.83
26;72;470;471;1;0;0.83
26;73;471;473;2;0;0.83
26;74;473;474;1;0;0.83
26;75;474;476;2;0;0.83
26;76;476;477;1;0;0.83
26;77;477;478;1;0;0.83
26;78;478;481;3;0;0.83
26;79;481;482;1;0;0.83
26;80;482;486;4;0;0.83
26;81;486;487;1;0;0.83
26;82;487;490;3;0;0.83
26;83;490;491;1;0;0.83
26;84;491;494;3;0;0.83
26;85;494;496;2;0;0.83
26;86;496;497;1;0;0.83
26;87;497;498;1;0;0.83
26;88;498;502;4;0;0.83
26;89;502;504;2;0;0.83
26;90;504;506;2;0;0.83
26;91;506;507;1;0;0.83
26;92;507;510;3;0;0.83
26;93;510;516;6;0;0.83
26;94;516;517;1;0;0.83
26;95;517;518;1;0;0.83
26;96;518;522;4;0;0.83
26;97;522;523;1;0;0.83
26;98;523;526;3;0;0.83
26;99;526;527;1;0;0.83
26;100;527;530;3;0;0.83
26;101;530;531;1;0;0.83
26;102;531;533;2;0;0.83
26;103;533;541;8;0;0.83
26;104;541;542;1;0;0.83
26;105;542;546;4;0;0.83
26;106;546;547;1;0;0.83
26;107;547;550;3;0;0.83
26;108;550;558;8;0;0.83
26;109;558;561;3;0;0.83
26;110;561;562;1;0;0.83
26;111;562;566;4;0;0.83
26;112;566;567;1;0;0.83
26;113;567;570;3;0;0.83
26;114;570;571;1;0;0.83
26;115;571;577;6;0;0.83
26;116;577;581;4;0;0.83
26;117;581;582;1;0;0.83
26;118;582;586;4;0;0.83
26;119;586;587;1;0;0.83
26;120;587;590;3;0;0.83
26;121;590;593;3;0;0.83
26;122;593;598;5;0;0.83
26;123;598;601;3;0;0.83
26;124;601;602;1;0;0.83
26;125;602;606;4;0;0.83
26;126;606;607;1;0;0.83
26;127;607;610;3;0;0.83
26;128;610;611;1;0;0.83
26;129;611;621;10;0;0.83
26;130;621;622;1;0;0.83
26;131;622;626;4;0;0.83
26;132;626;627;1;0;0.83
26;133;627;630;3;0;0.83
26;134;630;631;1;0;0.83
26;135;631;637;6;0;0.83
26;136;637;641;4;0;0.83
26;137;641;642;1;0;0.83
26;138;642;646;4;0;0.83
26;139;646;647;1;0;0.83
26;140;647;650;3;0;0.83
26;141;650;653;3;0;0.83
26;142;653;658;5;0;0.83
26;143;658;661;3;0;0.83
26;144;661;662;1;0;0.83
26;145;662;666;4;0;0.83
26;146;666;667;1;0;0.83
26;147;667;670;3;0;0.83
26;148;670;671;1;0;0.83
26;149;671;681;10;0;0.83
26;150;681;682;1;0;0.83
26;151;682;686;4;0;0.83
26;152;686;687;1;0;0.83
26;153;687;690;3;0;0.83
26;154;690;691;1;0;0.83
26;155;691;697;6;0;0.83
26;156;697;701;4;0;0.83
26;157;701;702;1;0;0.83
26;158;702;706;4;0;0.83
26;159;706;707;1;0;0.83
26;160;707;710;3;0;0.83
26;161;710;713;3;0;0.83
26;162;713;718;5;0;0.83
26;163;718;721;3;0;0.83
26;164;721;722;1;0;0.83
26;165;722;726;4;0;0.83
26;166;726;727;1;0;0.83
26;167;727;730;3;0;0.83
26;168;730;731;1;0;0.83
26;169;731;741;10;0;0.83
26;170;741;742;1;0;0.83
26;171;742;746;4;0;0.83
26;172;746;747;1;0;0.83
26;173;747;750;3;0;0.83
26;174;750;751;1;0;0.83
26;175;751;757;6;0;0.83
26;176;757;761;4;0;0.83
26;177;761;762;1;0;0.83
26;178;762;766;4;0;0.83
26;179;766;767;1;0;0.83
26;180;767;770;3;0;0.83
26;181;770;773;3;0;0.83
26;182;773;778;5;0;0.83
26;183;778;781;3;0;0.83
26;184;781;782;1;0;0.83
26;185;782;786;4;0;0.83
26;186;786;787;1;0;0.83
26;187;787;790;3;0;0.83
26;188;790;791;1;0;0.83
26;189;791;797;6;0;0.83
26;190;797;801;4;0;0.83
26;191;801;802;1;0;0.83
26;192;802;806;4;0;0.83
26;193;806;807;1;0;0.83
26;194;807;810;3;0;0.83
26;195;810;813;3;0;0.83
26;196;813;817;4;0;0.83
26;197;817;818;1;0;0.83
26;198;818;821;3;0;0.83
26;199;821;822;1;0;0.83
26;200;822;826;4;0;0.83
26;201;826;827;1;0;0.83
26;202;827;830;3;0;0.83
26;203;830;833;3;0;0.83
26;204;833;834;1;0;0.83
26;205;834;837;3;0;0.83
26;206;837;838;1;0;0.83
26;207;838;841;3;0;0.83
26;208;841;842;1;0;0.83
26;209;842;846;4;0;0.83
26;210;846;847;1;0;0.83
26;211;847;848;1;0;0.83
26;212;848;850;2;0;0.83
26;213;850;851;1;0;0.83
26;214;851;854;3;0;0.83
26;215;854;857;3;0;0.83
26;216;857;860;3;0;0.83
26;217;860;861;1;0;0.83
26;218;861;862;1;0;0.83
26;219;862;866;4;0;0.83
26;220;866;867;1;0;0.83
26;221;867;870;3;0;0.83
26;222;870;871;1;0;0.83
26;223;871;873;2;0;0.83
26;224;873;874;1;0;0.83
26;225;874;876;2;0;0.83
26;226;876;877;1;0;0.83
26;227;877;881;4;0;0.83
26;228;881;882;1;0;0.83
26;229;882;886;4;0;0.83
26;230;886;887;1;0;0.83
26;231;887;890;3;0;0.83
26;232;890;891;1;0;0.83
26;233;891;892;1;0;0.83
26;234;892;893;1;0;0.83
26;235;893;894;1;0;0.83
26;236;894;896;2;0;0.83
26;237;896;897;1;0;0.83
26;238;897;898;1;0;0.83
26;239;898;901;3;0;0.83
26;240;901;902;1;0;0.83
26;241;902;906;4;0;0.83
26;242;906;907;1;0;0.83
26;243;907;908;1;0;0.83
26;244;908;910;2;0;0.83
26;245;910;911;1;0;0.83
26;246;911;914;3;0;0.83
26;247;914;916;2;0;0.83
26;248;916;917;1;0;0.83
26;249;917;921;4;0;0.83
26;250;921;922;1;0;0.83
26;251;922;926;4;0;0.83
26;252;926;927;1;0;0.83
26;253;927;930;3;0;0.83
26;254;930;931;1;0;0.83
26;255;931;933;2;0;0.83
26;256;933;934;1;0;0.83
26;257;934;936;2;0;0.83
26;258;936;937;1;0;0.83
26;259;937;941;4;0;0.83
26;260;941;942;1;0;0.83
26;261;942;946;4;0;0.83
26;262;946;947;1;0;0.83
26;263;947;950;3;0;0.83
26;264;950;951;1;0;0.83
26;265;951;952;1;0;0.83
26;266;952;953;1;0;0.83
26;267;953;954;1;0;0.83
26;268;954;956;2;0;0.83
26;269;956;957;1;0;0.83
26;270;957;958;1;0;0.83
26;271;958;961;3;0;0.83
26;272;961;962;1;0;0.83
26;273;962;966;4;0;0.83
26;274;966;967;1;0;0.83
26;275;967;968;1;0;0.83
26;276;968;970;2;0;0.83
26;277;970;971;1;0;0.83
26;278;971;974;3;0;0.83
26;279;974;976;2;0;0.83
26;280;976;977;1;0;0.83
26;281;977;981;4;0;0.83
26;282;981;982;1;0;0.83
26;283;982;986;4;0;0.83
26;284;986;987;1;0;0.83
26;285;987;990;3;0;0.83
26;286;990;991;1;0;0.83
26;287;991;994;3;0;0.83
26;288;994;996;2;0;0.83
26;289;996;997;1;0;0.83
26;290;997;1000;3;0;0.83
26;291;1000;1001;1;0;0.83
26;292;1001;1002;1;0;0.83
26;293;1002;1006;4;0;0.83
26;294;1006;1007;1;0;0.83
26;295;1007;1008;1;0;0.83
26;296;1008;1010;2;0;0.83
26;297;1010;1011;1;0;0.83
26;298;1011;1012;1;0;0.83
26;299;1012;1014;2;0;0.83
26;300;1014;1017;3;0;0.83
26;301;1017;1018;1;0;0.83
26;302;1018;1021;3;0;0.83
26;303;1021;1022;1;0;0.83
26;304;1022;1026;4;0;0.83
26;305;1026;1028;2;0;0.83
26;306;1028;1030;2;0;0.83
26;307;1030;1031;1;0;0.83
26;308;1031;1032;1;0;0.83
26;309;1032;1034;2;0;0.83
26;310;1034;1036;2;0;0.83
26;311;1036;1041;5;0;0.83
26;312;1041;1042;1;0;0.83
26;313;1042;1047;5;0;0.83
26;314;1047;1050;3;0;0.83
26;315;1050;1051;1;0;0.83
26;316;1051;1052;1;0;0.83
26;317;1052;1054;2;0;0.83
26;318;1054;1056;2;0;0.83
26;319;1056;1062;6;0;0.83
26;320;1062;1066;4;0;0.83
26;321;1066;1070;4;0;0.83
26;322;1070;1071;1;0;0.83
26;323;1071;1072;1;0;0.83
26;324;1072;1074;2;0;0.83
26;325;1074;1077;3;0;0.83
26;326;1077;1078;1;0;0.83
26;327;1078;1081;3;0;0.83
26;328;1081;1082;1;0;0.83
26;329;1082;1086;4;0;0.83
26;330;1086;1090;4;0;0.83
26;331;1090;1091;1;0;0.83
26;332;1091;1092;1;0;0.83
26;333;1092;1094;2;0;0.83
26;334;1094;1096;2;0;0.83
26;335;1096;1101;5;0;0.83
26;336;1101;1102;1;0;0.83
26;337;1102;1107;5;0;0.83
26;338;1107;1110;3;0;0.83
26;339;1110;1111;1;0;0.83
26;340;1111;1112;1;0;0.83
26;341;1112;1114;2;0;0.83
26;342;1114;1116;2;0;0.83
26;343;1116;1117;1;0;0.83
26;344;1117;1119;2;0;0.83
26;345;1119;1122;3;0;0.83
26;346;1122;1123;1;0;0.83
26;347;1123;1128;5;0;0.83
26;348;1128;1129;1;0;0.83
26;349;1129;1133;4;0;0.83
26;350;1133;1134;1;0;0.83
26;351;1134;1135;1;0;0.83
26;352;1135;1142;7;0;0.83
26;353;1142;1143;1;0;0.83
26;354;1143;1147;4;0;0.83
26;355;1147;1149;2;0;0.83
26;356;1149;1155;6;0;0.83
26;357;1155;1158;3;0;0.83
26;358;1158;1162;4;0;0.83
26;359;1162;1163;1;0;0.83
26;360;1163;1164;1;0;0.83
26;361;1164;1172;8;0;0.83
26;362;1172;1175;3;0;0.83
26;363;1175;1178;3;0;0.83
26;364;1178;1180;2;0;0.83
26;365;1180;1182;2;0;0.83
26;366;1182;1183;1;0;0.83
26;367;1183;1184;1;0;0.83
26;368;1184;1189;5;0;0.83
26;369;1189;1198;9;0;0.83
26;370;1198;1199;1;0;0.83
26;371;1199;1203;4;0;0.83
26;372;1203;1204;1;0;0.83
26;373;1204;1205;1;0;0.83
26;374;1205;1207;2;0;0.83
26;375;1207;1212;5;0;0.83
26;376;1212;1218;6;0;0.83
26;377;1218;1227;9;0;0.83
26;378;1227;1228;1;0;0.83
26;379;1228;1229;1;0;0.83
26;380;1229;1230;1;0;0.83
26;381;1230;1234;4;0;0.83
26;382;1234;1235;1;0;0.83
26;383;1235;1238;3;0;0.83
26;384;1238;1240;2;0;0.83
26;385;1240;1252;12;0;0.83
26;386;1252;1253;1;0;0.83
26;387;1253;1254;1;0;0.83
26;388;1254;1255;1;0;0.83
26;389;1255;1263;8;0;0.83
26;390;1263;1269;6;0;0.83
26;391;1269;1274;5;0;0.83
26;392;1274;1275;1;0;0.83
26;393;1275;1277;2;0;0.83
26;394;1277;1278;1;0;0.83
26;395;1278;1279;1;0;0.83
26;396;1279;1287;8;0;0.83
26;397;1287;1288;1;0;0.83
26;398;1288;1303;15;0;0.83
26;399;1303;1304;1;0;0.83
26;400;1304;1310;6;0;0.83
26;401;1310;1312;2;0;0.83
26;402;1312;1313;1;0;0.83
26;403;1313;1314;1;0;0.83
26;404;1314;1324;10;0;0.83
26;405;1324;1332;8;0;0.83
26;406;1332;1333;1;0;0.83
26;407;1333;1337;4;0;0.83
26;408;1337;1338;1;0;0.83
26;409;1338;1344;6;0;0.83
26;410;1344;1349;5;0;0.83
26;411;1349;1353;4;0;0.83
26;412;1353;1362;9;0;0.83
26;413;1362;1365;3;0;0.83
26;414;1365;1366;1;0;0.83
26;415;1366;1368;2;0;0.83
26;416;1368;1383;15;0;0.83
26;417;1383;1387;4;0;0.83
26;418;1387;1402;15;0;0.83
26;419;1402;1417;15;0;0.83
26;420;1417;1432;15;0;0.83
26;421;1432;1447;15;0;0.83
26;422;1447;1462;15;0;0.83
26;423;1462;1477;15;0;0.83
26;424;1477;1492;15;0;0.83
26;425;1492;1507;15;0;0.83
26;426;1507;1522;15;0;0.83
26;427;1522;1537;15;0;0.83
26;428;1537;1552;15;0;0.83
26;429;1552;1567;15;0;0.83
26;430;1567;1582;15;0;0.83
26;431;1582;1597;15;0;0.83
26;432;1597;1612;15;0;0.83
26;433;1612;1627;15;0;0.83
26;434;1627;1642;15;0;0.83
26;435;1642;1657;15;0;0.83
26;436;1657;1672;15;0;0.83
26;437;1672;1680;8;0;0.83
27;0;240;328;88;0;0.83
27;1;328;333;5;0;0.83
27;2;333;340;7;0;0.83
27;3;340;341;1;0;0.83
27;4;341;344;3;0;0.83
27;5;344;347;3;0;0.83
27;6;347;348;1;0;0.83
27;7;348;349;1;0;0.83
27;8;349;350;1;0;0.83
27;9;350;352;2;0;0.83
27;10;352;353;1;0;0.83
27;11;353;355;2;0;0.83
27;12;355;356;1;0;0.83
27;13;356;358;2;0;0.83
27;14;358;363;5;0;0.83
27;15;363;367;4;0;0.83
27;16;367;369;2;0;0.83
27;17;369;370;1;0;0.83
27;18;370;371;1;0;0.83
27;19;371;374;3;0;0.83
27;20;374;377;3;0;0.83
27;21;377;378;1;0;0.83
27;22;378;381;3;0;0.83
27;23;381;382;1;0;0.83
27;24;382;383;1;0;0.83
27;25;383;386;3;0;0.83
27;26;386;387;1;0;0.83
27;27;387;390;3;0;0.83
27;28;390;391;1;0;0.83
27;29;391;396;5;0;0.83
27;30;396;397;1;0;0.83
27;31;397;399;2;0;0.83
27;32;399;401;2;0;0.83
27;33;401;402;1;0;0.83
27;34;402;406;4;0;0.83
27;35;406;407;1;0;0.83
27;36;407;408;1;0;0.83
27;37;408;410;2;0;0.83
27;38;410;411;1;0;0.83
27;39;411;413;2;0;0.83
27;40;413;414;1;0;0.83
27;41;414;416;2;0;0.83
27;42;416;417;1;0;0.83
27;43;417;418;1;0;0.83
27;44;418;421;3;0;0.83
27;45;421;422;1;0;0.83
27;46;422;426;4;0;0.83
27;47;426;427;1;0;0.83
27;48;427;428;1;0;0.83
27;49;428;430;2;0;0.83
27;50;430;431;1;0;0.83
27;51;431;434;3;0;0.83
27;52;434;436;2;0;0.83
27;53;436;437;1;0;0.83
27;54;437;441;4;0;0.83
27;55;441;442;1;0;0.83
27;56;442;443;1;0;0.83
27;57;443;444;1;0;0.83
27;58;444;446;2;0;0.83
27;59;446;447;1;0;0.83
27;60;447;450;3;0;0.83
27;61;450;451;1;0;0.83
27;62;451;456;5;0;0.83
27;63;456;457;1;0;0.83
27;64;457;458;1;0;0.83
27;65;458;459;1;0;0.83
27;66;459;461;2;0;0.83
27;67;461;462;1;0;0.83
27;68;462;466;4;0;0.83
27;69;466;467;1;0;0.83
27;70;467;468;1;0;0.83
27;71;468;470;2;0;0.83
27;72;470;471;1;0;0.83
27;73;471;473;2;0;0.83
27;74;473;474;1;0;0.83
27;75;474;476;2;0;0.83
27;76;476;477;1;0;0.83
27;77;477;478;1;0;0.83
27;78;478;481;3;0;0.83
27;79;481;482;1;0;0.83
27;80;482;486;4;0;0.83
27;81;486;487;1;0;0.83
27;82;487;490;3;0;0.83
27;83;490;491;1;0;0.83
27;84;491;494;3;0;0.83
27;85;494;496;2;0;0.83
27;86;496;497;1;0;0.83
27;87;497;498;1;0;0.83
27;88;498;502;4;0;0.83
27;89;502;504;2;0;0.83
27;90;504;506;2;0;0.83
27;91;506;507;1;0;0.83
27;92;507;510;3;0;0.83
27;93;510;516;6;0;0.83
27;94;516;517;1;0;0.83
27;95;517;518;1;0;0.83
27;96;518;522;4;0;0.83
27;97;522;523;1;0;0.83
27;98;523;526;3;0;0.83
27;99;526;527;1;0;0.83
27;100;527;530;3;0;0.83
27;101;530;531;1;0;0.83
27;102;531;533;2;0;0.83
27;103;533;541;8;0;0.83
27;104;541;542;1;0;0.83
27;105;542;546;4;0;0.83
27;106;546;547;1;0;0.83
27;107;547;550;3;0;0.83
27;108;550;558;8;0;0.83
27;109;558;561;3;0;0.83
27;110;561;562;1;0;0.83
27;111;562;566;4;0;0.83
27;112;566;567;1;0;0.83
27;113;567;570;3;0;0.83
27;114;570;571;1;0;0.83
27;115;571;577;6;0;0.83
27;116;577;581;4;0;0.83
27;117;581;582;1;0;0.83
27;118;582;586;4;0;0.83
27;119;586;587;1;0;0.83
27;120;587;590;3;0;0.83
27;121;590;593;3;0;0.83
27;122;593;598;5;0;0.83
27;123;598;601;3;0;0.83
27;124;601;602;1;0;0.83
27;125;602;606;4;0;0.83
27;126;606;607;1;0;0.83
27;127;607;610;3;0;0.83
27;128;610;611;1;0;0.83
27;129;611;621;10;0;0.83
27;130;621;622;1;0;0.83
27;131;622;626;4;0;0.83
27;132;626;627;1;0;0.83
27;133;627;630;3;0;0.83
27;134;630;631;1;0;0.83
27;135;631;637;6;0;0.83
27;136;637;641;4;0;0.83
27;137;641;642;1;0;0.83
27;138;642;646;4;0;0.83
27;139;646;647;1;0;0.83
27;140;647;650;3;0;0.83
27;141;650;653;3;0;0.83
27;142;653;658;5;0;0.83
27;143;658;661;3;0;0.83
27;144;661;662;1;0;0.83
27;145;662;666;4;0;0.83
27;146;666;667;1;0;0.83
27;147;667;670;3;0;0.83
27;148;670;671;1;0;0.83
27;149;671;681;10;0;0.83
27;150;681;682;1;0;0.83
27;151;682;686;4;0;0.83
27;152;686;687;1;0;0.83
27;153;687;690;3;0;0.83
27;154;690;691;1;0;0.83
27;155;691;697;6;0;0.83
27;156;697;701;4;0;0.83
27;157;701;702;1;0;0.83
27;158;702;706;4;0;0.83
27;159;706;707;1;0;0.83
27;160;707;710;3;0;0.83
27;161;710;713;3;0;0.83
27;162;713;718;5;0;0.83
27;163;718;721;3;0;0.83
27;164;721;722;1;0;0.83
27;165;722;726;4;0;0.83
27;166;726;727;1;0;0.83
27;167;727;730;3;0;0.83
27;168;730;731;1;0;0.83
27;169;731;741;10;0;0.83
27;170;741;742;1;0;0.83
27;171;742;746;4;0;0.83
27;172;746;747;1;0;0.83
27;173;747;750;3;0;0.83
27;174;750;751;1;0;0.83
27;175;751;757;6;0;0.83
27;176;757;761;4;0;0.83
27;177;761;762;1;0;0.83
27;178;762;766;4;0;0.83
27;179;766;767;1;0;0.83
27;180;767;770;3;0;0.83
27;181;770;773;3;0;0.83
27;182;773;778;5;0;0.83
27;183;778;781;3;0;0.83
27;184;781;782;1;0;0.83
27;185;782;786;4;0;0.83
27;186;786;787;1;0;0.83
27;187;787;790;3;0;0.83
27;188;790;791;1;0;0.83
27;189;791;797;6;0;0.83
27;190;797;801;4;0;0.83
27;191;801;802;1;0;0.83
27;192;802;806;4;0;0.83
27;193;806;807;1;0;0.83
27;194;807;810;3;0;0.83
27;195;810;813;3;0;0.83
27;196;813;817;4;0;0.83
27;197;817;818;1;0;0.83
27;198;818;821;3;0;0.83
27;199;821;822;1;0;0.83
27;200;822;826;4;0;0.83
27;201;826;827;1;0;0.83
27;202;827;830;3;0;0.83
27;203;830;833;3;0;0.83
27;204;833;834;1;0;0.83
27;205;834;837;3;0;0.83
27;206;837;838;1;0;0.83
27;207;838;841;3;0;0.83
27;208;841;842;1;0;0.83
27;209;842;846;4;0;0.83
27;210;846;847;1;0;0.83
27;211;847;848;1;0;0.83
27;212;848;850;2;0;0.83
27;213;850;851;1;0;0.83
27;214;851;854;3;0;0.83
27;215;854;857;3;0;0.83
27;216;857;860;3;0;0.83
27;217;860;861;1;0;0.83
27;218;861;862;1;0;0.83
27;219;862;866;4;0;0.83
27;220;866;867;1;0;0.83
27;221;867;870;3;0;0.83
27;222;870;871;1;0;0.83
27;223;871;873;2;0;0.83
27;224;873;874;1;0;0.83
27;225;874;876;2;0;0.83
27;226;876;877;1;0;0.83
27;227;877;881;4;0;0.83
27;228;881;882;1;0;0.83
27;229;882;886;4;0;0.83
27;230;886;887;1;0;0.83
27;231;887;890;3;0;0.83
27;232;890;891;1;0;0.83
27;233;891;892;1;0;0.83
27;234;892;893;1;0;0.83
27;235;893;894;1;0;0.83
27;236;894;896;2;0;0.83
27;237;896;897;1;0;0.83
27;238;897;898;1;0;0.83
27;239;898;901;3;0;0.83
27;240;901;902;1;0;0.83
27;241;902;906;4;0;0.83
27;242;906;907;1;0;0.83
27;243;907;908;1;0;0.83
27;244;908;910;2;0;0.83
27;245;910;911;1;0;0.83
27;246;911;914;3;0;0.83
27;247;914;916;2;0;0.83
27;248;916;917;1;0;0.83
27;249;917;921;4;0;0.83
27;250;921;922;1;0;0.83
27;251;922;926;4;0;0.83
27;252;926;927;1;0;0.83
27;253;927;930;3;0;0.83
27;254;930;931;1;0;0.83
27;255;931;933;2;0;0.83
27;256;933;934;1;0;0.83
27;257;934;936;2;0;0.83
27;258;936;937;1;0;0.83
27;259;937;941;4;0;0.83
27;260;941;942;1;0;0.83
27;261;942;946;4;0;0.83
27;262;946;947;1;0;0.83
27;263;947;950;3;0;0.83
27;264;950;951;1;0;0.83
27;265;951;952;1;0;0.83
27;266;952;953;1;0;0.83
27;267;953;954;1;0;0.83
27;268;954;956;2;0;0.83
27;269;956;957;1;0;0.83
27;270;957;958;1;0;0.83
27;271;958;961;3;0;0.83
27;272;961;962;1;0;0.83
27;273;962;966;4;0;0.83
27;274;966;967;1;0;0.83
27;275;967;968;1;0;0.83
27;276;968;970;2;0;0.83
27;277;970;971;1;0;0.83
27;278;971;974;3;0;0.83
27;279;974;976;2;0;0.83
27;280;976;977;1;0;0.83
27;281;977;981;4;0;0.83
27;282;981;982;1;0;0.83
27;283;982;986;4;0;0.83
27;284;986;987;1;0;0.83
27;285;987;990;3;0;0.83
27;286;990;991;1;0;0.83
27;287;991;994;3;0;0.83
27;288;994;996;2;0;0.83
27;289;996;997;1;0;0.83
27;290;997;1000;3;0;0.83
27;291;1000;1001;1;0;0.83
27;292;1001;1002;1;0;0.83
27;293;1002;1006;4;0;0.83
27;294;1006;1007;1;0;0.83
27;295;1007;1008;1;0;0.83
27;296;1008;1010;2;0;0.83
27;297;1010;1011;1;0;0.83
27;298;1011;1012;1;0;0.83
27;299;1012;1014;2;0;0.83
27;300;1014;1017;3;0;0.83
27;301;1017;1018;1;0;0.83
27;302;1018;1021;3;0;0.83
27;303;1021;1022;1;0;0.83
27;304;1022;1026;4;0;0.83
27;305;1026;1028;2;0;0.83
27;306;1028;1030;2;0;0.83
27;307;1030;1031;1;0;0.83
27;308;1031;1032;1;0;0.83
27;309;1032;1034;2;0;0.83
27;310;1034;1036;2;0;0.83
27;311;1036;1041;5;0;0.83
27;312;1041;1042;1;0;0.83
27;313;1042;1047;5;0;0.83
27;314;1047;1050;3;0;0.83
27;315;1050;1051;1;0;0.83
27;316;1051;1052;1;0;0.83
27;317;1052;1054;2;0;0.83
27;318;1054;1056;2;0;0.83
27;319;1056;1062;6;0;0.83
27;320;1062;1066;4;0;0.83
27;321;1066;1070;4;0;0.83
27;322;1070;1071;1;0;0.83
27;323;1071;1072;1;0;0.83
27;324;1072;1074;2;0;0.83
27;325;1074;1077;3;0;0.83
27;326;1077;1078;1;0;0.83
27;327;1078;1081;3;0;0.83
27;328;1081;1082;1;0;0.83
27;329;1082;1086;4;0;0.83
27;330;1086;1090;4;0;0.83
27;331;1090;1091;1;0;0.83
27;332;1091;1092;1;0;0.83
27;333;1092;1094;2;0;0.83
27;334;1094;1096;2;0;0.83
27;335;1096;1101;5;0;0.83
27;336;1101;1102;1;0;0.83
27;337;1102;1107;5;0;0.83
27;338;1107;1110;3;0;0.83
27;339;1110;1111;1;0;0.83
27;340;1111;1112;1;0;0.83
27;341;1112;1114;2;0;0.83
27;342;1114;1116;2;0;0.83
27;343;1116;1117;1;0;0.83
27;344;1117;1119;2;0;0.83
27;345;1119;1122;3;0;0.83
27;346;1122;1123;1;0;0.83
27;347;1123;1128;5;0;0.83
27;348;1128;1129;1;0;0.83
27;349;1129;1133;4;0;0.83
27;350;1133;1134;1;0;0.83
27;351;1134;1135;1;0;0.83
27;352;1135;1142;7;0;0.83
27;353;1142;1143;1;0;0.83
27;354;1143;1147;4;0;0.83
27;355;1147;1149;2;0;0.83
27;356;1149;1155;6;0;0.83
27;357;1155;1158;3;0;0.83
27;358;1158;1162;4;0;0.83
27;359;1162;1163;1;0;0.83
27;360;1163;1164;1;0;0.83
27;361;1164;1172;8;0;0.83
27;362;1172;1175;3;0;0.83
27;363;1175;1178;3;0;0.83
27;364;1178;1180;2;0;0.83
27;365;1180;1182;2;0;0.83
27;366;1182;1183;1;0;0.83
27;367;1183;1184;1;0;0.83
27;368;1184;1189;5;0;0.83
27;369;1189;1198;9;0;0.83
27;370;1198;1199;1;0;0.83
27;371;1199;1203;4;0;0.83
27;372;1203;1204;1;0;0.83
27;373;1204;1205;1;0;0.83
27;374;1205;1207;2;0;0.83
27;375;1207;1212;5;0;0.83
27;376;1212;1218;6;0;0.83
27;377;1218;1227;9;0;0.83
27;378;1227;1228;1;0;0.83
27;379;1228;1229;1;0;0.83
27;380;1229;1230;1;0;0.83
27;381;1230;1234;4;0;0.83
27;382;1234;1235;1;0;0.83
27;383;1235;1238;3;0;0.83
27;384;1238;1240;2;0;0.83
27;385;1240;1252;12;0;0.83
27;386;1252;1253;1;0;0.83
27;387;1253;1254;1;0;0.83
27;388;1254;1255;1;0;0.83
27;389;1255;1263;8;0;0.83
27;390;1263;1269;6;0;0.83
27;391;1269;1274;5;0;0.83
27;392;1274;1275;1;0;0.83
27;393;1275;1277;2;0;0.83
27;394;1277;1278;1;0;0.83
27;395;1278;1279;1;0;0.83
27;396;1279;1287;8;0;0.83
27;397;1287;1288;1;0;0.83
27;398;1288;1303;15;0;0.83
27;399;1303;1304;1;0;0.83
27;400;1304;1310;6;0;0.83
27;401;1310;1312;2;0;0.83
27;402;1312;1313;1;0;0.83
27;403;1313;1314;1;0;0.83
27;404;1314;1324;10;0;0.83
27;405;1324;1332;8;0;0.83
27;406;1332;1333;1;0;0.83
27;407;1333;1337;4;0;0.83
27;408;1337;1338;1;0;0.83
27;409;1338;1344;6;0;0.83
27;410;1344;1349;5;0;0.83
27;411;1349;1353;4;0;0.83
27;412;1353;1362;9;0;0.83
27;413;1362;1365;3;0;0.83
27;414;1365;1366;1;0;0.83
27;415;1366;1368;2;0;0.83
27;416;1368;1383;15;0;0.83
27;417;1383;1387;4;0;0.83
27;418;1387;1402;15;0;0.83
27;419;1402;1417;15;0;0.83
27;420;1417;1432;15;0;0.83
27;421;1432;1447;15;0;0.83
27;422;1447;1462;15;0;0.83
27;423;1462;1477;15;0;0.83
27;424;1477;1492;15;0;0.83
27;425;1492;1507;15;0;0.83
27;426;1507;1522;15;0;0.83
27;427;1522;1537;15;0;0.83
27;428;1537;1552;15;0;0.83
27;429;1552;1567;15;0;0.83
27;430;1567;1582;15;0;0.83
27;431;1582;1597;15;0;0.83
27;432;1597;1612;15;0;0.83
27;433;1612;1627;15;0;0.83
27;434;1627;1642;15;0;0.83
27;435;1642;1657;15;0;0.83
27;436;1657;1672;15;0;0.83
27;437;1672;1680;8;0;0.83
28;0;240;328;88;0;0.83
28;1;328;333;5;0;0.83
28;2;333;340;7;0;0.83
28;3;340;341;1;0;0.83
28;4;341;344;3;0;0.83
28;5;344;347;3;0;0.83
28;6;347;348;1;0;0.83
28;7;348;349;1;0;0.83
28;8;349;350;1;0;0.83
28;9;350;352;2;0;0.83
28;10;352;353;1;0;0.83
28;11;353;355;2;0;0.83
28;12;355;356;1;0;0.83
28;13;356;358;2;0;0.83
28;14;358;363;5;0;0.83
28;15;363;367;4;0;0.83
28;16;367;369;2;0;0.83
28;17;369;370;1;0;0.83
28;18;370;371;1;0;0.83
28;19;371;374;3;0;0.83
28;20;374;377;3;0;0.83
28;21;377;378;1;0;0.83
28;22;378;381;3;0;0.83
28;23;381;382;1;0;0.83
28;24;382;383;1;0;0.83
28;25;383;386;3;0;0.83
28;26;386;387;1;0;0.83
28;27;387;390;3;0;0.83
28;28;390;391;1;0;0.83
28;29;391;396;5;0;0.83
28;30;396;397;1;0;0.83
28;31;397;399;2;0;0.83
28;32;399;401;2;0;0.83
28;33;401;402;1;0;0.83
28;34;402;406;4;0;0.83
28;35;406;407;1;0;0.83
28;36;407;408;1;0;0.83
28;37;408;410;2;0;0.83
28;38;410;411;1;0;0.83
28;39;411;413;2;0;0.83
28;40;413;414;1;0;0.83
28;41;414;416;2;0;0.83
28;42;416;417;1;0;0.83
28;43;417;418;1;0;0.83
28;44;418;421;3;0;0.83
28;45;421;422;1;0;0.83
28;46;422;426;4;0;0.83
28;47;426;427;1;0;0.83
28;48;427;428;1;0;0.83
28;49;428;430;2;0;0.83
28;50;430;431;1;0;0.83
28;51;431;434;3;0;0.83
28;52;434;436;2;0;0.83
28;53;436;437;1;0;0.83
28;54;437;441;4;0;0.83
28;55;441;442;1;0;0.83
28;56;442;443;1;0;0.83
28;57;443;444;1;0;0.83
28;58;444;446;2;0;0.83
28;59;446;447;1;0;0.83
28;60;447;450;3;0;0.83
28;61;450;451;1;0;0.83
28;62;451;456;5;0;0.83
28;63;456;457;1;0;0.83
28;64;457;458;1;0;0.83
28;65;458;459;1;0;0.83
28;66;459;461;2;0;0.83
28;67;461;462;1;0;0.83
28;68;462;466;4;0;0.83
28;69;466;467;1;0;0.83
28;70;467;468;1;0;0.83
28;71;468;470;2;0;0.83
28;72;470;471;1;0;0.83
28;73;471;473;2;0;0.83
28;74;473;474;1;0;0.83
28;75;474;476;2;0;0.83
28;76;476;477;1;0;0.83
28;77;477;478;1;0;0.83
28;78;478;481;3;0;0.83
28;79;481;482;1;0;0.83
28;80;482;486;4;0;0.83
28;81;486;487;1;0;0.83
28;82;487;490;3;0;0.83
28;83;490;491;1;0;0.83
28;84;491;494;3;0;0.83
28;85;494;496;2;0;0.83
28;86;496;497;1;0;0.83
28;87;497;498;1;0;0.83
28;88;498;502;4;0;0.83
28;89;502;504;2;0;0.83
28;90;504;506;2;0;0.83
28;91;506;507;1;0;0.83
28;92;507;510;3;0;0.83
28;93;510;516;6;0;0.83
28;94;516;517;1;0;0.83
28;95;517;518;1;0;0.83
28;96;518;522;4;0;0.83
28;97;522;523;1;0;0.83
28;98;523;526;3;0;0.83
28;99;526;527;1;0;0.83
28;100;527;530;3;0;0.83
28;101;530;531;1;0;0.83
28;102;531;533;2;0;0.83
28;103;533;541;8;0;0.83
28;104;541;542;1;0;0.83
28;105;542;546;4;0;0.83
28;106;546;547;1;0;0.83
28;107;547;550;3;0;0.83
28;108;550;558;8;0;0.83
28;109;558;561;3;0;0.83
28;110;561;562;1;0;0.83
28;111;562;566;4;0;0.83
28;112;566;567;1;0;0.83
28;113;567;570;3;0;0.83
28;114;570;571;1;0;0.83
28;115;571;577;6;0;0.83
28;116;577;581;4;0;0.83
28;117;581;582;1;0;0.83
28;118;582;586;4;0;0.83
28;119;586;587;1;0;0.83
28;120;587;590;3;0;0.83
28;121;590;593;3;0;0.83
28;122;593;598;5;0;0.83
28;123;598;601;3;0;0.83
28;124;601;602;1;0;0.83
28;125;602;606;4;0;0.83
28;126;606;607;1;0;0.83
28;127;607;610;3;0;0.83
28;128;610;611;1;0;0.83
28;129;611;621;10;0;0.83
28;130;621;622;1;0;0.83
28;131;622;626;4;0;0.83
28;132;626;627;1;0;0.83
28;133;627;630;3;0;0.83
28;134;630;631;1;0;0.83
28;135;631;637;6;0;0.83
28;136;637;641;4;0;0.83
28;137;641;642;1;0;0.83
28;138;642;646;4;0;0.83
28;139;646;647;1;0;0.83
28;140;647;650;3;0;0.83
28;141;650;653;3;0;0.83
28;142;653;658;5;0;0.83
28;143;658;661;3;0;0.83
28;144;661;662;1;0;0.83
28;145;662;666;4;0;0.83
28;146;666;667;1;0;0.83
28;147;667;670;3;0;0.83
28;148;670;671;1;0;0.83
28;149;671;681;10;0;0.83
28;150;681;682;1;0;0.83
28;151;682;686;4;0;0.83
28;152;686;687;1;0;0.83
28;153;687;690;3;0;0.83
28;154;690;691;1;0;0.83
28;155;691;697;6;0;0.83
28;156;697;701;4;0;0.83
28;157;701;702;1;0;0.83
28;158;702;706;4;0;0.83
28;159;706;707;1;0;0.83
28;160;707;710;3;0;0.83
28;161;710;713;3;0;0.83
28;162;713;718;5;0;0.83
28;163;718;721;3;0;0.83
28;164;721;722;1;0;0.83
28;165;722;726;4;0;0.83
28;166;726;727;1;0;0.83
28;167;727;730;3;0;0.83
28;168;730;731;1;0;0.83
28;169;731;741;10;0;0.83
28;170;741;742;1;0;0.83
28;171;742;746;4;0;0.83
28;172;746;747;1;0;0.83
28;173;747;750;3;0;0.83
28;174;750;751;1;0;0.83
28;175;751;757;6;0;0.83
28;176;757;761;4;0;0.83
28;177;761;762;1;0;0.83
28;178;762;766;4;0;0.83
28;179;766;767;1;0;0.83
28;180;767;770;3;0;0.83
28;181;770;773;3;0;0.83
28;182;773;778;5;0;0.83
28;183;778;781;3;0;0.83
28;184;781;782;1;0;0.83
28;185;782;786;4;0;0.83
28;186;786;787;1;0;0.83
28;187;787;790;3;0;0.83
28;188;790;791;1;0;0.83
28;189;791;797;6;0;0.83
28;190;797;801;4;0;0.83
28;191;801;802;1;0;0.83
28;192;802;806;4;0;0.83
28;193;806;807;1;0;0.83
28;194;807;810;3;0;0.83
28;195;810;813;3;0;0.83
28;196;813;817;4;0;0.83
28;197;817;818;1;0;0.83
28;198;818;821;3;0;0.83
28;199;821;822;1;0;0.83
28;200;822;826;4;0;0.83
28;201;826;827;1;0;0.83
28;202;827;830;3;0;0.83
28;203;830;833;3;0;0.83
28;204;833;834;1;0;0.83
28;205;834;837;3;0;0.83
28;206;837;838;1;0;0.83
28;207;838;841;3;0;0.83
28;208;841;842;1;0;0.83
28;209;842;846;4;0;0.83
28;210;846;847;1;0;0.83
28;211;847;848;1;0;0.83
28;212;848;850;2;0;0.83
28;213;850;851;1;0;0.83
28;214;851;854;3;0;0.83
28;215;854;857;3;0;0.83
28;216;857;860;3;0;0.83
28;217;860;861;1;0;0.83
28;218;861;862;1;0;0.83
28;219;862;866;4;0;0.83
28;220;866;867;1;0;0.83
28;221;867;870;3;0;0.83
28;222;870;871;1;0;0.83
28;223;871;873;2;0;0.83
28;224;873;874;1;0;0.83
28;225;874;876;2;0;0.83
28;226;876;877;1;0;0.83
28;227;877;881;4;0;0.83
28;228;881;882;1;0;0.83
28;229;882;886;4;0;0.83
28;230;886;887;1;0;0.83
28;231;887;890;3;0;0.83
28;232;890;891;1;0;0.83
28;233;891;892;1;0;0.83
28;234;892;893;1;0;0.83
28;235;893;894;1;0;0.83
28;236;894;896;2;0;0.83
28;237;896;897;1;0;0.83
28;238;897;898;1;0;0.83
28;239;898;901;3;0;0.83
28;240;901;902;1;0;0.83
28;241;902;906;4;0;0.83
28;242;906;907;1;0;0.83
28;243;907;908;1;0;0.83
28;244;908;910;2;0;0.83
28;245;910;911;1;0;0.83
28;246;911;914;3;0;0.83
28;247;914;916;2;0;0.83
28;248;916;917;1;0;0.83
28;249;917;921;4;0;0.83
28;250;921;922;1;0;0.83
28;251;922;926;4;0;0.83
28;252;926;927;1;0;0.83
28;253;927;930;3;0;0.83
28;254;930;931;1;0;0.83
28;255;931;933;2;0;0.83
28;256;933;934;1;0;0.83
28;257;934;936;2;0;0.83
28;258;936;937;1;0;0.83
28;259;937;941;4;0;0.83
28;260;941;942;1;0;0.83
28;261;942;946;4;0;0.83
28;262;946;947;1;0;0.83
28;263;947;950;3;0;0.83
28;264;950;951;1;0;0.83
28;265;951;952;1;0;0.83
28;266;952;953;1;0;0.83
28;267;953;954;1;0;0.83
28;268;954;956;2;0;0.83
28;269;956;957;1;0;0.83
28;270;957;958;1;0;0.83
28;271;958;961;3;0;0.83
28;272;961;962;1;0;0.83
28;273;962;966;4;0;0.83
28;274;966;967;1;0;0.83
28;275;967;968;1;0;0.83
28;276;968;970;2;0;0.83
28;277;970;971;1;0;0.83
28;278;971;974;3;0;0.83
28;279;974;976;2;0;0.83
28;280;976;977;1;0;0.83
28;281;977;981;4;0;0.83
28;282;981;982;1;0;0.83
28;283;982;986;4;0;0.83
28;284;986;987;1;0;0.83
28;285;987;990;3;0;0.83
28;286;990;991;1;0;0.83
28;287;991;994;3;0;0.83
28;288;994;996;2;0;0.83
28;289;996;997;1;0;0.83
28;290;997;1000;3;0;0.83
28;291;1000;1001;1;0;0.83
28;292;1001;1002;1;0;0.83
28;293;1002;1006;4;0;0.83
28;294;1006;1007;1;0;0.83
28;295;1007;1008;1;0;0.83
28;296;1008;1010;2;0;0.83
28;297;1010;1011;1;0;0.83
28;298;1011;1012;1;0;0.83
28;299;1012;1014;2;0;0.83
28;300;1014;1017;3;0;0.83
28;301;1017;1018;1;0;0.83
28;302;1018;1021;3;0;0.83
28;303;1021;1022;1;0;0.83
28;304;1022;1026;4;0;0.83
28;305;1026;1028;2;0;0.83
28;306;1028;1030;2;0;0.83
28;307;1030;1031;1;0;0.83
28;308;1031;1032;1;0;0.83
28;309;1032;1034;2;0;0.83
28;310;1034;1036;2;0;0.83
28;311;1036;1041;5;0;0.83
28;312;1041;1042;1;0;0.83
28;313;1042;1047;5;0;0.83
28;314;1047;1050;3;0;0.83
28;315;1050;1051;1;0;0.83
28;316;1051;1052;1;0;0.83
28;317;1052;1054;2;0;0.83
28;318;1054;1056;2;0;0.83
28;319;1056;1062;6;0;0.83
28;320;1062;1066;4;0;0.83
28;321;1066;1070;4;0;0.83
28;322;1070;1071;1;0;0.83
28;323;1071;1072;1;0;0.83
28;324;1072;1074;2;0;0.83
28;325;1074;1077;3;0;0.83
28;326;1077;1078;1;0;0.83
28;327;1078;1081;3;0;0.83
28;328;1081;1082;1;0;0.83
28;329;1082;1086;4;0;0.83
28;330;1086;1090;4;0;0.83
28;331;1090;1091;1;0;0.83
28;332;1091;1092;1;0;0.83
28;333;1092;1094;2;0;0.83
28;334;1094;1096;2;0;0.83
28;335;1096;1101;5;0;0.83
28;336;1101;1102;1;0;0.83
28;337;1102;1107;5;0;0.83
28;338;1107;1110;3;0;0.83
28;339;1110;1111;1;0;0.83
28;340;1111;1112;1;0;0.83
28;341;1112;1114;2;0;0.83
28;342;1114;1116;2;0;0.83
28;343;1116;1117;1;0;0.83
28;344;1117;1119;2;0;0.83
28;345;1119;1122;3;0;0.83
28;346;1122;1123;1;0;0.83
28;347;1123;1128;5;0;0.83
28;348;1128;1129;1;0;0.83
28;349;1129;1133;4;0;0.83
28;350;1133;1134;1;0;0.83
28;351;1134;1135;1;0;0.83
28;352;1135;1142;7;0;0.83
28;353;1142;1143;1;0;0.83
28;354;1143;1147;4;0;0.83
28;355;1147;1149;2;0;0.83
28;356;1149;1155;6;0;0.83
28;357;1155;1158;3;0;0.83
28;358;1158;1162;4;0;0.83
28;359;1162;1163;1;0;0.83
28;360;1163;1164;1;0;0.83
28;361;1164;1172;8;0;0.83
28;362;1172;1175;3;0;0.83
28;363;1175;1178;3;0;0.83
28;364;1178;1180;2;0;0.83
28;365;1180;1182;2;0;0.83
28;366;1182;1183;1;0;0.83
28;367;1183;1184;1;0;0.83
28;368;1184;1189;5;0;0.83
28;369;1189;1198;9;0;0.83
28;370;1198;1199;1;0;0.83
28;371;1199;1203;4;0;0.83
28;372;1203;1204;1;0;0.83
28;373;1204;1205;1;0;0.83
28;374;1205;1207;2;0;0.83
28;375;1207;1212;5;0;0.83
28;376;1212;1218;6;0;0.83
28;377;1218;1227;9;0;0.83
28;378;1227;1228;1;0;0.83
28;379;1228;1229;1;0;0.83
28;380;1229;1230;1;0;0.83
28;381;1230;1234;4;0;0.83
28;382;1234;1235;1;0;0.83
28;383;1235;1238;3;0;0.83
28;384;1238;1240;2;0;0.83
28;385;1240;1252;12;0;0.83
28;386;1252;1253;1;0;0.83
28;387;1253;1254;1;0;0.83
28;388;1254;1255;1;0;0.83
28;389;1255;1263;8;0;0.83
28;390;1263;1269;6;0;0.83
28;391;1269;1274;5;0;0.83
28;392;1274;1275;1;0;0.83
28;393;1275;1277;2;0;0.83
28;394;1277;1278;1;0;0.83
28;395;1278;1279;1;0;0.83
28;396;1279;1287;8;0;0.83
28;397;1287;1288;1;0;0.83
28;398;1288;1303;15;0;0.83
28;399;1303;1304;1;0;0.83
28;400;1304;1310;6;0;0.83
28;401;1310;1312;2;0;0.83
28;402;1312;1313;1;0;0.83
28;403;1313;1314;1;0;0.83
28;404;1314;1324;10;0;0.83
28;405;1324;1332;8;0;0.83
28;406;1332;1333;1;0;0.83
28;407;1333;1337;4;0;0.83
28;408;1337;1338;1;0;0.83
28;409;1338;1344;6;0;0.83
28;410;1344;1349;5;0;0.83
28;411;1349;1353;4;0;0.83
28;412;1353;1362;9;0;0.83
28;413;1362;1365;3;0;0.83
28;414;1365;1366;1;0;0.83
28;415;1366;1368;2;0;0.83
28;416;1368;1383;15;0;0.83
28;417;1383;1387;4;0;0.83
28;418;1387;1402;15;0;0.83
28;419;1402;1417;15;0;0.83
28;420;1417;1432;15;0;0.83
28;421;1432;1447;15;0;0.83
28;422;1447;1462;15;0;0.83
28;423;1462;1477;15;0;0.83
28;424;1477;1492;15;0;0.83
28;425;1492;1507;15;0;0.83
28;426;1507;1522;15;0;0.83
28;427;1522;1537;15;0;0.83
28;428;1537;1552;15;0;0.83
28;429;1552;1567;15;0;0.83
28;430;1567;1582;15;0;0.83
28;431;1582;1597;15;0;0.83
28;432;1597;1612;15;0;0.83
28;433;1612;1627;15;0;0.83
28;434;1627;1642;15;0;0.83
28;435;1642;1657;15;0;0.83
28;436;1657;1672;15;0;0.83
28;437;1672;1680;8;0;0.83
29;0;240;328;88;0;2.0
29;1;328;333;5;0;2.0
29;2;333;340;7;0;2.0
29;3;340;341;1;0;2.0
29;4;341;344;3;0;2.0
29;5;344;347;3;0;2.0
29;6;347;348;1;0;2.0
29;7;348;349;1;0;2.0
29;8;349;350;1;0;2.0
29;9;350;352;2;0;2.0
29;10;352;353;1;0;2.0
29;11;353;355;2;0;2.0
29;12;355;356;1;0;2.0
29;13;356;358;2;0;2.0
29;14;358;363;5;0;2.0
29;15;363;367;4;0;2.0
29;16;367;369;2;0;2.0
29;17;369;370;1;0;2.0
29;18;370;371;1;0;2.0
29;19;371;374;3;0;2.0
29;20;374;377;3;0;2.0
29;21;377;378;1;0;2.0
29;22;378;381;3;0;2.0
29;23;381;382;1;0;2.0
29;24;382;383;1;0;2.0
29;25;383;386;3;0;2.0
29;26;386;387;1;0;2.0
29;27;387;390;3;0;2.0
29;28;390;391;1;0;2.0
29;29;391;396;5;0;2.0
29;30;396;397;1;0;2.0
29;31;397;399;2;0;2.0
29;32;399;401;2;0;2.0
29;33;401;402;1;0;2.0
29;34;402;406;4;0;2.0
29;35;406;407;1;0;2.0
29;36;407;408;1;0;2.0
29;37;408;410;2;0;2.0
29;38;410;411;1;0;2.0
29;39;411;413;2;0;2.0
29;40;413;414;1;0;2.0
29;41;414;416;2;0;2.0
29;42;416;417;1;0;2.0
29;43;417;418;1;0;2.0
29;44;418;421;3;0;2.0
29;45;421;422;1;0;2.0
29;46;422;426;4;0;2.0
29;47;426;427;1;0;2.0
29;48;427;428;1;0;2.0
29;49;428;430;2;0;2.0
29;50;430;431;1;0;2.0
29;51;431;434;3;0;2.0
29;52;434;436;2;0;2.0
29;53;436;437;1;0;2.0
29;54;437;441;4;0;2.0
29;55;441;442;1;0;2.0
29;56;442;443;1;0;2.0
29;57;443;444;1;0;2.0
29;58;444;446;2;0;2.0
29;59;446;447;1;0;2.0
29;60;447;450;3;0;2.0
29;61;450;451;1;0;2.0
29;62;451;456;5;0;2.0
29;63;456;457;1;0;2.0
29;64;457;458;1;0;2.0
29;65;458;459;1;0;2.0
29;66;459;461;2;0;2.0
29;67;461;462;1;0;2.0
29;68;462;466;4;0;2.0
29;69;466;467;1;0;2.0
29;70;467;468;1;0;2.0
29;71;468;470;2;0;2.0
29;72;470;471;1;0;2.0
29;73;471;473;2;0;2.0
29;74;473;474;1;0;2.0
29;75;474;476;2;0;2.0
29;76;476;477;1;0;2.0
29;77;477;478;1;0;2.0
29;78;478;481;3;0;2.0
29;79;481;482;1;0;2.0
29;80;482;486;4;0;2.0
29;81;486;487;1;0;2.0
29;82;487;490;3;0;2.0
29;83;490;491;1;0;2.0
29;84;491;494;3;0;2.0
29;85;494;496;2;0;2.0
29;86;496;497;1;0;2.0
29;87;497;498;1;0;2.0
29;88;498;502;4;0;2.0
29;89;502;504;2;0;2.0
29;90;504;506;2;0;2.0
29;91;506;507;1;0;2.0
29;92;507;510;3;0;2.0
29;93;510;516;6;0;2.0
29;94;516;517;1;0;2.0
29;95;517;518;1;0;2.0
29;96;518;522;4;0;2.0
29;97;522;523;1;0;2.0
29;98;523;526;3;0;2.0
29;99;526;527;1;0;2.0
29;100;527;530;3;0;2.0
29;101;530;531;1;0;2.0
29;102;531;533;2;0;2.0
29;103;533;541;8;0;2.0
29;104;541;542;1;0;2.0
29;105;542;546;4;0;2.0
29;106;546;547;1;0;2.0
29;107;547;550;3;0;2.0
29;108;550;558;8;0;2.0
29;109;558;561;3;0;2.0
29;110;561;562;1;0;2.0
29;111;562;566;4;0;2.0
29;112;566;567;1;0;2.0
29;113;567;570;3;0;2.0
29;114;570;571;1;0;2.0
29;115;571;577;6;0;2.0
29;116;577;581;4;0;2.0
29;117;581;582;1;0;2.0
29;118;582;586;4;0;2.0
29;119;586;587;1;0;2.0
29;120;587;590;3;0;2.0
29;121;590;593;3;0;2.0
29;122;593;598;5;0;2.0
29;123;598;601;3;0;2.0
29;124;601;602;1;0;2.0
29;125;602;606;4;0;2.0
29;126;606;607;1;0;2.0
29;127;607;610;3;0;2.0
29;128;610;611;1;0;2.0
29;129;611;621;10;0;2.0
29;130;621;622;1;0;2.0
29;131;622;626;4;0;2.0
29;132;626;627;1;0;2.0
29;133;627;630;3;0;2.0
29;134;630;631;1;0;2.0
29;135;631;637;6;0;2.0
29;136;637;641;4;0;2.0
29;137;641;642;1;0;2.0
29;138;642;646;4;0;2.0
29;139;646;647;1;0;2.0
29;140;647;650;3;0;2.0
29;141;650;653;3;0;2.0
29;142;653;658;5;0;2.0
29;143;658;661;3;0;2.0
29;144;661;662;1;0;2.0
29;145;662;666;4;0;2.0
29;146;666;667;1;0;2.0
29;147;667;670;3;0;2.0
29;148;670;671;1;0;2.0
29;149;671;681;10;0;2.0
29;150;681;682;1;0;2.0
29;151;682;686;4;0;2.0
29;152;686;687;1;0;2.0
29;153;687;690;3;0;2.0
29;154;690;691;1;0;2.0
29;155;691;697;6;0;2.0
29;156;697;701;4;0;2.0
29;157;701;702;1;0;2.0
29;158;702;706;4;0;2.0
29;159;706;707;1;0;2.0
29;160;707;710;3;0;2.0
29;161;710;713;3;0;2.0
29;162;713;718;5;0;2.0
29;163;718;721;3;0;2.0
29;164;721;722;1;0;2.0
29;165;722;726;4;0;2.0
29;166;726;727;1;0;2.0
29;167;727;730;3;0;2.0
29;168;730;731;1;0;2.0
29;169;731;741;10;0;2.0
29;170;741;742;1;0;2.0
29;171;742;746;4;0;2.0
29;172;746;747;1;0;2.0
29;173;747;750;3;0;2.0
29;174;750;751;1;0;2.0
29;175;751;757;6;0;2.0
29;176;757;761;4;0;2.0
29;177;761;762;1;0;2.0
29;178;762;766;4;0;2.0
29;179;766;767;1;0;2.0
29;180;767;770;3;0;2.0
29;181;770;773;3;0;2.0
29;182;773;778;5;0;2.0
29;183;778;781;3;0;2.0
29;184;781;782;1;0;2.0
29;185;782;786;4;0;2.0
29;186;786;787;1;0;2.0
29;187;787;790;3;0;2.0
29;188;790;791;1;0;2.0
29;189;791;797;6;0;2.0
29;190;797;801;4;0;2.0
29;191;801;802;1;0;2.0
29;192;802;806;4;0;2.0
29;193;806;807;1;0;2.0
29;194;807;810;3;0;2.0
29;195;810;813;3;0;2.0
29;196;813;817;4;0;2.0
29;197;817;818;1;0;2.0
29;198;818;821;3;0;2.0
29;199;821;822;1;0;2.0
29;200;822;826;4;0;2.0
29;201;826;827;1;0;2.0
29;202;827;830;3;0;2.0
29;203;830;833;3;0;2.0
29;204;833;834;1;0;2.0
29;205;834;837;3;0;2.0
29;206;837;838;1;0;2.0
29;207;838;841;3;0;2.0
29;208;841;842;1;0;2.0
29;209;842;846;4;0;2.0
29;210;846;847;1;0;2.0
29;211;847;848;1;0;2.0
29;212;848;850;2;0;2.0
29;213;850;851;1;0;2.0
29;214;851;854;3;0;2.0
29;215;854;857;3;0;2.0
29;216;857;860;3;0;2.0
29;217;860;861;1;0;2.0
29;218;861;862;1;0;2.0
29;219;862;866;4;0;2.0
29;220;866;867;1;0;2.0
29;221;867;870;3;0;2.0
29;222;870;871;1;0;2.0
29;223;871;873;2;0;2.0
29;224;873;874;1;0;2.0
29;225;874;876;2;0;2.0
29;226;876;877;1;0;2.0
29;227;877;881;4;0;2.0
29;228;881;882;1;0;2.0
29;229;882;886;4;0;2.0
29;230;886;887;1;0;2.0
29;231;887;890;3;0;2.0
29;232;890;891;1;0;2.0
29;233;891;892;1;0;2.0
29;234;892;893;1;0;2.0
29;235;893;894;1;0;2.0
29;236;894;896;2;0;2.0
29;237;896;897;1;0;2.0
29;238;897;898;1;0;2.0
29;239;898;901;3;0;2.0
29;240;901;902;1;0;2.0
29;241;902;906;4;0;2.0
29;242;906;907;1;0;2.0
29;243;907;908;1;0;2.0
29;244;908;910;2;0;2.0
29;245;910;911;1;0;2.0
29;246;911;914;3;0;2.0
29;247;914;916;2;0;2.0
29;248;916;917;1;0;2.0
29;249;917;921;4;0;2.0
29;250;921;922;1;0;2.0
29;251;922;926;4;0;2.0
29;252;926;927;1;0;2.0
29;253;927;930;3;0;2.0
29;254;930;931;1;0;2.0
29;255;931;933;2;0;2.0
29;256;933;934;1;0;2.0
29;257;934;936;2;0;2.0
29;258;936;937;1;0;2.0
29;259;937;941;4;0;2.0
29;260;941;942;1;0;2.0
29;261;942;946;4;0;2.0
29;262;946;947;1;0;2.0
29;263;947;950;3;0;2.0
29;264;950;951;1;0;2.0
29;265;951;952;1;0;2.0
29;266;952;953;1;0;2.0
29;267;953;954;1;0;2.0
29;268;954;956;2;0;2.0
29;269;956;957;1;0;2.0
29;270;957;958;1;0;2.0
29;271;958;961;3;0;2.0
29;272;961;962;1;0;2.0
29;273;962;966;4;0;2.0
29;274;966;967;1;0;2.0
29;275;967;968;1;0;2.0
29;276;968;970;2;0;2.0
29;277;970;971;1;0;2.0
29;278;971;974;3;0;2.0
29;279;974;976;2;0;2.0
29;280;976;977;1;0;2.0
29;281;977;981;4;0;2.0
29;282;981;982;1;0;2.0
29;283;982;986;4;0;2.0
29;284;986;987;1;0;2.0
29;285;987;990;3;0;2.0
29;286;990;991;1;0;2.0
29;287;991;994;3;0;2.0
29;288;994;996;2;0;2.0
29;289;996;997;1;0;2.0
29;290;997;1000;3;0;2.0
29;291;1000;1001;1;0;2.0
29;292;1001;1002;1;0;2.0
29;293;1002;1006;4;0;2.0
29;294;1006;1007;1;0;2.0
29;295;1007;1008;1;0;2.0
29;296;1008;1010;2;0;2.0
29;297;1010;1011;1;0;2.0
29;298;1011;1012;1;0;2.0
29;299;1012;1014;2;0;2.0
29;300;1014;1017;3;0;2.0
29;301;1017;1018;1;0;2.0
29;302;1018;1021;3;0;2.0
29;303;1021;1022;1;0;2.0
29;304;1022;1026;4;0;2.0
29;305;1026;1028;2;0;2.0
29;306;1028;1030;2;0;2.0
29;307;1030;1031;1;0;2.0
29;308;1031;1032;1;0;2.0
29;309;1032;1034;2;0;2.0
29;310;1034;1036;2;0;2.0
29;311;1036;1041;5;0;2.0
29;312;1041;1042;1;0;2.0
29;313;1042;1047;5;0;2.0
29;314;1047;1050;3;0;2.0
29;315;1050;1051;1;0;2.0
29;316;1051;1052;1;0;2.0
29;317;1052;1054;2;0;2.0
29;318;1054;1056;2;0;2.0
29;319;1056;1062;6;0;2.0
29;320;1062;1066;4;0;2.0
29;321;1066;1070;4;0;2.0
29;322;1070;1071;1;0;2.0
29;323;1071;1072;1;0;2.0
29;324;1072;1074;2;0;2.0
29;325;1074;1077;3;0;2.0
29;326;1077;1078;1;0;2.0
29;327;1078;1081;3;0;2.0
29;328;1081;1082;1;0;2.0
29;329;1082;1086;4;0;2.0
29;330;1086;1090;4;0;2.0
29;331;1090;1091;1;0;2.0
29;332;1091;1092;1;0;2.0
29;333;1092;1094;2;0;2.0
29;334;1094;1096;2;0;2.0
29;335;1096;1101;5;0;2.0
29;336;1101;1102;1;0;2.0
29;337;1102;1107;5;0;2.0
29;338;1107;1110;3;0;2.0
29;339;1110;1111;1;0;2.0
29;340;1111;1112;1;0;2.0
29;341;1112;1114;2;0;2.0
29;342;1114;1116;2;0;2.0
29;343;1116;1117;1;0;2.0
29;344;1117;1119;2;0;2.0
29;345;1119;1122;3;0;2.0
29;346;1122;1123;1;0;2.0
29;347;1123;1128;5;0;2.0
29;348;1128;1129;1;0;2.0
29;349;1129;1133;4;0;2.0
29;350;1133;1134;1;0;2.0
29;351;1134;1135;1;0;2.0
29;352;1135;1142;7;0;2.0
29;353;1142;1143;1;0;2.0
29;354;1143;1147;4;0;2.0
29;355;1147;1149;2;0;2.0
29;356;1149;1155;6;0;2.0
29;357;1155;1158;3;0;2.0
29;358;1158;1162;4;0;2.0
29;359;1162;1163;1;0;2.0
29;360;1163;1164;1;0;2.0
29;361;1164;1172;8;0;2.0
29;362;1172;1175;3;0;2.0
29;363;1175;1178;3;0;2.0
29;364;1178;1180;2;0;2.0
29;365;1180;1182;2;0;2.0
29;366;1182;1183;1;0;2.0
29;367;1183;1184;1;0;2.0
29;368;1184;1189;5;0;2.0
29;369;1189;1198;9;0;2.0
29;370;1198;1199;1;0;2.0
29;371;1199;1203;4;0;2.0
29;372;1203;1204;1;0;2.0
29;373;1204;1205;1;0;2.0
29;374;1205;1207;2;0;2.0
29;375;1207;1212;5;0;2.0
29;376;1212;1218;6;0;2.0
29;377;1218;1227;9;0;2.0
29;378;1227;1228;1;0;2.0
29;379;1228;1229;1;0;2.0
29;380;1229;1230;1;0;2.0
29;381;1230;1234;4;0;2.0
29;382;1234;1235;1;0;2.0
29;383;1235;1238;3;0;2.0
29;384;1238;1240;2;0;2.0
29;385;1240;1252;12;0;2.0
29;386;1252;1253;1;0;2.0
29;387;1253;1254;1;0;2.0
29;388;1254;1255;1;0;2.0
29;389;1255;1263;8;0;2.0
29;390;1263;1269;6;0;2.0
29;391;1269;1274;5;0;2.0
29;392;1274;1275;1;0;2.0
29;393;1275;1277;2;0;2.0
29;394;1277;1278;1;0;2.0
29;395;1278;1279;1;0;2.0
29;396;1279;1287;8;0;2.0
29;397;1287;1288;1;0;2.0
29;398;1288;1303;15;0;2.0
29;399;1303;1304;1;0;2.0
29;400;1304;1310;6;0;2.0
29;401;1310;1312;2;0;2.0
29;402;1312;1313;1;0;2.0
29;403;1313;1314;1;0;2.0
29;404;1314;1324;10;0;2.0
29;405;1324;1332;8;0;2.0
29;406;1332;1333;1;0;2.0
29;407;1333;1337;4;0;2.0
29;408;1337;1338;1;0;2.0
29;409;1338;1344;6;0;2.0
29;410;1344;1349;5;0;2.0
29;411;1349;1353;4;0;2.0
29;412;1353;1362;9;0;2.0
29;413;1362;1365;3;0;2.0
29;414;1365;1366;1;0;2.0
29;415;1366;1368;2;0;2.0
29;416;1368;1383;15;0;2.0
29;417;1383;1387;4;0;2.0
29;418;1387;1402;15;0;2.0
29;419;1402;1417;15;0;2.0
29;420;1417;1432;15;0;2.0
29;421;1432;1447;15;0;2.0
29;422;1447;1462;15;0;2.0
29;423;1462;1477;15;0;2.0
29;424;1477;1492;15;0;2.0
29;425;1492;1507;15;0;2.0
29;426;1507;1522;15;0;2.0
29;427;1522;1537;15;0;2.0
29;428;1537;1552;15;0;2.0
29;429;1552;1567;15;0;2.0
29;430;1567;1582;15;0;2.0
29;431;1582;1597;15;0;2.0
29;432;1597;1612;15;0;2.0
29;433;1612;1627;15;0;2.0
29;434;1627;1642;15;0;2.0
29;435;1642;1657;15;0;2.0
29;436;1657;1672;15;0;2.0
29;437;1672;1680;8;0;2.0
30;0;240;328;88;0;2.0
30;1;328;333;5;0;2.0
30;2;333;340;7;0;2.0
30;3;340;341;1;0;2.0
30;4;341;344;3;0;2.0
30;5;344;347;3;0;2.0
30;6;347;348;1;0;2.0
30;7;348;349;1;0;2.0
30;8;349;350;1;0;2.0
30;9;350;352;2;0;2.0
30;10;352;353;1;0;2.0
30;11;353;355;2;0;2.0
30;12;355;356;1;0;2.0
30;13;356;358;2;0;2.0
30;14;358;363;5;0;2.0
30;15;363;367;4;0;2.0
30;16;367;369;2;0;2.0
30;17;369;370;1;0;2.0
30;18;370;371;1;0;2.0
30;19;371;374;3;0;2.0
30;20;374;377;3;0;2.0
30;21;377;378;1;0;2.0
30;22;378;381;3;0;2.0
30;23;381;382;1;0;2.0
30;24;382;383;1;0;2.0
30;25;383;386;3;0;2.0
30;26;386;387;1;0;2.0
30;27;387;390;3;0;2.0
30;28;390;391;1;0;2.0
30;29;391;396;5;0;2.0
30;30;396;397;1;0;2.0
30;31;397;399;2;0;2.0
30;32;399;401;2;0;2.0
30;33;401;402;1;0;2.0
30;34;402;406;4;0;2.0
30;35;406;407;1;0;2.0
30;36;407;408;1;0;2.0
30;37;408;410;2;0;2.0
30;38;410;411;1;0;2.0
30;39;411;413;2;0;2.0
30;40;413;414;1;0;2.0
30;41;414;416;2;0;2.0
30;42;416;417;1;0;2.0
30;43;417;418;1;0;2.0
30;44;418;421;3;0;2.0
30;45;421;422;1;0;2.0
30;46;422;426;4;0;2.0
30;47;426;427;1;0;2.0
30;48;427;428;1;0;2.0
30;49;428;430;2;0;2.0
30;50;430;431;1;0;2.0
30;51;431;434;3;0;2.0
30;52;434;436;2;0;2.0
30;53;436;437;1;0;2.0
30;54;437;441;4;0;2.0
30;55;441;442;1;0;2.0
30;56;442;443;1;0;2.0
30;57;443;444;1;0;2.0
30;58;444;446;2;0;2.0
30;59;446;447;1;0;2.0
30;60;447;450;3;0;2.0
30;61;450;451;1;0;2.0
30;62;451;456;5;0;2.0
30;63;456;457;1;0;2.0
30;64;457;458;1;0;2.0
30;65;458;459;1;0;2.0
30;66;459;461;2;0;2.0
30;67;461;462;1;0;2.0
30;68;462;466;4;0;2.0
30;69;466;467;1;0;2.0
30;70;467;468;1;0;2.0
30;71;468;470;2;0;2.0
30;72;470;471;1;0;2.0
30;73;471;473;2;0;2.0
30;74;473;474;1;0;2.0
30;75;474;476;2;0;2.0
30;76;476;477;1;0;2.0
30;77;477;478;1;0;2.0
30;78;478;481;3;0;2.0
30;79;481;482;1;0;2.0
30;80;482;486;4;0;2.0
30;81;486;487;1;0;2.0
30;82;487;490;3;0;2.0
30;83;490;491;1;0;2.0
30;84;491;494;3;0;2.0
30;85;494;496;2;0;2.0
30;86;496;497;1;0;2.0
30;87;497;498;1;0;2.0
30;88;498;502;4;0;2.0
30;89;502;504;2;0;2.0
30;90;504;506;2;0;2.0
30;91;506;507;1;0;2.0
30;92;507;510;3;0;2.0
30;93;510;516;6;0;2.0
30;94;516;517;1;0;2.0
30;95;517;518;1;0;2.0
30;96;518;522;4;0;2.0
30;97;522;523;1;0;2.0
30;98;523;526;3;0;2.0
30;99;526;527;1;0;2.0
30;100;527;530;3;0;2.0
30;101;530;531;1;0;2.0
30;102;531;533;2;0;2.0
30;103;533;541;8;0;2.0
30;104;541;542;1;0;2.0
30;105;542;546;4;0;2.0
30;106;546;547;1;0;2.0
30;107;547;550;3;0;2.0
30;108;550;558;8;0;2.0
30;109;558;561;3;0;2.0
30;110;561;562;1;0;2.0
30;111;562;566;4;0;2.0
30;112;566;567;1;0;2.0
30;113;567;570;3;0;2.0
30;114;570;571;1;0;2.0
30;115;571;577;6;0;2.0
30;116;577;581;4;0;2.0
30;117;581;582;1;0;2.0
30;118;582;586;4;0;2.0
30;119;586;587;1;0;2.0
30;120;587;590;3;0;2.0
30;121;590;593;3;0;2.0
30;122;593;598;5;0;2.0
30;123;598;601;3;0;2.0
30;124;601;602;1;0;2.0
30;125;602;606;4;0;2.0
30;126;606;607;1;0;2.0
30;127;607;610;3;0;2.0
30;128;610;611;1;0;2.0
30;129;611;621;10;0;2.0
30;130;621;622;1;0;2.0
30;131;622;626;4;0;2.0
30;132;626;627;1;0;2.0
30;133;627;630;3;0;2.0
30;134;630;631;1;0;2.0
30;135;631;637;6;0;2.0
30;136;637;641;4;0;2.0
30;137;641;642;1;0;2.0
30;138;642;646;4;0;2.0
30;139;646;647;1;0;2.0
30;140;647;650;3;0;2.0
30;141;650;653;3;0;2.0
30;142;653;658;5;0;2.0
30;143;658;661;3;0;2.0
30;144;661;662;1;0;2.0
30;145;662;666;4;0;2.0
30;146;666;667;1;0;2.0
30;147;667;670;3;0;2.0
30;148;670;671;1;0;2.0
30;149;671;681;10;0;2.0
30;150;681;682;1;0;2.0
30;151;682;686;4;0;2.0
30;152;686;687;1;0;2.0
30;153;687;690;3;0;2.0
30;154;690;691;1;0;2.0
30;155;691;697;6;0;2.0
30;156;697;701;4;0;2.0
30;157;701;702;1;0;2.0
30;158;702;706;4;0;2.0
30;159;706;707;1;0;2.0
30;160;707;710;3;0;2.0
30;161;710;713;3;0;2.0
30;162;713;718;5;0;2.0
30;163;718;721;3;0;2.0
30;164;721;722;1;0;2.0
30;165;722;726;4;0;2.0
30;166;726;727;1;0;2.0
30;167;727;730;3;0;2.0
30;168;730;731;1;0;2.0
30;169;731;741;10;0;2.0
30;170;741;742;1;0;2.0
30;171;742;746;4;0;2.0
30;172;746;747;1;0;2.0
30;173;747;750;3;0;2.0
30;174;750;751;1;0;2.0
30;175;751;757;6;0;2.0
30;176;757;761;4;0;2.0
30;177;761;762;1;0;2.0
30;178;762;766;4;0;2.0
30;179;766;767;1;0;2.0
30;180;767;770;3;0;2.0
30;181;770;773;3;0;2.0
30;182;773;778;5;0;2.0
30;183;778;781;3;0;2.0
30;184;781;782;1;0;2.0
30;185;782;786;4;0;2.0
30;186;786;787;1;0;2.0
30;187;787;790;3;0;2.0
30;188;790;791;1;0;2.0
30;189;791;797;6;0;2.0
30;190;797;801;4;0;2.0
30;191;801;802;1;0;2.0
30;192;802;806;4;0;2.0
30;193;806;807;1;0;2.0
30;194;807;810;3;0;2.0
30;195;810;813;3;0;2.0
30;196;813;817;4;0;2.0
30;197;817;818;1;0;2.0
30;198;818;821;3;0;2.0
30;199;821;822;1;0;2.0
30;200;822;826;4;0;2.0
30;201;826;827;1;0;2.0
30;202;827;830;3;0;2.0
30;203;830;833;3;0;2.0
30;204;833;834;1;0;2.0
30;205;834;837;3;0;2.0
30;206;837;838;1;0;2.0
30;207;838;841;3;0;2.0
30;208;841;842;1;0;2.0
30;209;842;846;4;0;2.0
30;210;846;847;1;0;2.0
30;211;847;848;1;0;2.0
30;212;848;850;2;0;2.0
30;213;850;851;1;0;2.0
30;214;851;854;3;0;2.0
30;215;854;857;3;0;2.0
30;216;857;860;3;0;2.0
30;217;860;861;1;0;2.0
30;218;861;862;1;0;2.0
30;219;862;866;4;0;2.0
30;220;866;867;1;0;2.0
30;221;867;870;3;0;2.0
30;222;870;871;1;0;2.0
30;223;871;873;2;0;2.0
30;224;873;874;1;0;2.0
30;225;874;876;2;0;2.0
30;226;876;877;1;0;2.0
30;227;877;881;4;0;2.0
30;228;881;882;1;0;2.0
30;229;882;886;4;0;2.0
30;230;886;887;1;0;2.0
30;231;887;890;3;0;2.0
30;232;890;891;1;0;2.0
30;233;891;892;1;0;2.0
30;234;892;893;1;0;2.0
30;235;893;894;1;0;2.0
30;236;894;896;2;0;2.0
30;237;896;897;1;0;2.0
30;238;897;898;1;0;2.0
30;239;898;901;3;0;2.0
30;240;901;902;1;0;2.0
30;241;902;906;4;0;2.0
30;242;906;907;1;0;2.0
30;243;907;908;1;0;2.0
30;244;908;910;2;0;2.0
30;245;910;911;1;0;2.0
30;246;911;914;3;0;2.0
30;247;914;916;2;0;2.0
30;248;916;917;1;0;2.0
30;249;917;921;4;0;2.0
30;250;921;922;1;0;2.0
30;251;922;926;4;0;2.0
30;252;926;927;1;0;2.0
30;253;927;930;3;0;2.0
30;254;930;931;1;0;2.0
30;255;931;933;2;0;2.0
30;256;933;934;1;0;2.0
30;257;934;936;2;0;2.0
30;258;936;937;1;0;2.0
30;259;937;941;4;0;2.0
30;260;941;942;1;0;2.0
30;261;942;946;4;0;2.0
30;262;946;947;1;0;2.0
30;263;947;950;3;0;2.0
30;264;950;951;1;0;2.0
30;265;951;952;1;0;2.0
30;266;952;953;1;0;2.0
30;267;953;954;1;0;2.0
30;268;954;956;2;0;2.0
30;269;956;957;1;0;2.0
30;270;957;958;1;0;2.0
30;271;958;961;3;0;2.0
30;272;961;962;1;0;2.0
30;273;962;966;4;0;2.0
30;274;966;967;1;0;2.0
30;275;967;968;1;0;2.0
30;276;968;970;2;0;2.0
30;277;970;971;1;0;2.0
30;278;971;974;3;0;2.0
30;279;974;976;2;0;2.0
30;280;976;977;1;0;2.0
30;281;977;981;4;0;2.0
30;282;981;982;1;0;2.0
30;283;982;986;4;0;2.0
30;284;986;987;1;0;2.0
30;285;987;990;3;0;2.0
30;286;990;991;1;0;2.0
30;287;991;994;3;0;2.0
30;288;994;996;2;0;2.0
30;289;996;997;1;0;2.0
30;290;997;1000;3;0;2.0
30;291;1000;1001;1;0;2.0
30;292;1001;1002;1;0;2.0
30;293;1002;1006;4;0;2.0
30;294;1006;1007;1;0;2.0
30;295;1007;1008;1;0;2.0
30;296;1008;1010;2;0;2.0
30;297;1010;1011;1;0;2.0
30;298;1011;1012;1;0;2.0
30;299;1012;1014;2;0;2.0
30;300;1014;1017;3;0;2.0
30;301;1017;1018;1;0;2.0
30;302;1018;1021;3;0;2.0
30;303;1021;1022;1;0;2.0
30;304;1022;1026;4;0;2.0
30;305;1026;1028;2;0;2.0
30;306;1028;1030;2;0;2.0
30;307;1030;1031;1;0;2.0
30;308;1031;1032;1;0;2.0
30;309;1032;1034;2;0;2.0
30;310;1034;1036;2;0;2.0
30;311;1036;1041;5;0;2.0
30;312;1041;1042;1;0;2.0
30;313;1042;1047;5;0;2.0
30;314;1047;1050;3;0;2.0
30;315;1050;1051;1;0;2.0
30;316;1051;1052;1;0;2.0
30;317;1052;1054;2;0;2.0
30;318;1054;1056;2;0;2.0
30;319;1056;1062;6;0;2.0
30;320;1062;1066;4;0;2.0
30;321;1066;1070;4;0;2.0
30;322;1070;1071;1;0;2.0
30;323;1071;1072;1;0;2.0
30;324;1072;1074;2;0;2.0
30;325;1074;1077;3;0;2.0
30;326;1077;1078;1;0;2.0
30;327;1078;1081;3;0;2.0
30;328;1081;1082;1;0;2.0
30;329;1082;1086;4;0;2.0
30;330;1086;1090;4;0;2.0
30;331;1090;1091;1;0;2.0
30;332;1091;1092;1;0;2.0
30;333;1092;1094;2;0;2.0
30;334;1094;1096;2;0;2.0
30;335;1096;1101;5;0;2.0
30;336;1101;1102;1;0;2.0
30;337;1102;1107;5;0;2.0
30;338;1107;1110;3;0;2.0
30;339;1110;1111;1;0;2.0
30;340;1111;1112;1;0;2.0
30;341;1112;1114;2;0;2.0
30;342;1114;1116;2;0;2.0
30;343;1116;1117;1;0;2.0
30;344;1117;1119;2;0;2.0
30;345;1119;1122;3;0;2.0
30;346;1122;1123;1;0;2.0
30;347;1123;1128;5;0;2.0
30;348;1128;1129;1;0;2.0
30;349;1129;1133;4;0;2.0
30;350;1133;1134;1;0;2.0
30;351;1134;1135;1;0;2.0
30;352;1135;1142;7;0;2.0
30;353;1142;1143;1;0;2.0
30;354;1143;1147;4;0;2.0
30;355;1147;1149;2;0;2.0
30;356;1149;1155;6;0;2.0
30;357;1155;1158;3;0;2.0
30;358;1158;1162;4;0;2.0
30;359;1162;1163;1;0;2.0
30;360;1163;1164;1;0;2.0
30;361;1164;1172;8;0;2.0
30;362;1172;1175;3;0;2.0
30;363;1175;1178;3;0;2.0
30;364;1178;1180;2;0;2.0
30;365;1180;1182;2;0;2.0
30;366;1182;1183;1;0;2.0
30;367;1183;1184;1;0;2.0
30;368;1184;1189;5;0;2.0
30;369;1189;1198;9;0;2.0
30;370;1198;1199;1;0;2.0
30;371;1199;1203;4;0;2.0
30;372;1203;1204;1;0;2.0
30;373;1204;1205;1;0;2.0
30;374;1205;1207;2;0;2.0
30;375;1207;1212;5;0;2.0
30;376;1212;1218;6;0;2.0
30;377;1218;1227;9;0;2.0
30;378;1227;1228;1;0;2.0
30;379;1228;1229;1;0;2.0
30;380;1229;1230;1;0;2.0
30;381;1230;1234;4;0;2.0
30;382;1234;1235;1;0;2.0
30;383;1235;1238;3;0;2.0
30;384;1238;1240;2;0;2.0
30;385;1240;1252;12;0;2.0
30;386;1252;1253;1;0;2.0
30;387;1253;1254;1;0;2.0
30;388;1254;1255;1;0;2.0
30;389;1255;1263;8;0;2.0
30;390;1263;1269;6;0;2.0
30;391;1269;1274;5;0;2.0
30;392;1274;1275;1;0;2.0
30;393;1275;1277;2;0;2.0
30;394;1277;1278;1;0;2.0
30;395;1278;1279;1;0;2.0
30;396;1279;1287;8;0;2.0
30;397;1287;1288;1;0;2.0
30;398;1288;1303;15;0;2.0
30;399;1303;1304;1;0;2.0
30;400;1304;1310;6;0;2.0
30;401;1310;1312;2;0;2.0
30;402;1312;1313;1;0;2.0
30;403;1313;1314;1;0;2.0
30;404;1314;1324;10;0;2.0
30;405;1324;1332;8;0;2.0
30;406;1332;1333;1;0;2.0
30;407;1333;1337;4;0;2.0
30;408;1337;1338;1;0;2.0
30;409;1338;1344;6;0;2.0
30;410;1344;1349;5;0;2.0
30;411;1349;1353;4;0;2.0
30;412;1353;1362;9;0;2.0
30;413;1362;1365;3;0;2.0
30;414;1365;1366;1;0;2.0
30;415;1366;1368;2;0;2.0
30;416;1368;1383;15;0;2.0
30;417;1383;1387;4;0;2.0
30;418;1387;1402;15;0;2.0
30;419;1402;1417;15;0;2.0
30;420;1417;1432;15;0;2.0
30;421;1432;1447;15;0;2.0
30;422;1447;1462;15;0;2.0
30;423;1462;1477;15;0;2.0
30;424;1477;1492;15;0;2.0
30;425;1492;1507;15;0;2.0
30;426;1507;1522;15;0;2.0
30;427;1522;1537;15;0;2.0
30;428;1537;1552;15;0;2.0
30;429;1552;1567;15;0;2.0
30;430;1567;1582;15;0;2.0
30;431;1582;1597;15;0;2.0
30;432;1597;1612;15;0;2.0
30;433;1612;1627;15;0;2.0
30;434;1627;1642;15;0;2.0
30;435;1642;1657;15;0;2.0
30;436;1657;1672;15;0;2.0
30;437;1672;1680;8;0;2.0
