Index Nabijacky;Index Udalosti;Cas Zaciatku;Cas Konca;CasTrvania;Miesto;Rychlost nabijania
0;0;249;328;79;112;2.0
0;1;328;331;3;112;2.0
0;2;331;332;1;112;2.0
0;3;332;333;1;112;2.0
0;4;333;335;2;112;2.0
0;5;335;336;1;112;2.0
0;6;336;337;1;112;2.0
0;7;337;341;4;112;2.0
0;8;341;343;2;112;2.0
0;9;343;346;3;112;2.0
0;10;346;347;1;112;2.0
0;11;347;351;4;112;2.0
0;12;351;352;1;112;2.0
0;13;352;355;3;112;2.0
0;14;355;357;2;112;2.0
0;15;357;358;1;112;2.0
0;16;358;361;3;112;2.0
0;17;361;362;1;112;2.0
0;18;362;363;1;112;2.0
0;19;363;366;3;112;2.0
0;20;366;367;1;112;2.0
0;21;367;370;3;112;2.0
0;22;370;371;1;112;2.0
0;23;371;373;2;112;2.0
0;24;373;376;3;112;2.0
0;25;376;378;2;112;2.0
0;26;378;383;5;112;2.0
0;27;383;387;4;112;2.0
0;28;387;388;1;112;2.0
0;29;388;391;3;112;2.0
0;30;391;392;1;112;2.0
0;31;392;393;1;112;2.0
0;32;393;396;3;112;2.0
0;33;396;398;2;112;2.0
0;34;398;402;4;112;2.0
0;35;402;406;4;112;2.0
0;36;406;407;1;112;2.0
0;37;407;410;3;112;2.0
0;38;410;411;1;112;2.0
0;39;411;413;2;112;2.0
0;40;413;420;7;112;2.0
0;41;420;421;1;112;2.0
0;42;421;423;2;112;2.0
0;43;423;424;1;112;2.0
0;44;424;426;2;112;2.0
0;45;426;427;1;112;2.0
0;46;427;428;1;112;2.0
0;47;428;431;3;112;2.0
0;48;431;433;2;112;2.0
0;49;433;436;3;112;2.0
0;50;436;437;1;112;2.0
0;51;437;446;9;112;2.0
0;52;446;448;2;112;2.0
0;53;448;450;2;112;2.0
0;54;450;451;1;112;2.0
0;55;451;452;1;112;2.0
0;56;452;453;1;112;2.0
0;57;453;455;2;112;2.0
0;58;455;456;1;112;2.0
0;59;456;465;9;112;2.0
0;60;465;466;1;112;2.0
0;61;466;467;1;112;2.0
0;62;467;471;4;112;2.0
0;63;471;475;4;112;2.0
0;64;475;476;1;112;2.0
0;65;476;478;2;112;2.0
0;66;478;481;3;112;2.0
0;67;481;482;1;112;2.0
0;68;482;483;1;112;2.0
0;69;483;484;1;112;2.0
0;70;484;486;2;112;2.0
0;71;486;488;2;112;2.0
0;72;488;496;8;112;2.0
0;73;496;498;2;112;2.0
0;74;498;501;3;112;2.0
0;75;501;505;4;112;2.0
0;76;505;506;1;112;2.0
0;77;506;507;1;112;2.0
0;78;507;515;8;112;2.0
0;79;515;518;3;112;2.0
0;80;518;521;3;112;2.0
0;81;521;528;7;112;2.0
0;82;528;529;1;112;2.0
0;83;529;531;2;112;2.0
0;84;531;538;7;112;2.0
0;85;538;539;1;112;2.0
0;86;539;543;4;112;2.0
0;87;543;545;2;112;2.0
0;88;545;547;2;112;2.0
0;89;547;551;4;112;2.0
0;90;551;552;1;112;2.0
0;91;552;553;1;112;2.0
0;92;553;555;2;112;2.0
0;93;555;574;19;112;2.0
0;94;574;577;3;112;2.0
0;95;577;586;9;112;2.0
0;96;586;587;1;112;2.0
0;97;587;590;3;112;2.0
0;98;590;591;1;112;2.0
0;99;591;593;2;112;2.0
0;100;593;595;2;112;2.0
0;101;595;598;3;112;2.0
0;102;598;619;21;112;2.0
0;103;619;620;1;112;2.0
0;104;620;626;6;112;2.0
0;105;626;627;1;112;2.0
0;106;627;628;1;112;2.0
0;107;628;633;5;112;2.0
0;108;633;635;2;112;2.0
0;109;635;636;1;112;2.0
0;110;636;653;17;112;2.0
0;111;653;657;4;112;2.0
0;112;657;658;1;112;2.0
0;113;658;661;3;112;2.0
0;114;661;671;10;112;2.0
0;115;671;675;4;112;2.0
0;116;675;685;10;112;2.0
0;117;685;694;9;112;2.0
0;118;694;696;2;112;2.0
0;119;696;697;1;112;2.0
0;120;697;703;6;112;2.0
0;121;703;706;3;112;2.0
0;122;706;713;7;112;2.0
0;123;713;718;5;112;2.0
0;124;718;720;2;112;2.0
0;125;720;721;1;112;2.0
0;126;721;726;5;112;2.0
0;127;726;727;1;112;2.0
0;128;727;731;4;112;2.0
0;129;731;739;8;112;2.0
0;130;739;740;1;112;2.0
0;131;740;743;3;112;2.0
0;132;743;752;9;112;2.0
0;133;752;753;1;112;2.0
0;134;753;763;10;112;2.0
0;135;763;765;2;112;2.0
0;136;765;766;1;112;2.0
0;137;766;771;5;112;2.0
0;138;771;777;6;112;2.0
0;139;777;778;1;112;2.0
0;140;778;780;2;112;2.0
0;141;780;786;6;112;2.0
0;142;786;791;5;112;2.0
0;143;791;794;3;112;2.0
0;144;794;796;2;112;2.0
0;145;796;799;3;112;2.0
0;146;799;801;2;112;2.0
0;147;801;802;1;112;2.0
0;148;802;804;2;112;2.0
0;149;804;806;2;112;2.0
0;150;806;807;1;112;2.0
0;151;807;811;4;112;2.0
0;152;811;816;5;112;2.0
0;153;816;818;2;112;2.0
0;154;818;821;3;112;2.0
0;155;821;822;1;112;2.0
0;156;822;823;1;112;2.0
0;157;823;826;3;112;2.0
0;158;826;827;1;112;2.0
0;159;827;831;4;112;2.0
0;160;831;834;3;112;2.0
0;161;834;835;1;112;2.0
0;162;835;836;1;112;2.0
0;163;836;838;2;112;2.0
0;164;838;839;1;112;2.0
0;165;839;841;2;112;2.0
0;166;841;846;5;112;2.0
0;167;846;851;5;112;2.0
0;168;851;854;3;112;2.0
0;169;854;857;3;112;2.0
0;170;857;859;2;112;2.0
0;171;859;861;2;112;2.0
0;172;861;862;1;112;2.0
0;173;862;866;4;112;2.0
0;174;866;868;2;112;2.0
0;175;868;870;2;112;2.0
0;176;870;871;1;112;2.0
0;177;871;881;10;112;2.0
0;178;881;882;1;112;2.0
0;179;882;883;1;112;2.0
0;180;883;886;3;112;2.0
0;181;886;887;1;112;2.0
0;182;887;889;2;112;2.0
0;183;889;890;1;112;2.0
0;184;890;891;1;112;2.0
0;185;891;897;6;112;2.0
0;186;897;898;1;112;2.0
0;187;898;903;5;112;2.0
0;188;903;904;1;112;2.0
0;189;904;905;1;112;2.0
0;190;905;906;1;112;2.0
0;191;906;909;3;112;2.0
0;192;909;911;2;112;2.0
0;193;911;913;2;112;2.0
0;194;913;914;1;112;2.0
0;195;914;916;2;112;2.0
0;196;916;918;2;112;2.0
0;197;918;919;1;112;2.0
0;198;919;921;2;112;2.0
0;199;921;925;4;112;2.0
0;200;925;927;2;112;2.0
0;201;927;928;1;112;2.0
0;202;928;929;1;112;2.0
0;203;929;930;1;112;2.0
0;204;930;933;3;112;2.0
0;205;933;938;5;112;2.0
0;206;938;940;2;112;2.0
0;207;940;941;1;112;2.0
0;208;941;942;1;112;2.0
0;209;942;943;1;112;2.0
0;210;943;946;3;112;2.0
0;211;946;949;3;112;2.0
0;212;949;957;8;112;2.0
0;213;957;960;3;112;2.0
0;214;960;961;1;112;2.0
0;215;961;963;2;112;2.0
0;216;963;964;1;112;2.0
0;217;964;968;4;112;2.0
0;218;968;969;1;112;2.0
0;219;969;971;2;112;2.0
0;220;971;973;2;112;2.0
0;221;973;974;1;112;2.0
0;222;974;976;2;112;2.0
0;223;976;977;1;112;2.0
0;224;977;979;2;112;2.0
0;225;979;980;1;112;2.0
0;226;980;981;1;112;2.0
0;227;981;983;2;112;2.0
0;228;983;984;1;112;2.0
0;229;984;995;11;112;2.0
0;230;995;1001;6;112;2.0
0;231;1001;1002;1;112;2.0
0;232;1002;1003;1;112;2.0
0;233;1003;1006;3;112;2.0
0;234;1006;1011;5;112;2.0
0;235;1011;1014;3;112;2.0
0;236;1014;1016;2;112;2.0
0;237;1016;1018;2;112;2.0
0;238;1018;1019;1;112;2.0
0;239;1019;1021;2;112;2.0
0;240;1021;1023;2;112;2.0
0;241;1023;1024;1;112;2.0
0;242;1024;1025;1;112;2.0
0;243;1025;1031;6;112;2.0
0;244;1031;1033;2;112;2.0
0;245;1033;1034;1;112;2.0
0;246;1034;1036;2;112;2.0
0;247;1036;1041;5;112;2.0
0;248;1041;1045;4;112;2.0
0;249;1045;1046;1;112;2.0
0;250;1046;1049;3;112;2.0
0;251;1049;1051;2;112;2.0
0;252;1051;1057;6;112;2.0
0;253;1057;1058;1;112;2.0
0;254;1058;1061;3;112;2.0
0;255;1061;1063;2;112;2.0
0;256;1063;1066;3;112;2.0
0;257;1066;1071;5;112;2.0
0;258;1071;1073;2;112;2.0
0;259;1073;1080;7;112;2.0
0;260;1080;1081;1;112;2.0
0;261;1081;1083;2;112;2.0
0;262;1083;1085;2;112;2.0
0;263;1085;1087;2;112;2.0
0;264;1087;1090;3;112;2.0
0;265;1090;1091;1;112;2.0
0;266;1091;1096;5;112;2.0
0;267;1096;1097;1;112;2.0
0;268;1097;1100;3;112;2.0
0;269;1100;1103;3;112;2.0
0;270;1103;1104;1;112;2.0
0;271;1104;1107;3;112;2.0
0;272;1107;1108;1;112;2.0
0;273;1108;1113;5;112;2.0
0;274;1113;1117;4;112;2.0
0;275;1117;1123;6;112;2.0
0;276;1123;1126;3;112;2.0
0;277;1126;1137;11;112;2.0
0;278;1137;1143;6;112;2.0
0;279;1143;1147;4;112;2.0
0;280;1147;1150;3;112;2.0
0;281;1150;1154;4;112;2.0
0;282;1154;1173;19;112;2.0
0;283;1173;1177;4;112;2.0
0;284;1177;1180;3;112;2.0
0;285;1180;1183;3;112;2.0
0;286;1183;1198;15;112;2.0
0;287;1198;1209;11;112;2.0
0;288;1209;1210;1;112;2.0
0;289;1210;1212;2;112;2.0
0;290;1212;1220;8;112;2.0
0;291;1220;1223;3;112;2.0
0;292;1223;1227;4;112;2.0
0;293;1227;1233;6;112;2.0
0;294;1233;1258;25;112;2.0
0;295;1258;1262;4;112;2.0
0;296;1262;1267;5;112;2.0
0;297;1267;1270;3;112;2.0
0;298;1270;1272;2;112;2.0
0;299;1272;1283;11;112;2.0
0;300;1283;1285;2;112;2.0
0;301;1285;1293;8;112;2.0
0;302;1293;1298;5;112;2.0
0;303;1298;1301;3;112;2.0
0;304;1301;1312;11;112;2.0
0;305;1312;1320;8;112;2.0
0;306;1320;1322;2;112;2.0
0;307;1322;1326;4;112;2.0
0;308;1326;1334;8;112;2.0
0;309;1334;1336;2;112;2.0
0;310;1336;1340;4;112;2.0
0;311;1340;1342;2;112;2.0
0;312;1342;1348;6;112;2.0
0;313;1348;1357;9;112;2.0
0;314;1357;1359;2;112;2.0
0;315;1359;1362;3;112;2.0
0;316;1362;1365;3;112;2.0
0;317;1365;1366;1;112;2.0
0;318;1366;1369;3;112;2.0
0;319;1369;1371;2;112;2.0
0;320;1371;1372;1;112;2.0
0;321;1372;1377;5;112;2.0
0;322;1377;1383;6;112;2.0
0;323;1383;1384;1;112;2.0
0;324;1384;1387;3;112;2.0
0;325;1387;1388;1;112;2.0
0;326;1388;1398;10;112;2.0
0;327;1398;1413;15;112;2.0
0;328;1413;1428;15;112;2.0
0;329;1428;1443;15;112;2.0
0;330;1443;1458;15;112;2.0
0;331;1458;1473;15;112;2.0
0;332;1473;1488;15;112;2.0
0;333;1488;1503;15;112;2.0
0;334;1503;1518;15;112;2.0
0;335;1518;1533;15;112;2.0
0;336;1533;1548;15;112;2.0
0;337;1548;1563;15;112;2.0
0;338;1563;1578;15;112;2.0
0;339;1578;1593;15;112;2.0
0;340;1593;1608;15;112;2.0
0;341;1608;1623;15;112;2.0
0;342;1623;1638;15;112;2.0
0;343;1638;1653;15;112;2.0
0;344;1653;1668;15;112;2.0
0;345;1668;1680;12;112;2.0
1;0;245;328;83;93;2.0
1;1;328;332;4;93;2.0
1;2;332;335;3;93;2.0
1;3;335;336;1;93;2.0
1;4;336;337;1;93;2.0
1;5;337;340;3;93;2.0
1;6;340;341;1;93;2.0
1;7;341;345;4;93;2.0
1;8;345;350;5;93;2.0
1;9;350;351;1;93;2.0
1;10;351;352;1;93;2.0
1;11;352;355;3;93;2.0
1;12;355;356;1;93;2.0
1;13;356;357;1;93;2.0
1;14;357;358;1;93;2.0
1;15;358;360;2;93;2.0
1;16;360;361;1;93;2.0
1;17;361;363;2;93;2.0
1;18;363;365;2;93;2.0
1;19;365;366;1;93;2.0
1;20;366;367;1;93;2.0
1;21;367;370;3;93;2.0
1;22;370;372;2;93;2.0
1;23;372;375;3;93;2.0
1;24;375;376;1;93;2.0
1;25;376;379;3;93;2.0
1;26;379;383;4;93;2.0
1;27;383;385;2;93;2.0
1;28;385;386;1;93;2.0
1;29;386;389;3;93;2.0
1;30;389;391;2;93;2.0
1;31;391;392;1;93;2.0
1;32;392;395;3;93;2.0
1;33;395;398;3;93;2.0
1;34;398;400;2;93;2.0
1;35;400;401;1;93;2.0
1;36;401;403;2;93;2.0
1;37;403;406;3;93;2.0
1;38;406;410;4;93;2.0
1;39;410;411;1;93;2.0
1;40;411;415;4;93;2.0
1;41;415;416;1;93;2.0
1;42;416;418;2;93;2.0
1;43;418;419;1;93;2.0
1;44;419;420;1;93;2.0
1;45;420;421;1;93;2.0
1;46;421;422;1;93;2.0
1;47;422;423;1;93;2.0
1;48;423;425;2;93;2.0
1;49;425;426;1;93;2.0
1;50;426;427;1;93;2.0
1;51;427;430;3;93;2.0
1;52;430;431;1;93;2.0
1;53;431;432;1;93;2.0
1;54;432;435;3;93;2.0
1;55;435;436;1;93;2.0
1;56;436;440;4;93;2.0
1;57;440;442;2;93;2.0
1;58;442;445;3;93;2.0
1;59;445;446;1;93;2.0
1;60;446;448;2;93;2.0
1;61;448;449;1;93;2.0
1;62;449;450;1;93;2.0
1;63;450;453;3;93;2.0
1;64;453;455;2;93;2.0
1;65;455;457;2;93;2.0
1;66;457;458;1;93;2.0
1;67;458;465;7;93;2.0
1;68;465;467;2;93;2.0
1;69;467;470;3;93;2.0
1;70;470;471;1;93;2.0
1;71;471;472;1;93;2.0
1;72;472;475;3;93;2.0
1;73;475;477;2;93;2.0
1;74;477;481;4;93;2.0
1;75;481;483;2;93;2.0
1;76;483;485;2;93;2.0
1;77;485;486;1;93;2.0
1;78;486;487;1;93;2.0
1;79;487;498;11;93;2.0
1;80;498;500;2;93;2.0
1;81;500;506;6;93;2.0
1;82;506;508;2;93;2.0
1;83;508;512;4;93;2.0
1;84;512;517;5;93;2.0
1;85;517;519;2;93;2.0
1;86;519;520;1;93;2.0
1;87;520;521;1;93;2.0
1;88;521;530;9;93;2.0
1;89;530;533;3;93;2.0
1;90;533;535;2;93;2.0
1;91;535;541;6;93;2.0
1;92;541;543;2;93;2.0
1;93;543;546;3;93;2.0
1;94;546;547;1;93;2.0
1;95;547;550;3;93;2.0
1;96;550;553;3;93;2.0
1;97;553;557;4;93;2.0
1;98;557;560;3;93;2.0
1;99;560;577;17;93;2.0
1;100;577;579;2;93;2.0
1;101;579;585;6;93;2.0
1;102;585;591;6;93;2.0
1;103;591;592;1;93;2.0
1;104;592;593;1;93;2.0
1;105;593;594;1;93;2.0
1;106;594;595;1;93;2.0
1;107;595;597;2;93;2.0
1;108;597;601;4;93;2.0
1;109;601;620;19;93;2.0
1;110;620;623;3;93;2.0
1;111;623;626;3;93;2.0
1;112;626;628;2;93;2.0
1;113;628;632;4;93;2.0
1;114;632;633;1;93;2.0
1;115;633;634;1;93;2.0
1;116;634;635;1;93;2.0
1;117;635;640;5;93;2.0
1;118;640;653;13;93;2.0
1;119;653;660;7;93;2.0
1;120;660;661;1;93;2.0
1;121;661;662;1;93;2.0
1;122;662;664;2;93;2.0
1;123;664;675;11;93;2.0
1;124;675;680;5;93;2.0
1;125;680;686;6;93;2.0
1;126;686;696;10;93;2.0
1;127;696;699;3;93;2.0
1;128;699;702;3;93;2.0
1;129;702;703;1;93;2.0
1;130;703;705;2;93;2.0
1;131;705;713;8;93;2.0
1;132;713;721;8;93;2.0
1;133;721;722;1;93;2.0
1;134;722;725;3;93;2.0
1;135;725;729;4;93;2.0
1;136;729;731;2;93;2.0
1;137;731;732;1;93;2.0
1;138;732;740;8;93;2.0
1;139;740;743;3;93;2.0
1;140;743;750;7;93;2.0
1;141;750;753;3;93;2.0
1;142;753;754;1;93;2.0
1;143;754;759;5;93;2.0
1;144;759;763;4;93;2.0
1;145;763;765;2;93;2.0
1;146;765;770;5;93;2.0
1;147;770;771;1;93;2.0
1;148;771;773;2;93;2.0
1;149;773;782;9;93;2.0
1;150;782;788;6;93;2.0
1;151;788;791;3;93;2.0
1;152;791;799;8;93;2.0
1;153;799;800;1;93;2.0
1;154;800;803;3;93;2.0
1;155;803;805;2;93;2.0
1;156;805;810;5;93;2.0
1;157;810;812;2;93;2.0
1;158;812;818;6;93;2.0
1;159;818;821;3;93;2.0
1;160;821;823;2;93;2.0
1;161;823;825;2;93;2.0
1;162;825;826;1;93;2.0
1;163;826;829;3;93;2.0
1;164;829;833;4;93;2.0
1;165;833;837;4;93;2.0
1;166;837;838;1;93;2.0
1;167;838;839;1;93;2.0
1;168;839;841;2;93;2.0
1;169;841;844;3;93;2.0
1;170;844;850;6;93;2.0
1;171;850;851;1;93;2.0
1;172;851;854;3;93;2.0
1;173;854;857;3;93;2.0
1;174;857;859;2;93;2.0
1;175;859;860;1;93;2.0
1;176;860;862;2;93;2.0
1;177;862;863;1;93;2.0
1;178;863;865;2;93;2.0
1;179;865;866;1;93;2.0
1;180;866;869;3;93;2.0
1;181;869;870;1;93;2.0
1;182;870;872;2;93;2.0
1;183;872;875;3;93;2.0
1;184;875;876;1;93;2.0
1;185;876;881;5;93;2.0
1;186;881;883;2;93;2.0
1;187;883;884;1;93;2.0
1;188;884;885;1;93;2.0
1;189;885;887;2;93;2.0
1;190;887;891;4;93;2.0
1;191;891;892;1;93;2.0
1;192;892;893;1;93;2.0
1;193;893;894;1;93;2.0
1;194;894;902;8;93;2.0
1;195;902;903;1;93;2.0
1;196;903;904;1;93;2.0
1;197;904;905;1;93;2.0
1;198;905;906;1;93;2.0
1;199;906;907;1;93;2.0
1;200;907;909;2;93;2.0
1;201;909;913;4;93;2.0
1;202;913;914;1;93;2.0
1;203;914;915;1;93;2.0
1;204;915;919;4;93;2.0
1;205;919;920;1;93;2.0
1;206;920;921;1;93;2.0
1;207;921;922;1;93;2.0
1;208;922;928;6;93;2.0
1;209;928;930;2;93;2.0
1;210;930;932;2;93;2.0
1;211;932;934;2;93;2.0
1;212;934;935;1;93;2.0
1;213;935;939;4;93;2.0
1;214;939;941;2;93;2.0
1;215;941;942;1;93;2.0
1;216;942;943;1;93;2.0
1;217;943;945;2;93;2.0
1;218;945;947;2;93;2.0
1;219;947;949;2;93;2.0
1;220;949;951;2;93;2.0
1;221;951;954;3;93;2.0
1;222;954;960;6;93;2.0
1;223;960;961;1;93;2.0
1;224;961;962;1;93;2.0
1;225;962;964;2;93;2.0
1;226;964;969;5;93;2.0
1;227;969;970;1;93;2.0
1;228;970;973;3;93;2.0
1;229;973;974;1;93;2.0
1;230;974;975;1;93;2.0
1;231;975;980;5;93;2.0
1;232;980;981;1;93;2.0
1;233;981;982;1;93;2.0
1;234;982;985;3;93;2.0
1;235;985;997;12;93;2.0
1;236;997;999;2;93;2.0
1;237;999;1000;1;93;2.0
1;238;1000;1001;1;93;2.0
1;239;1001;1002;1;93;2.0
1;240;1002;1003;1;93;2.0
1;241;1003;1007;4;93;2.0
1;242;1007;1011;4;93;2.0
1;243;1011;1018;7;93;2.0
1;244;1018;1019;1;93;2.0
1;245;1019;1020;1;93;2.0
1;246;1020;1021;1;93;2.0
1;247;1021;1024;3;93;2.0
1;248;1024;1025;1;93;2.0
1;249;1025;1029;4;93;2.0
1;250;1029;1030;1;93;2.0
1;251;1030;1033;3;93;2.0
1;252;1033;1034;1;93;2.0
1;253;1034;1037;3;93;2.0
1;254;1037;1039;2;93;2.0
1;255;1039;1047;8;93;2.0
1;256;1047;1050;3;93;2.0
1;257;1050;1051;1;93;2.0
1;258;1051;1059;8;93;2.0
1;259;1059;1061;2;93;2.0
1;260;1061;1062;1;93;2.0
1;261;1062;1069;7;93;2.0
1;262;1069;1070;1;93;2.0
1;263;1070;1071;1;93;2.0
1;264;1071;1080;9;93;2.0
1;265;1080;1081;1;93;2.0
1;266;1081;1087;6;93;2.0
1;267;1087;1090;3;93;2.0
1;268;1090;1092;2;93;2.0
1;269;1092;1093;1;93;2.0
1;270;1093;1098;5;93;2.0
1;271;1098;1101;3;93;2.0
1;272;1101;1102;1;93;2.0
1;273;1102;1105;3;93;2.0
1;274;1105;1108;3;93;2.0
1;275;1108;1114;6;93;2.0
1;276;1114;1116;2;93;2.0
1;277;1116;1118;2;93;2.0
1;278;1118;1119;1;93;2.0
1;279;1119;1128;9;93;2.0
1;280;1128;1137;9;93;2.0
1;281;1137;1141;4;93;2.0
1;282;1141;1148;7;93;2.0
1;283;1148;1149;1;93;2.0
1;284;1149;1155;6;93;2.0
1;285;1155;1156;1;93;2.0
1;286;1156;1175;19;93;2.0
1;287;1175;1177;2;93;2.0
1;288;1177;1178;1;93;2.0
1;289;1178;1181;3;93;2.0
1;290;1181;1188;7;93;2.0
1;291;1188;1204;16;93;2.0
1;292;1204;1209;5;93;2.0
1;293;1209;1210;1;93;2.0
1;294;1210;1212;2;93;2.0
1;295;1212;1223;11;93;2.0
1;296;1223;1225;2;93;2.0
1;297;1225;1228;3;93;2.0
1;298;1228;1238;10;93;2.0
1;299;1238;1254;16;93;2.0
1;300;1254;1263;9;93;2.0
1;301;1263;1266;3;93;2.0
1;302;1266;1268;2;93;2.0
1;303;1268;1269;1;93;2.0
1;304;1269;1272;3;93;2.0
1;305;1272;1275;3;93;2.0
1;306;1275;1285;10;93;2.0
1;307;1285;1286;1;93;2.0
1;308;1286;1298;12;93;2.0
1;309;1298;1303;5;93;2.0
1;310;1303;1309;6;93;2.0
1;311;1309;1310;1;93;2.0
1;312;1310;1319;9;93;2.0
1;313;1319;1325;6;93;2.0
1;314;1325;1326;1;93;2.0
1;315;1326;1328;2;93;2.0
1;316;1328;1341;13;93;2.0
1;317;1341;1342;1;93;2.0
1;318;1342;1347;5;93;2.0
1;319;1347;1349;2;93;2.0
1;320;1349;1356;7;93;2.0
1;321;1356;1364;8;93;2.0
1;322;1364;1365;1;93;2.0
1;323;1365;1367;2;93;2.0
1;324;1367;1368;1;93;2.0
1;325;1368;1370;2;93;2.0
1;326;1370;1377;7;93;2.0
1;327;1377;1383;6;93;2.0
1;328;1383;1384;1;93;2.0
1;329;1384;1390;6;93;2.0
1;330;1390;1395;5;93;2.0
1;331;1395;1399;4;93;2.0
1;332;1399;1414;15;93;2.0
1;333;1414;1429;15;93;2.0
1;334;1429;1444;15;93;2.0
1;335;1444;1459;15;93;2.0
1;336;1459;1474;15;93;2.0
1;337;1474;1489;15;93;2.0
1;338;1489;1504;15;93;2.0
1;339;1504;1519;15;93;2.0
1;340;1519;1534;15;93;2.0
1;341;1534;1549;15;93;2.0
1;342;1549;1564;15;93;2.0
1;343;1564;1579;15;93;2.0
1;344;1579;1594;15;93;2.0
1;345;1594;1609;15;93;2.0
1;346;1609;1624;15;93;2.0
1;347;1624;1639;15;93;2.0
1;348;1639;1654;15;93;2.0
1;349;1654;1669;15;93;2.0
1;350;1669;1680;11;93;2.0
2;0;246;330;84;92;2.0
2;1;330;331;1;92;2.0
2;2;331;334;3;92;2.0
2;3;334;335;1;92;2.0
2;4;335;336;1;92;2.0
2;5;336;339;3;92;2.0
2;6;339;340;1;92;2.0
2;7;340;345;5;92;2.0
2;8;345;349;4;92;2.0
2;9;349;350;1;92;2.0
2;10;350;351;1;92;2.0
2;11;351;354;3;92;2.0
2;12;354;355;1;92;2.0
2;13;355;356;1;92;2.0
2;14;356;359;3;92;2.0
2;15;359;360;1;92;2.0
2;16;360;364;4;92;2.0
2;17;364;365;1;92;2.0
2;18;365;366;1;92;2.0
2;19;366;369;3;92;2.0
2;20;369;371;2;92;2.0
2;21;371;375;4;92;2.0
2;22;375;379;4;92;2.0
2;23;379;382;3;92;2.0
2;24;382;385;3;92;2.0
2;25;385;388;3;92;2.0
2;26;388;390;2;92;2.0
2;27;390;391;1;92;2.0
2;28;391;394;3;92;2.0
2;29;394;395;1;92;2.0
2;30;395;397;2;92;2.0
2;31;397;400;3;92;2.0
2;32;400;401;1;92;2.0
2;33;401;402;1;92;2.0
2;34;402;405;3;92;2.0
2;35;405;409;4;92;2.0
2;36;409;410;1;92;2.0
2;37;410;414;4;92;2.0
2;38;414;415;1;92;2.0
2;39;415;419;4;92;2.0
2;40;419;420;1;92;2.0
2;41;420;421;1;92;2.0
2;42;421;422;1;92;2.0
2;43;422;423;1;92;2.0
2;44;423;424;1;92;2.0
2;45;424;425;1;92;2.0
2;46;425;426;1;92;2.0
2;47;426;430;4;92;2.0
2;48;430;431;1;92;2.0
2;49;431;435;4;92;2.0
2;50;435;436;1;92;2.0
2;51;436;439;3;92;2.0
2;52;439;441;2;92;2.0
2;53;441;445;4;92;2.0
2;54;445;448;3;92;2.0
2;55;448;449;1;92;2.0
2;56;449;450;1;92;2.0
2;57;450;452;2;92;2.0
2;58;452;454;2;92;2.0
2;59;454;455;1;92;2.0
2;60;455;456;1;92;2.0
2;61;456;457;1;92;2.0
2;62;457;458;1;92;2.0
2;63;458;465;7;92;2.0
2;64;465;466;1;92;2.0
2;65;466;469;3;92;2.0
2;66;469;470;1;92;2.0
2;67;470;471;1;92;2.0
2;68;471;476;5;92;2.0
2;69;476;480;4;92;2.0
2;70;480;482;2;92;2.0
2;71;482;484;2;92;2.0
2;72;484;485;1;92;2.0
2;73;485;486;1;92;2.0
2;74;486;497;11;92;2.0
2;75;497;499;2;92;2.0
2;76;499;500;1;92;2.0
2;77;500;505;5;92;2.0
2;78;505;506;1;92;2.0
2;79;506;507;1;92;2.0
2;80;507;511;4;92;2.0
2;81;511;516;5;92;2.0
2;82;516;518;2;92;2.0
2;83;518;520;2;92;2.0
2;84;520;529;9;92;2.0
2;85;529;530;1;92;2.0
2;86;530;532;2;92;2.0
2;87;532;535;3;92;2.0
2;88;535;540;5;92;2.0
2;89;540;542;2;92;2.0
2;90;542;545;3;92;2.0
2;91;545;546;1;92;2.0
2;92;546;549;3;92;2.0
2;93;549;552;3;92;2.0
2;94;552;556;4;92;2.0
2;95;556;560;4;92;2.0
2;96;560;576;16;92;2.0
2;97;576;578;2;92;2.0
2;98;578;585;7;92;2.0
2;99;585;590;5;92;2.0
2;100;590;591;1;92;2.0
2;101;591;592;1;92;2.0
2;102;592;593;1;92;2.0
2;103;593;594;1;92;2.0
2;104;594;595;1;92;2.0
2;105;595;596;1;92;2.0
2;106;596;601;5;92;2.0
2;107;601;619;18;92;2.0
2;108;619;623;4;92;2.0
2;109;623;625;2;92;2.0
2;110;625;627;2;92;2.0
2;111;627;631;4;92;2.0
2;112;631;632;1;92;2.0
2;113;632;633;1;92;2.0
2;114;633;635;2;92;2.0
2;115;635;640;5;92;2.0
2;116;640;652;12;92;2.0
2;117;652;660;8;92;2.0
2;118;660;661;1;92;2.0
2;119;661;663;2;92;2.0
2;120;663;674;11;92;2.0
2;121;674;680;6;92;2.0
2;122;680;685;5;92;2.0
2;123;685;695;10;92;2.0
2;124;695;698;3;92;2.0
2;125;698;701;3;92;2.0
2;126;701;702;1;92;2.0
2;127;702;705;3;92;2.0
2;128;705;712;7;92;2.0
2;129;712;721;9;92;2.0
2;130;721;724;3;92;2.0
2;131;724;725;1;92;2.0
2;132;725;728;3;92;2.0
2;133;728;730;2;92;2.0
2;134;730;731;1;92;2.0
2;135;731;739;8;92;2.0
2;136;739;743;4;92;2.0
2;137;743;750;7;92;2.0
2;138;750;752;2;92;2.0
2;139;752;753;1;92;2.0
2;140;753;758;5;92;2.0
2;141;758;762;4;92;2.0
2;142;762;765;3;92;2.0
2;143;765;769;4;92;2.0
2;144;769;770;1;92;2.0
2;145;770;772;2;92;2.0
2;146;772;781;9;92;2.0
2;147;781;787;6;92;2.0
2;148;787;790;3;92;2.0
2;149;790;798;8;92;2.0
2;150;798;799;1;92;2.0
2;151;799;800;1;92;2.0
2;152;800;802;2;92;2.0
2;153;802;804;2;92;2.0
2;154;804;805;1;92;2.0
2;155;805;809;4;92;2.0
2;156;809;811;2;92;2.0
2;157;811;817;6;92;2.0
2;158;817;820;3;92;2.0
2;159;820;822;2;92;2.0
2;160;822;825;3;92;2.0
2;161;825;826;1;92;2.0
2;162;826;828;2;92;2.0
2;163;828;832;4;92;2.0
2;164;832;836;4;92;2.0
2;165;836;838;2;92;2.0
2;166;838;840;2;92;2.0
2;167;840;843;3;92;2.0
2;168;843;850;7;92;2.0
2;169;850;853;3;92;2.0
2;170;853;856;3;92;2.0
2;171;856;858;2;92;2.0
2;172;858;859;1;92;2.0
2;173;859;861;2;92;2.0
2;174;861;862;1;92;2.0
2;175;862;864;2;92;2.0
2;176;864;865;1;92;2.0
2;177;865;868;3;92;2.0
2;178;868;870;2;92;2.0
2;179;870;871;1;92;2.0
2;180;871;874;3;92;2.0
2;181;874;875;1;92;2.0
2;182;875;876;1;92;2.0
2;183;876;881;5;92;2.0
2;184;881;882;1;92;2.0
2;185;882;883;1;92;2.0
2;186;883;885;2;92;2.0
2;187;885;886;1;92;2.0
2;188;886;890;4;92;2.0
2;189;890;891;1;92;2.0
2;190;891;892;1;92;2.0
2;191;892;893;1;92;2.0
2;192;893;901;8;92;2.0
2;193;901;903;2;92;2.0
2;194;903;905;2;92;2.0
2;195;905;906;1;92;2.0
2;196;906;908;2;92;2.0
2;197;908;912;4;92;2.0
2;198;912;913;1;92;2.0
2;199;913;914;1;92;2.0
2;200;914;918;4;92;2.0
2;201;918;919;1;92;2.0
2;202;919;920;1;92;2.0
2;203;920;921;1;92;2.0
2;204;921;928;7;92;2.0
2;205;928;929;1;92;2.0
2;206;929;931;2;92;2.0
2;207;931;933;2;92;2.0
2;208;933;935;2;92;2.0
2;209;935;938;3;92;2.0
2;210;938;940;2;92;2.0
2;211;940;941;1;92;2.0
2;212;941;942;1;92;2.0
2;213;942;945;3;92;2.0
2;214;945;946;1;92;2.0
2;215;946;948;2;92;2.0
2;216;948;951;3;92;2.0
2;217;951;953;2;92;2.0
2;218;953;960;7;92;2.0
2;219;960;961;1;92;2.0
2;220;961;963;2;92;2.0
2;221;963;968;5;92;2.0
2;222;968;969;1;92;2.0
2;223;969;972;3;92;2.0
2;224;972;973;1;92;2.0
2;225;973;974;1;92;2.0
2;226;974;979;5;92;2.0
2;227;979;980;1;92;2.0
2;228;980;981;1;92;2.0
2;229;981;984;3;92;2.0
2;230;984;996;12;92;2.0
2;231;996;998;2;92;2.0
2;232;998;1000;2;92;2.0
2;233;1000;1001;1;92;2.0
2;234;1001;1002;1;92;2.0
2;235;1002;1004;2;92;2.0
2;236;1004;1006;2;92;2.0
2;237;1006;1011;5;92;2.0
2;238;1011;1017;6;92;2.0
2;239;1017;1018;1;92;2.0
2;240;1018;1019;1;92;2.0
2;241;1019;1020;1;92;2.0
2;242;1020;1023;3;92;2.0
2;243;1023;1024;1;92;2.0
2;244;1024;1025;1;92;2.0
2;245;1025;1028;3;92;2.0
2;246;1028;1029;1;92;2.0
2;247;1029;1030;1;92;2.0
2;248;1030;1033;3;92;2.0
2;249;1033;1034;1;92;2.0
2;250;1034;1036;2;92;2.0
2;251;1036;1038;2;92;2.0
2;252;1038;1046;8;92;2.0
2;253;1046;1049;3;92;2.0
2;254;1049;1050;1;92;2.0
2;255;1050;1058;8;92;2.0
2;256;1058;1060;2;92;2.0
2;257;1060;1061;1;92;2.0
2;258;1061;1062;1;92;2.0
2;259;1062;1068;6;92;2.0
2;260;1068;1070;2;92;2.0
2;261;1070;1071;1;92;2.0
2;262;1071;1080;9;92;2.0
2;263;1080;1081;1;92;2.0
2;264;1081;1086;5;92;2.0
2;265;1086;1090;4;92;2.0
2;266;1090;1092;2;92;2.0
2;267;1092;1093;1;92;2.0
2;268;1093;1097;4;92;2.0
2;269;1097;1100;3;92;2.0
2;270;1100;1101;1;92;2.0
2;271;1101;1104;3;92;2.0
2;272;1104;1107;3;92;2.0
2;273;1107;1113;6;92;2.0
2;274;1113;1116;3;92;2.0
2;275;1116;1118;2;92;2.0
2;276;1118;1127;9;92;2.0
2;277;1127;1136;9;92;2.0
2;278;1136;1140;4;92;2.0
2;279;1140;1147;7;92;2.0
2;280;1147;1148;1;92;2.0
2;281;1148;1149;1;92;2.0
2;282;1149;1154;5;92;2.0
2;283;1154;1155;1;92;2.0
2;284;1155;1174;19;92;2.0
2;285;1174;1176;2;92;2.0
2;286;1176;1178;2;92;2.0
2;287;1178;1180;2;92;2.0
2;288;1180;1187;7;92;2.0
2;289;1187;1203;16;92;2.0
2;290;1203;1209;6;92;2.0
2;291;1209;1211;2;92;2.0
2;292;1211;1223;12;92;2.0
2;293;1223;1224;1;92;2.0
2;294;1224;1227;3;92;2.0
2;295;1227;1238;11;92;2.0
2;296;1238;1256;18;92;2.0
2;297;1256;1262;6;92;2.0
2;298;1262;1265;3;92;2.0
2;299;1265;1267;2;92;2.0
2;300;1267;1269;2;92;2.0
2;301;1269;1271;2;92;2.0
2;302;1271;1275;4;92;2.0
2;303;1275;1284;9;92;2.0
2;304;1284;1285;1;92;2.0
2;305;1285;1298;13;92;2.0
2;306;1298;1302;4;92;2.0
2;307;1302;1309;7;92;2.0
2;308;1309;1310;1;92;2.0
2;309;1310;1319;9;92;2.0
2;310;1319;1324;5;92;2.0
2;311;1324;1325;1;92;2.0
2;312;1325;1330;5;92;2.0
2;313;1330;1341;11;92;2.0
2;314;1341;1347;6;92;2.0
2;315;1347;1348;1;92;2.0
2;316;1348;1356;8;92;2.0
2;317;1356;1364;8;92;2.0
2;318;1364;1365;1;92;2.0
2;319;1365;1366;1;92;2.0
2;320;1366;1368;2;92;2.0
2;321;1368;1369;1;92;2.0
2;322;1369;1376;7;92;2.0
2;323;1376;1383;7;92;2.0
2;324;1383;1389;6;92;2.0
2;325;1389;1395;6;92;2.0
2;326;1395;1398;3;92;2.0
2;327;1398;1413;15;92;2.0
2;328;1413;1428;15;92;2.0
2;329;1428;1443;15;92;2.0
2;330;1443;1458;15;92;2.0
2;331;1458;1473;15;92;2.0
2;332;1473;1488;15;92;2.0
2;333;1488;1503;15;92;2.0
2;334;1503;1518;15;92;2.0
2;335;1518;1533;15;92;2.0
2;336;1533;1548;15;92;2.0
2;337;1548;1563;15;92;2.0
2;338;1563;1578;15;92;2.0
2;339;1578;1593;15;92;2.0
2;340;1593;1608;15;92;2.0
2;341;1608;1623;15;92;2.0
2;342;1623;1638;15;92;2.0
2;343;1638;1653;15;92;2.0
2;344;1653;1668;15;92;2.0
2;345;1668;1680;12;92;2.0
3;0;248;327;79;77;2.0
3;1;327;332;5;77;2.0
3;2;332;333;1;77;2.0
3;3;333;335;2;77;2.0
3;4;335;336;1;77;2.0
3;5;336;338;2;77;2.0
3;6;338;340;2;77;2.0
3;7;340;343;3;77;2.0
3;8;343;346;3;77;2.0
3;9;346;347;1;77;2.0
3;10;347;350;3;77;2.0
3;11;350;351;1;77;2.0
3;12;351;356;5;77;2.0
3;13;356;358;2;77;2.0
3;14;358;362;4;77;2.0
3;15;362;363;1;77;2.0
3;16;363;365;2;77;2.0
3;17;365;366;1;77;2.0
3;18;366;368;2;77;2.0
3;19;368;371;3;77;2.0
3;20;371;375;4;77;2.0
3;21;375;378;3;77;2.0
3;22;378;385;7;77;2.0
3;23;385;386;1;77;2.0
3;24;386;388;2;77;2.0
3;25;388;391;3;77;2.0
3;26;391;392;1;77;2.0
3;27;392;397;5;77;2.0
3;28;397;398;1;77;2.0
3;29;398;400;2;77;2.0
3;30;400;401;1;77;2.0
3;31;401;402;1;77;2.0
3;32;402;406;4;77;2.0
3;33;406;407;1;77;2.0
3;34;407;410;3;77;2.0
3;35;410;413;3;77;2.0
3;36;413;414;1;77;2.0
3;37;414;416;2;77;2.0
3;38;416;418;2;77;2.0
3;39;418;420;2;77;2.0
3;40;420;421;1;77;2.0
3;41;421;422;1;77;2.0
3;42;422;423;1;77;2.0
3;43;423;424;1;77;2.0
3;44;424;426;2;77;2.0
3;45;426;428;2;77;2.0
3;46;428;431;3;77;2.0
3;47;431;433;2;77;2.0
3;48;433;435;2;77;2.0
3;49;435;437;2;77;2.0
3;50;437;441;4;77;2.0
3;51;441;445;4;77;2.0
3;52;445;448;3;77;2.0
3;53;448;451;3;77;2.0
3;54;451;452;1;77;2.0
3;55;452;453;1;77;2.0
3;56;453;455;2;77;2.0
3;57;455;456;1;77;2.0
3;58;456;458;2;77;2.0
3;59;458;460;2;77;2.0
3;60;460;466;6;77;2.0
3;61;466;467;1;77;2.0
3;62;467;468;1;77;2.0
3;63;468;471;3;77;2.0
3;64;471;476;5;77;2.0
3;65;476;478;2;77;2.0
3;66;478;480;2;77;2.0
3;67;480;481;1;77;2.0
3;68;481;482;1;77;2.0
3;69;482;483;1;77;2.0
3;70;483;485;2;77;2.0
3;71;485;486;1;77;2.0
3;72;486;497;11;77;2.0
3;73;497;503;6;77;2.0
3;74;503;505;2;77;2.0
3;75;505;507;2;77;2.0
3;76;507;511;4;77;2.0
3;77;511;516;5;77;2.0
3;78;516;518;2;77;2.0
3;79;518;520;2;77;2.0
3;80;520;529;9;77;2.0
3;81;529;532;3;77;2.0
3;82;532;533;1;77;2.0
3;83;533;535;2;77;2.0
3;84;535;538;3;77;2.0
3;85;538;540;2;77;2.0
3;86;540;546;6;77;2.0
3;87;546;548;2;77;2.0
3;88;548;549;1;77;2.0
3;89;549;552;3;77;2.0
3;90;552;556;4;77;2.0
3;91;556;560;4;77;2.0
3;92;560;572;12;77;2.0
3;93;572;578;6;77;2.0
3;94;578;586;8;77;2.0
3;95;586;588;2;77;2.0
3;96;588;590;2;77;2.0
3;97;590;591;1;77;2.0
3;98;591;592;1;77;2.0
3;99;592;595;3;77;2.0
3;100;595;596;1;77;2.0
3;101;596;600;4;77;2.0
3;102;600;619;19;77;2.0
3;103;619;621;2;77;2.0
3;104;621;623;2;77;2.0
3;105;623;625;2;77;2.0
3;106;625;628;3;77;2.0
3;107;628;629;1;77;2.0
3;108;629;631;2;77;2.0
3;109;631;633;2;77;2.0
3;110;633;638;5;77;2.0
3;111;638;640;2;77;2.0
3;112;640;652;12;77;2.0
3;113;652;656;4;77;2.0
3;114;656;660;4;77;2.0
3;115;660;661;1;77;2.0
3;116;661;672;11;77;2.0
3;117;672;680;8;77;2.0
3;118;680;685;5;77;2.0
3;119;685;691;6;77;2.0
3;120;691;698;7;77;2.0
3;121;698;701;3;77;2.0
3;122;701;708;7;77;2.0
3;123;708;712;4;77;2.0
3;124;712;720;8;77;2.0
3;125;720;721;1;77;2.0
3;126;721;722;1;77;2.0
3;127;722;725;3;77;2.0
3;128;725;726;1;77;2.0
3;129;726;731;5;77;2.0
3;130;731;739;8;77;2.0
3;131;739;745;6;77;2.0
3;132;745;750;5;77;2.0
3;133;750;752;2;77;2.0
3;134;752;753;1;77;2.0
3;135;753;758;5;77;2.0
3;136;758;761;3;77;2.0
3;137;761;766;5;77;2.0
3;138;766;767;1;77;2.0
3;139;767;768;1;77;2.0
3;140;768;770;2;77;2.0
3;141;770;772;2;77;2.0
3;142;772;781;9;77;2.0
3;143;781;786;5;77;2.0
3;144;786;787;1;77;2.0
3;145;787;795;8;77;2.0
3;146;795;798;3;77;2.0
3;147;798;799;1;77;2.0
3;148;799;802;3;77;2.0
3;149;802;803;1;77;2.0
3;150;803;804;1;77;2.0
3;151;804;807;3;77;2.0
3;152;807;808;1;77;2.0
3;153;808;811;3;77;2.0
3;154;811;816;5;77;2.0
3;155;816;817;1;77;2.0
3;156;817;818;1;77;2.0
3;157;818;822;4;77;2.0
3;158;822;825;3;77;2.0
3;159;825;827;2;77;2.0
3;160;827;828;1;77;2.0
3;161;828;831;3;77;2.0
3;162;831;832;1;77;2.0
3;163;832;836;4;77;2.0
3;164;836;837;1;77;2.0
3;165;837;838;1;77;2.0
3;166;838;843;5;77;2.0
3;167;843;846;3;77;2.0
3;168;846;850;4;77;2.0
3;169;850;852;2;77;2.0
3;170;852;853;1;77;2.0
3;171;853;858;5;77;2.0
3;172;858;859;1;77;2.0
3;173;859;861;2;77;2.0
3;174;861;862;1;77;2.0
3;175;862;865;3;77;2.0
3;176;865;871;6;77;2.0
3;177;871;872;1;77;2.0
3;178;872;873;1;77;2.0
3;179;873;875;2;77;2.0
3;180;875;878;3;77;2.0
3;181;878;880;2;77;2.0
3;182;880;881;1;77;2.0
3;183;881;884;3;77;2.0
3;184;884;886;2;77;2.0
3;185;886;888;2;77;2.0
3;186;888;890;2;77;2.0
3;187;890;891;1;77;2.0
3;188;891;892;1;77;2.0
3;189;892;893;1;77;2.0
3;190;893;901;8;77;2.0
3;191;901;903;2;77;2.0
3;192;903;906;3;77;2.0
3;193;906;908;2;77;2.0
3;194;908;910;2;77;2.0
3;195;910;911;1;77;2.0
3;196;911;913;2;77;2.0
3;197;913;914;1;77;2.0
3;198;914;916;2;77;2.0
3;199;916;918;2;77;2.0
3;200;918;919;1;77;2.0
3;201;919;923;4;77;2.0
3;202;923;929;6;77;2.0
3;203;929;930;1;77;2.0
3;204;930;931;1;77;2.0
3;205;931;933;2;77;2.0
3;206;933;935;2;77;2.0
3;207;935;936;1;77;2.0
3;208;936;938;2;77;2.0
3;209;938;939;1;77;2.0
3;210;939;941;2;77;2.0
3;211;941;945;4;77;2.0
3;212;945;946;1;77;2.0
3;213;946;948;2;77;2.0
3;214;948;950;2;77;2.0
3;215;950;953;3;77;2.0
3;216;953;956;3;77;2.0
3;217;956;961;5;77;2.0
3;218;961;963;2;77;2.0
3;219;963;968;5;77;2.0
3;220;968;969;1;77;2.0
3;221;969;970;1;77;2.0
3;222;970;971;1;77;2.0
3;223;971;973;2;77;2.0
3;224;973;974;1;77;2.0
3;225;974;976;2;77;2.0
3;226;976;979;3;77;2.0
3;227;979;981;2;77;2.0
3;228;981;983;2;77;2.0
3;229;983;984;1;77;2.0
3;230;984;996;12;77;2.0
3;231;996;998;2;77;2.0
3;232;998;1001;3;77;2.0
3;233;1001;1002;1;77;2.0
3;234;1002;1003;1;77;2.0
3;235;1003;1004;1;77;2.0
3;236;1004;1006;2;77;2.0
3;237;1006;1008;2;77;2.0
3;238;1008;1010;2;77;2.0
3;239;1010;1016;6;77;2.0
3;240;1016;1017;1;77;2.0
3;241;1017;1018;1;77;2.0
3;242;1018;1019;1;77;2.0
3;243;1019;1023;4;77;2.0
3;244;1023;1024;1;77;2.0
3;245;1024;1025;1;77;2.0
3;246;1025;1029;4;77;2.0
3;247;1029;1030;1;77;2.0
3;248;1030;1031;1;77;2.0
3;249;1031;1033;2;77;2.0
3;250;1033;1034;1;77;2.0
3;251;1034;1038;4;77;2.0
3;252;1038;1046;8;77;2.0
3;253;1046;1049;3;77;2.0
3;254;1049;1050;1;77;2.0
3;255;1050;1053;3;77;2.0
3;256;1053;1056;3;77;2.0
3;257;1056;1059;3;77;2.0
3;258;1059;1061;2;77;2.0
3;259;1061;1062;1;77;2.0
3;260;1062;1065;3;77;2.0
3;261;1065;1070;5;77;2.0
3;262;1070;1073;3;77;2.0
3;263;1073;1076;3;77;2.0
3;264;1076;1080;4;77;2.0
3;265;1080;1083;3;77;2.0
3;266;1083;1084;1;77;2.0
3;267;1084;1086;2;77;2.0
3;268;1086;1092;6;77;2.0
3;269;1092;1093;1;77;2.0
3;270;1093;1095;2;77;2.0
3;271;1095;1097;2;77;2.0
3;272;1097;1100;3;77;2.0
3;273;1100;1101;1;77;2.0
3;274;1101;1104;3;77;2.0
3;275;1104;1107;3;77;2.0
3;276;1107;1110;3;77;2.0
3;277;1110;1116;6;77;2.0
3;278;1116;1118;2;77;2.0
3;279;1118;1121;3;77;2.0
3;280;1121;1127;6;77;2.0
3;281;1127;1132;5;77;2.0
3;282;1132;1138;6;77;2.0
3;283;1138;1147;9;77;2.0
3;284;1147;1148;1;77;2.0
3;285;1148;1152;4;77;2.0
3;286;1152;1154;2;77;2.0
3;287;1154;1155;1;77;2.0
3;288;1155;1172;17;77;2.0
3;289;1172;1174;2;77;2.0
3;290;1174;1178;4;77;2.0
3;291;1178;1180;2;77;2.0
3;292;1180;1187;7;77;2.0
3;293;1187;1200;13;77;2.0
3;294;1200;1207;7;77;2.0
3;295;1207;1209;2;77;2.0
3;296;1209;1212;3;77;2.0
3;297;1212;1224;12;77;2.0
3;298;1224;1225;1;77;2.0
3;299;1225;1227;2;77;2.0
3;300;1227;1238;11;77;2.0
3;301;1238;1259;21;77;2.0
3;302;1259;1262;3;77;2.0
3;303;1262;1263;1;77;2.0
3;304;1263;1267;4;77;2.0
3;305;1267;1272;5;77;2.0
3;306;1272;1274;2;77;2.0
3;307;1274;1284;10;77;2.0
3;308;1284;1285;1;77;2.0
3;309;1285;1298;13;77;2.0
3;310;1298;1302;4;77;2.0
3;311;1302;1308;6;77;2.0
3;312;1308;1312;4;77;2.0
3;313;1312;1321;9;77;2.0
3;314;1321;1322;1;77;2.0
3;315;1322;1323;1;77;2.0
3;316;1323;1333;10;77;2.0
3;317;1333;1341;8;77;2.0
3;318;1341;1346;5;77;2.0
3;319;1346;1348;2;77;2.0
3;320;1348;1356;8;77;2.0
3;321;1356;1364;8;77;2.0
3;322;1364;1365;1;77;2.0
3;323;1365;1366;1;77;2.0
3;324;1366;1369;3;77;2.0
3;325;1369;1370;1;77;2.0
3;326;1370;1372;2;77;2.0
3;327;1372;1383;11;77;2.0
3;328;1383;1386;3;77;2.0
3;329;1386;1389;3;77;2.0
3;330;1389;1394;5;77;2.0
3;331;1394;1398;4;77;2.0
3;332;1398;1413;15;77;2.0
3;333;1413;1428;15;77;2.0
3;334;1428;1443;15;77;2.0
3;335;1443;1458;15;77;2.0
3;336;1458;1473;15;77;2.0
3;337;1473;1488;15;77;2.0
3;338;1488;1503;15;77;2.0
3;339;1503;1518;15;77;2.0
3;340;1518;1533;15;77;2.0
3;341;1533;1548;15;77;2.0
3;342;1548;1563;15;77;2.0
3;343;1563;1578;15;77;2.0
3;344;1578;1593;15;77;2.0
3;345;1593;1608;15;77;2.0
3;346;1608;1623;15;77;2.0
3;347;1623;1638;15;77;2.0
3;348;1638;1653;15;77;2.0
3;349;1653;1668;15;77;2.0
3;350;1668;1680;12;77;2.0
4;0;245;331;86;119;2.0
4;1;331;333;2;119;2.0
4;2;333;336;3;119;2.0
4;3;336;337;1;119;2.0
4;4;337;338;1;119;2.0
4;5;338;340;2;119;2.0
4;6;340;344;4;119;2.0
4;7;344;348;4;119;2.0
4;8;348;349;1;119;2.0
4;9;349;350;1;119;2.0
4;10;350;352;2;119;2.0
4;11;352;354;2;119;2.0
4;12;354;357;3;119;2.0
4;13;357;360;3;119;2.0
4;14;360;361;1;119;2.0
4;15;361;363;2;119;2.0
4;16;363;364;1;119;2.0
4;17;364;367;3;119;2.0
4;18;367;369;2;119;2.0
4;19;369;373;4;119;2.0
4;20;373;375;2;119;2.0
4;21;375;377;2;119;2.0
4;22;377;382;5;119;2.0
4;23;382;383;1;119;2.0
4;24;383;386;3;119;2.0
4;25;386;387;1;119;2.0
4;26;387;389;2;119;2.0
4;27;389;390;1;119;2.0
4;28;390;392;2;119;2.0
4;29;392;393;1;119;2.0
4;30;393;395;2;119;2.0
4;31;395;398;3;119;2.0
4;32;398;399;1;119;2.0
4;33;399;400;1;119;2.0
4;34;400;405;5;119;2.0
4;35;405;407;2;119;2.0
4;36;407;408;1;119;2.0
4;37;408;410;2;119;2.0
4;38;410;412;2;119;2.0
4;39;412;417;5;119;2.0
4;40;417;418;1;119;2.0
4;41;418;419;1;119;2.0
4;42;419;420;1;119;2.0
4;43;420;421;1;119;2.0
4;44;421;422;1;119;2.0
4;45;422;423;1;119;2.0
4;46;423;424;1;119;2.0
4;47;424;427;3;119;2.0
4;48;427;429;2;119;2.0
4;49;429;430;1;119;2.0
4;50;430;433;3;119;2.0
4;51;433;434;1;119;2.0
4;52;434;438;4;119;2.0
4;53;438;439;1;119;2.0
4;54;439;445;6;119;2.0
4;55;445;446;1;119;2.0
4;56;446;447;1;119;2.0
4;57;447;449;2;119;2.0
4;58;449;451;2;119;2.0
4;59;451;452;1;119;2.0
4;60;452;453;1;119;2.0
4;61;453;454;1;119;2.0
4;62;454;455;1;119;2.0
4;63;455;458;3;119;2.0
4;64;458;459;1;119;2.0
4;65;459;464;5;119;2.0
4;66;464;465;1;119;2.0
4;67;465;467;2;119;2.0
4;68;467;468;1;119;2.0
4;69;468;469;1;119;2.0
4;70;469;470;1;119;2.0
4;71;470;474;4;119;2.0
4;72;474;477;3;119;2.0
4;73;477;480;3;119;2.0
4;74;480;482;2;119;2.0
4;75;482;483;1;119;2.0
4;76;483;484;1;119;2.0
4;77;484;485;1;119;2.0
4;78;485;495;10;119;2.0
4;79;495;498;3;119;2.0
4;80;498;500;2;119;2.0
4;81;500;503;3;119;2.0
4;82;503;504;1;119;2.0
4;83;504;505;1;119;2.0
4;84;505;509;4;119;2.0
4;85;509;514;5;119;2.0
4;86;514;516;2;119;2.0
4;87;516;518;2;119;2.0
4;88;518;520;2;119;2.0
4;89;520;527;7;119;2.0
4;90;527;530;3;119;2.0
4;91;530;532;2;119;2.0
4;92;532;533;1;119;2.0
4;93;533;538;5;119;2.0
4;94;538;542;4;119;2.0
4;95;542;544;2;119;2.0
4;96;544;547;3;119;2.0
4;97;547;550;3;119;2.0
4;98;550;554;4;119;2.0
4;99;554;558;4;119;2.0
4;100;558;576;18;119;2.0
4;101;576;585;9;119;2.0
4;102;585;589;4;119;2.0
4;103;589;590;1;119;2.0
4;104;590;591;1;119;2.0
4;105;591;592;1;119;2.0
4;106;592;593;1;119;2.0
4;107;593;594;1;119;2.0
4;108;594;599;5;119;2.0
4;109;599;617;18;119;2.0
4;110;617;623;6;119;2.0
4;111;623;625;2;119;2.0
4;112;625;627;2;119;2.0
4;113;627;629;2;119;2.0
4;114;629;630;1;119;2.0
4;115;630;631;1;119;2.0
4;116;631;635;4;119;2.0
4;117;635;638;3;119;2.0
4;118;638;652;14;119;2.0
4;119;652;658;6;119;2.0
4;120;658;659;1;119;2.0
4;121;659;660;1;119;2.0
4;122;660;661;1;119;2.0
4;123;661;673;12;119;2.0
4;124;673;678;5;119;2.0
4;125;678;683;5;119;2.0
4;126;683;695;12;119;2.0
4;127;695;696;1;119;2.0
4;128;696;699;3;119;2.0
4;129;699;702;3;119;2.0
4;130;702;705;3;119;2.0
4;131;705;712;7;119;2.0
4;132;712;719;7;119;2.0
4;133;719;723;4;119;2.0
4;134;723;726;3;119;2.0
4;135;726;729;3;119;2.0
4;136;729;730;1;119;2.0
4;137;730;737;7;119;2.0
4;138;737;743;6;119;2.0
4;139;743;748;5;119;2.0
4;140;748;750;2;119;2.0
4;141;750;751;1;119;2.0
4;142;751;760;9;119;2.0
4;143;760;762;2;119;2.0
4;144;762;765;3;119;2.0
4;145;765;768;3;119;2.0
4;146;768;770;2;119;2.0
4;147;770;772;2;119;2.0
4;148;772;779;7;119;2.0
4;149;779;785;6;119;2.0
4;150;785;790;5;119;2.0
4;151;790;796;6;119;2.0
4;152;796;797;1;119;2.0
4;153;797;800;3;119;2.0
4;154;800;802;2;119;2.0
4;155;802;806;4;119;2.0
4;156;806;808;2;119;2.0
4;157;808;809;1;119;2.0
4;158;809;815;6;119;2.0
4;159;815;820;5;119;2.0
4;160;820;822;2;119;2.0
4;161;822;823;1;119;2.0
4;162;823;824;1;119;2.0
4;163;824;825;1;119;2.0
4;164;825;830;5;119;2.0
4;165;830;832;2;119;2.0
4;166;832;834;2;119;2.0
4;167;834;836;2;119;2.0
4;168;836;838;2;119;2.0
4;169;838;840;2;119;2.0
4;170;840;841;1;119;2.0
4;171;841;850;9;119;2.0
4;172;850;851;1;119;2.0
4;173;851;856;5;119;2.0
4;174;856;857;1;119;2.0
4;175;857;859;2;119;2.0
4;176;859;860;1;119;2.0
4;177;860;863;3;119;2.0
4;178;863;865;2;119;2.0
4;179;865;866;1;119;2.0
4;180;866;869;3;119;2.0
4;181;869;870;1;119;2.0
4;182;870;873;3;119;2.0
4;183;873;874;1;119;2.0
4;184;874;877;3;119;2.0
4;185;877;879;2;119;2.0
4;186;879;881;2;119;2.0
4;187;881;882;1;119;2.0
4;188;882;885;3;119;2.0
4;189;885;889;4;119;2.0
4;190;889;890;1;119;2.0
4;191;890;891;1;119;2.0
4;192;891;892;1;119;2.0
4;193;892;899;7;119;2.0
4;194;899;901;2;119;2.0
4;195;901;904;3;119;2.0
4;196;904;905;1;119;2.0
4;197;905;906;1;119;2.0
4;198;906;910;4;119;2.0
4;199;910;911;1;119;2.0
4;200;911;912;1;119;2.0
4;201;912;916;4;119;2.0
4;202;916;917;1;119;2.0
4;203;917;920;3;119;2.0
4;204;920;927;7;119;2.0
4;205;927;928;1;119;2.0
4;206;928;929;1;119;2.0
4;207;929;931;2;119;2.0
4;208;931;933;2;119;2.0
4;209;933;939;6;119;2.0
4;210;939;940;1;119;2.0
4;211;940;942;2;119;2.0
4;212;942;944;2;119;2.0
4;213;944;945;1;119;2.0
4;214;945;946;1;119;2.0
4;215;946;949;3;119;2.0
4;216;949;951;2;119;2.0
4;217;951;959;8;119;2.0
4;218;959;960;1;119;2.0
4;219;960;961;1;119;2.0
4;220;961;966;5;119;2.0
4;221;966;967;1;119;2.0
4;222;967;970;3;119;2.0
4;223;970;971;1;119;2.0
4;224;971;972;1;119;2.0
4;225;972;977;5;119;2.0
4;226;977;979;2;119;2.0
4;227;979;980;1;119;2.0
4;228;980;982;2;119;2.0
4;229;982;994;12;119;2.0
4;230;994;999;5;119;2.0
4;231;999;1000;1;119;2.0
4;232;1000;1001;1;119;2.0
4;233;1001;1002;1;119;2.0
4;234;1002;1004;2;119;2.0
4;235;1004;1005;1;119;2.0
4;236;1005;1009;4;119;2.0
4;237;1009;1015;6;119;2.0
4;238;1015;1016;1;119;2.0
4;239;1016;1017;1;119;2.0
4;240;1017;1020;3;119;2.0
4;241;1020;1021;1;119;2.0
4;242;1021;1022;1;119;2.0
4;243;1022;1023;1;119;2.0
4;244;1023;1027;4;119;2.0
4;245;1027;1030;3;119;2.0
4;246;1030;1031;1;119;2.0
4;247;1031;1035;4;119;2.0
4;248;1035;1036;1;119;2.0
4;249;1036;1044;8;119;2.0
4;250;1044;1047;3;119;2.0
4;251;1047;1048;1;119;2.0
4;252;1048;1050;2;119;2.0
4;253;1050;1060;10;119;2.0
4;254;1060;1066;6;119;2.0
4;255;1066;1069;3;119;2.0
4;256;1069;1070;1;119;2.0
4;257;1070;1078;8;119;2.0
4;258;1078;1080;2;119;2.0
4;259;1080;1084;4;119;2.0
4;260;1084;1085;1;119;2.0
4;261;1085;1090;5;119;2.0
4;262;1090;1093;3;119;2.0
4;263;1093;1095;2;119;2.0
4;264;1095;1098;3;119;2.0
4;265;1098;1099;1;119;2.0
4;266;1099;1102;3;119;2.0
4;267;1102;1105;3;119;2.0
4;268;1105;1111;6;119;2.0
4;269;1111;1114;3;119;2.0
4;270;1114;1116;2;119;2.0
4;271;1116;1120;4;119;2.0
4;272;1120;1125;5;119;2.0
4;273;1125;1136;11;119;2.0
4;274;1136;1139;3;119;2.0
4;275;1139;1145;6;119;2.0
4;276;1145;1146;1;119;2.0
4;277;1146;1149;3;119;2.0
4;278;1149;1152;3;119;2.0
4;279;1152;1153;1;119;2.0
4;280;1153;1172;19;119;2.0
4;281;1172;1176;4;119;2.0
4;282;1176;1178;2;119;2.0
4;283;1178;1185;7;119;2.0
4;284;1185;1201;16;119;2.0
4;285;1201;1207;6;119;2.0
4;286;1207;1209;2;119;2.0
4;287;1209;1211;2;119;2.0
4;288;1211;1222;11;119;2.0
4;289;1222;1223;1;119;2.0
4;290;1223;1225;2;119;2.0
4;291;1225;1236;11;119;2.0
4;292;1236;1257;21;119;2.0
4;293;1257;1260;3;119;2.0
4;294;1260;1264;4;119;2.0
4;295;1264;1265;1;119;2.0
4;296;1265;1269;4;119;2.0
4;297;1269;1271;2;119;2.0
4;298;1271;1273;2;119;2.0
4;299;1273;1282;9;119;2.0
4;300;1282;1283;1;119;2.0
4;301;1283;1296;13;119;2.0
4;302;1296;1300;4;119;2.0
4;303;1300;1307;7;119;2.0
4;304;1307;1309;2;119;2.0
4;305;1309;1319;10;119;2.0
4;306;1319;1322;3;119;2.0
4;307;1322;1324;2;119;2.0
4;308;1324;1325;1;119;2.0
4;309;1325;1331;6;119;2.0
4;310;1331;1339;8;119;2.0
4;311;1339;1345;6;119;2.0
4;312;1345;1346;1;119;2.0
4;313;1346;1354;8;119;2.0
4;314;1354;1362;8;119;2.0
4;315;1362;1363;1;119;2.0
4;316;1363;1364;1;119;2.0
4;317;1364;1367;3;119;2.0
4;318;1367;1376;9;119;2.0
4;319;1376;1381;5;119;2.0
4;320;1381;1383;2;119;2.0
4;321;1383;1387;4;119;2.0
4;322;1387;1393;6;119;2.0
4;323;1393;1396;3;119;2.0
4;324;1396;1411;15;119;2.0
4;325;1411;1426;15;119;2.0
4;326;1426;1441;15;119;2.0
4;327;1441;1456;15;119;2.0
4;328;1456;1471;15;119;2.0
4;329;1471;1486;15;119;2.0
4;330;1486;1501;15;119;2.0
4;331;1501;1516;15;119;2.0
4;332;1516;1531;15;119;2.0
4;333;1531;1546;15;119;2.0
4;334;1546;1561;15;119;2.0
4;335;1561;1576;15;119;2.0
4;336;1576;1591;15;119;2.0
4;337;1591;1606;15;119;2.0
4;338;1606;1621;15;119;2.0
4;339;1621;1636;15;119;2.0
4;340;1636;1651;15;119;2.0
4;341;1651;1666;15;119;2.0
4;342;1666;1680;14;119;2.0
5;0;243;330;87;96;2.0
5;1;330;333;3;96;2.0
5;2;333;334;1;96;2.0
5;3;334;335;1;96;2.0
5;4;335;338;3;96;2.0
5;5;338;339;1;96;2.0
5;6;339;343;4;96;2.0
5;7;343;350;7;96;2.0
5;8;350;352;2;96;2.0
5;9;352;354;2;96;2.0
5;10;354;356;2;96;2.0
5;11;356;357;1;96;2.0
5;12;357;358;1;96;2.0
5;13;358;359;1;96;2.0
5;14;359;360;1;96;2.0
5;15;360;362;2;96;2.0
5;16;362;365;3;96;2.0
5;17;365;367;2;96;2.0
5;18;367;370;3;96;2.0
5;19;370;371;1;96;2.0
5;20;371;373;2;96;2.0
5;21;373;374;1;96;2.0
5;22;374;379;5;96;2.0
5;23;379;384;5;96;2.0
5;24;384;385;1;96;2.0
5;25;385;387;2;96;2.0
5;26;387;390;3;96;2.0
5;27;390;392;2;96;2.0
5;28;392;393;1;96;2.0
5;29;393;394;1;96;2.0
5;30;394;395;1;96;2.0
5;31;395;396;1;96;2.0
5;32;396;400;4;96;2.0
5;33;400;401;1;96;2.0
5;34;401;407;6;96;2.0
5;35;407;408;1;96;2.0
5;36;408;409;1;96;2.0
5;37;409;410;1;96;2.0
5;38;410;413;3;96;2.0
5;39;413;417;4;96;2.0
5;40;417;420;3;96;2.0
5;41;420;421;1;96;2.0
5;42;421;422;1;96;2.0
5;43;422;423;1;96;2.0
5;44;423;424;1;96;2.0
5;45;424;425;1;96;2.0
5;46;425;426;1;96;2.0
5;47;426;427;1;96;2.0
5;48;427;428;1;96;2.0
5;49;428;430;2;96;2.0
5;50;430;432;2;96;2.0
5;51;432;434;2;96;2.0
5;52;434;436;2;96;2.0
5;53;436;440;4;96;2.0
5;54;440;443;3;96;2.0
5;55;443;447;4;96;2.0
5;56;447;450;3;96;2.0
5;57;450;451;1;96;2.0
5;58;451;453;2;96;2.0
5;59;453;454;1;96;2.0
5;60;454;455;1;96;2.0
5;61;455;456;1;96;2.0
5;62;456;459;3;96;2.0
5;63;459;463;4;96;2.0
5;64;463;466;3;96;2.0
5;65;466;469;3;96;2.0
5;66;469;470;1;96;2.0
5;67;470;472;2;96;2.0
5;68;472;475;3;96;2.0
5;69;475;476;1;96;2.0
5;70;476;482;6;96;2.0
5;71;482;484;2;96;2.0
5;72;484;485;1;96;2.0
5;73;485;486;1;96;2.0
5;74;486;487;1;96;2.0
5;75;487;497;10;96;2.0
5;76;497;498;1;96;2.0
5;77;498;500;2;96;2.0
5;78;500;504;4;96;2.0
5;79;504;506;2;96;2.0
5;80;506;507;1;96;2.0
5;81;507;510;3;96;2.0
5;82;510;516;6;96;2.0
5;83;516;517;1;96;2.0
5;84;517;518;1;96;2.0
5;85;518;522;4;96;2.0
5;86;522;528;6;96;2.0
5;87;528;534;6;96;2.0
5;88;534;535;1;96;2.0
5;89;535;540;5;96;2.0
5;90;540;544;4;96;2.0
5;91;544;546;2;96;2.0
5;92;546;547;1;96;2.0
5;93;547;549;2;96;2.0
5;94;549;552;3;96;2.0
5;95;552;555;3;96;2.0
5;96;555;558;3;96;2.0
5;97;558;577;19;96;2.0
5;98;577;578;1;96;2.0
5;99;578;583;5;96;2.0
5;100;583;590;7;96;2.0
5;101;590;592;2;96;2.0
5;102;592;593;1;96;2.0
5;103;593;594;1;96;2.0
5;104;594;595;1;96;2.0
5;105;595;596;1;96;2.0
5;106;596;601;5;96;2.0
5;107;601;618;17;96;2.0
5;108;618;621;3;96;2.0
5;109;621;627;6;96;2.0
5;110;627;629;2;96;2.0
5;111;629;630;1;96;2.0
5;112;630;632;2;96;2.0
5;113;632;633;1;96;2.0
5;114;633;638;5;96;2.0
5;115;638;654;16;96;2.0
5;116;654;660;6;96;2.0
5;117;660;662;2;96;2.0
5;118;662;663;1;96;2.0
5;119;663;675;12;96;2.0
5;120;675;678;3;96;2.0
5;121;678;684;6;96;2.0
5;122;684;697;13;96;2.0
5;123;697;700;3;96;2.0
5;124;700;703;3;96;2.0
5;125;703;704;1;96;2.0
5;126;704;714;10;96;2.0
5;127;714;721;7;96;2.0
5;128;721;723;2;96;2.0
5;129;723;725;2;96;2.0
5;130;725;728;3;96;2.0
5;131;728;730;2;96;2.0
5;132;730;732;2;96;2.0
5;133;732;738;6;96;2.0
5;134;738;741;3;96;2.0
5;135;741;750;9;96;2.0
5;136;750;751;1;96;2.0
5;137;751;752;1;96;2.0
5;138;752;760;8;96;2.0
5;139;760;763;3;96;2.0
5;140;763;764;1;96;2.0
5;141;764;768;4;96;2.0
5;142;768;770;2;96;2.0
5;143;770;772;2;96;2.0
5;144;772;774;2;96;2.0
5;145;774;780;6;96;2.0
5;146;780;781;1;96;2.0
5;147;781;787;6;96;2.0
5;148;787;792;5;96;2.0
5;149;792;797;5;96;2.0
5;150;797;798;1;96;2.0
5;151;798;801;3;96;2.0
5;152;801;803;2;96;2.0
5;153;803;805;2;96;2.0
5;154;805;810;5;96;2.0
5;155;810;817;7;96;2.0
5;156;817;821;4;96;2.0
5;157;821;822;1;96;2.0
5;158;822;823;1;96;2.0
5;159;823;824;1;96;2.0
5;160;824;825;1;96;2.0
5;161;825;826;1;96;2.0
5;162;826;830;4;96;2.0
5;163;830;834;4;96;2.0
5;164;834;835;1;96;2.0
5;165;835;836;1;96;2.0
5;166;836;837;1;96;2.0
5;167;837;838;1;96;2.0
5;168;838;840;2;96;2.0
5;169;840;842;2;96;2.0
5;170;842;848;6;96;2.0
5;171;848;852;4;96;2.0
5;172;852;853;1;96;2.0
5;173;853;857;4;96;2.0
5;174;857;858;1;96;2.0
5;175;858;860;2;96;2.0
5;176;860;861;1;96;2.0
5;177;861;865;4;96;2.0
5;178;865;867;2;96;2.0
5;179;867;868;1;96;2.0
5;180;868;871;3;96;2.0
5;181;871;874;3;96;2.0
5;182;874;875;1;96;2.0
5;183;875;877;2;96;2.0
5;184;877;880;3;96;2.0
5;185;880;883;3;96;2.0
5;186;883;884;1;96;2.0
5;187;884;885;1;96;2.0
5;188;885;887;2;96;2.0
5;189;887;890;3;96;2.0
5;190;890;891;1;96;2.0
5;191;891;892;1;96;2.0
5;192;892;894;2;96;2.0
5;193;894;900;6;96;2.0
5;194;900;902;2;96;2.0
5;195;902;903;1;96;2.0
5;196;903;905;2;96;2.0
5;197;905;906;1;96;2.0
5;198;906;907;1;96;2.0
5;199;907;910;3;96;2.0
5;200;910;912;2;96;2.0
5;201;912;913;1;96;2.0
5;202;913;914;1;96;2.0
5;203;914;917;3;96;2.0
5;204;917;918;1;96;2.0
5;205;918;922;4;96;2.0
5;206;922;926;4;96;2.0
5;207;926;928;2;96;2.0
5;208;928;930;2;96;2.0
5;209;930;931;1;96;2.0
5;210;931;932;1;96;2.0
5;211;932;935;3;96;2.0
5;212;935;940;5;96;2.0
5;213;940;941;1;96;2.0
5;214;941;942;1;96;2.0
5;215;942;943;1;96;2.0
5;216;943;944;1;96;2.0
5;217;944;945;1;96;2.0
5;218;945;948;3;96;2.0
5;219;948;951;3;96;2.0
5;220;951;952;1;96;2.0
5;221;952;958;6;96;2.0
5;222;958;960;2;96;2.0
5;223;960;961;1;96;2.0
5;224;961;962;1;96;2.0
5;225;962;967;5;96;2.0
5;226;967;969;2;96;2.0
5;227;969;970;1;96;2.0
5;228;970;972;2;96;2.0
5;229;972;973;1;96;2.0
5;230;973;974;1;96;2.0
5;231;974;978;4;96;2.0
5;232;978;980;2;96;2.0
5;233;980;981;1;96;2.0
5;234;981;982;1;96;2.0
5;235;982;983;1;96;2.0
5;236;983;984;1;96;2.0
5;237;984;996;12;96;2.0
5;238;996;998;2;96;2.0
5;239;998;1000;2;96;2.0
5;240;1000;1001;1;96;2.0
5;241;1001;1002;1;96;2.0
5;242;1002;1004;2;96;2.0
5;243;1004;1005;1;96;2.0
5;244;1005;1007;2;96;2.0
5;245;1007;1011;4;96;2.0
5;246;1011;1017;6;96;2.0
5;247;1017;1018;1;96;2.0
5;248;1018;1022;4;96;2.0
5;249;1022;1023;1;96;2.0
5;250;1023;1025;2;96;2.0
5;251;1025;1028;3;96;2.0
5;252;1028;1030;2;96;2.0
5;253;1030;1033;3;96;2.0
5;254;1033;1034;1;96;2.0
5;255;1034;1037;3;96;2.0
5;256;1037;1046;9;96;2.0
5;257;1046;1048;2;96;2.0
5;258;1048;1049;1;96;2.0
5;259;1049;1060;11;96;2.0
5;260;1060;1062;2;96;2.0
5;261;1062;1068;6;96;2.0
5;262;1068;1071;3;96;2.0
5;263;1071;1079;8;96;2.0
5;264;1079;1080;1;96;2.0
5;265;1080;1082;2;96;2.0
5;266;1082;1086;4;96;2.0
5;267;1086;1087;1;96;2.0
5;268;1087;1088;1;96;2.0
5;269;1088;1090;2;96;2.0
5;270;1090;1091;1;96;2.0
5;271;1091;1096;5;96;2.0
5;272;1096;1099;3;96;2.0
5;273;1099;1101;2;96;2.0
5;274;1101;1103;2;96;2.0
5;275;1103;1104;1;96;2.0
5;276;1104;1106;2;96;2.0
5;277;1106;1113;7;96;2.0
5;278;1113;1115;2;96;2.0
5;279;1115;1116;1;96;2.0
5;280;1116;1120;4;96;2.0
5;281;1120;1126;6;96;2.0
5;282;1126;1138;12;96;2.0
5;283;1138;1141;3;96;2.0
5;284;1141;1146;5;96;2.0
5;285;1146;1147;1;96;2.0
5;286;1147;1153;6;96;2.0
5;287;1153;1155;2;96;2.0
5;288;1155;1174;19;96;2.0
5;289;1174;1176;2;96;2.0
5;290;1176;1178;2;96;2.0
5;291;1178;1179;1;96;2.0
5;292;1179;1186;7;96;2.0
5;293;1186;1203;17;96;2.0
5;294;1203;1207;4;96;2.0
5;295;1207;1208;1;96;2.0
5;296;1208;1213;5;96;2.0
5;297;1213;1221;8;96;2.0
5;298;1221;1224;3;96;2.0
5;299;1224;1226;2;96;2.0
5;300;1226;1236;10;96;2.0
5;301;1236;1256;20;96;2.0
5;302;1256;1261;5;96;2.0
5;303;1261;1266;5;96;2.0
5;304;1266;1267;1;96;2.0
5;305;1267;1273;6;96;2.0
5;306;1273;1275;2;96;2.0
5;307;1275;1284;9;96;2.0
5;308;1284;1296;12;96;2.0
5;309;1296;1301;5;96;2.0
5;310;1301;1308;7;96;2.0
5;311;1308;1309;1;96;2.0
5;312;1309;1317;8;96;2.0
5;313;1317;1324;7;96;2.0
5;314;1324;1326;2;96;2.0
5;315;1326;1327;1;96;2.0
5;316;1327;1330;3;96;2.0
5;317;1330;1341;11;96;2.0
5;318;1341;1345;4;96;2.0
5;319;1345;1347;2;96;2.0
5;320;1347;1355;8;96;2.0
5;321;1355;1362;7;96;2.0
5;322;1362;1364;2;96;2.0
5;323;1364;1365;1;96;2.0
5;324;1365;1366;1;96;2.0
5;325;1366;1368;2;96;2.0
5;326;1368;1378;10;96;2.0
5;327;1378;1381;3;96;2.0
5;328;1381;1382;1;96;2.0
5;329;1382;1389;7;96;2.0
5;330;1389;1395;6;96;2.0
5;331;1395;1397;2;96;2.0
5;332;1397;1412;15;96;2.0
5;333;1412;1427;15;96;2.0
5;334;1427;1442;15;96;2.0
5;335;1442;1457;15;96;2.0
5;336;1457;1472;15;96;2.0
5;337;1472;1487;15;96;2.0
5;338;1487;1502;15;96;2.0
5;339;1502;1517;15;96;2.0
5;340;1517;1532;15;96;2.0
5;341;1532;1547;15;96;2.0
5;342;1547;1562;15;96;2.0
5;343;1562;1577;15;96;2.0
5;344;1577;1592;15;96;2.0
5;345;1592;1607;15;96;2.0
5;346;1607;1622;15;96;2.0
5;347;1622;1637;15;96;2.0
5;348;1637;1652;15;96;2.0
5;349;1652;1667;15;96;2.0
5;350;1667;1680;13;96;2.0
6;0;252;321;69;160;2.0
6;1;321;326;5;160;2.0
6;2;326;331;5;160;2.0
6;3;331;334;3;160;2.0
6;4;334;337;3;160;2.0
6;5;337;339;2;160;2.0
6;6;339;340;1;160;2.0
6;7;340;341;1;160;2.0
6;8;341;342;1;160;2.0
6;9;342;343;1;160;2.0
6;10;343;346;3;160;2.0
6;11;346;348;2;160;2.0
6;12;348;349;1;160;2.0
6;13;349;350;1;160;2.0
6;14;350;352;2;160;2.0
6;15;352;354;2;160;2.0
6;16;354;359;5;160;2.0
6;17;359;360;1;160;2.0
6;18;360;361;1;160;2.0
6;19;361;363;2;160;2.0
6;20;363;367;4;160;2.0
6;21;367;368;1;160;2.0
6;22;368;369;1;160;2.0
6;23;369;371;2;160;2.0
6;24;371;372;1;160;2.0
6;25;372;373;1;160;2.0
6;26;373;374;1;160;2.0
6;27;374;378;4;160;2.0
6;28;378;380;2;160;2.0
6;29;380;381;1;160;2.0
6;30;381;383;2;160;2.0
6;31;383;387;4;160;2.0
6;32;387;389;2;160;2.0
6;33;389;391;2;160;2.0
6;34;391;393;2;160;2.0
6;35;393;394;1;160;2.0
6;36;394;395;1;160;2.0
6;37;395;400;5;160;2.0
6;38;400;402;2;160;2.0
6;39;402;403;1;160;2.0
6;40;403;404;1;160;2.0
6;41;404;405;1;160;2.0
6;42;405;406;1;160;2.0
6;43;406;410;4;160;2.0
6;44;410;412;2;160;2.0
6;45;412;413;1;160;2.0
6;46;413;417;4;160;2.0
6;47;417;418;1;160;2.0
6;48;418;420;2;160;2.0
6;49;420;421;1;160;2.0
6;50;421;422;1;160;2.0
6;51;422;423;1;160;2.0
6;52;423;425;2;160;2.0
6;53;425;426;1;160;2.0
6;54;426;427;1;160;2.0
6;55;427;428;1;160;2.0
6;56;428;429;1;160;2.0
6;57;429;433;4;160;2.0
6;58;433;434;1;160;2.0
6;59;434;436;2;160;2.0
6;60;436;438;2;160;2.0
6;61;438;439;1;160;2.0
6;62;439;440;1;160;2.0
6;63;440;442;2;160;2.0
6;64;442;444;2;160;2.0
6;65;444;449;5;160;2.0
6;66;449;451;2;160;2.0
6;67;451;453;2;160;2.0
6;68;453;454;1;160;2.0
6;69;454;457;3;160;2.0
6;70;457;459;2;160;2.0
6;71;459;460;1;160;2.0
6;72;460;463;3;160;2.0
6;73;463;464;1;160;2.0
6;74;464;465;1;160;2.0
6;75;465;466;1;160;2.0
6;76;466;470;4;160;2.0
6;77;470;472;2;160;2.0
6;78;472;473;1;160;2.0
6;79;473;474;1;160;2.0
6;80;474;475;1;160;2.0
6;81;475;477;2;160;2.0
6;82;477;479;2;160;2.0
6;83;479;480;1;160;2.0
6;84;480;481;1;160;2.0
6;85;481;482;1;160;2.0
6;86;482;485;3;160;2.0
6;87;485;488;3;160;2.0
6;88;488;489;1;160;2.0
6;89;489;496;7;160;2.0
6;90;496;501;5;160;2.0
6;91;501;508;7;160;2.0
6;92;508;510;2;160;2.0
6;93;510;511;1;160;2.0
6;94;511;514;3;160;2.0
6;95;514;520;6;160;2.0
6;96;520;522;2;160;2.0
6;97;522;524;2;160;2.0
6;98;524;532;8;160;2.0
6;99;532;535;3;160;2.0
6;100;535;537;2;160;2.0
6;101;537;538;1;160;2.0
6;102;538;544;6;160;2.0
6;103;544;549;5;160;2.0
6;104;549;550;1;160;2.0
6;105;550;553;3;160;2.0
6;106;553;554;1;160;2.0
6;107;554;556;2;160;2.0
6;108;556;559;3;160;2.0
6;109;559;562;3;160;2.0
6;110;562;566;4;160;2.0
6;111;566;580;14;160;2.0
6;112;580;581;1;160;2.0
6;113;581;588;7;160;2.0
6;114;588;591;3;160;2.0
6;115;591;593;2;160;2.0
6;116;593;594;1;160;2.0
6;117;594;597;3;160;2.0
6;118;597;600;3;160;2.0
6;119;600;603;3;160;2.0
6;120;603;615;12;160;2.0
6;121;615;617;2;160;2.0
6;122;617;625;8;160;2.0
6;123;625;628;3;160;2.0
6;124;628;629;1;160;2.0
6;125;629;633;4;160;2.0
6;126;633;634;1;160;2.0
6;127;634;639;5;160;2.0
6;128;639;642;3;160;2.0
6;129;642;643;1;160;2.0
6;130;643;650;7;160;2.0
6;131;650;657;7;160;2.0
6;132;657;658;1;160;2.0
6;133;658;662;4;160;2.0
6;134;662;664;2;160;2.0
6;135;664;671;7;160;2.0
6;136;671;682;11;160;2.0
6;137;682;685;3;160;2.0
6;138;685;691;6;160;2.0
6;139;691;692;1;160;2.0
6;140;692;701;9;160;2.0
6;141;701;704;3;160;2.0
6;142;704;713;9;160;2.0
6;143;713;717;4;160;2.0
6;144;717;720;3;160;2.0
6;145;720;721;1;160;2.0
6;146;721;723;2;160;2.0
6;147;723;725;2;160;2.0
6;148;725;727;2;160;2.0
6;149;727;734;7;160;2.0
6;150;734;745;11;160;2.0
6;151;745;748;3;160;2.0
6;152;748;752;4;160;2.0
6;153;752;758;6;160;2.0
6;154;758;759;1;160;2.0
6;155;759;760;1;160;2.0
6;156;760;766;6;160;2.0
6;157;766;772;6;160;2.0
6;158;772;773;1;160;2.0
6;159;773;777;4;160;2.0
6;160;777;780;3;160;2.0
6;161;780;784;4;160;2.0
6;162;784;785;1;160;2.0
6;163;785;791;6;160;2.0
6;164;791;793;2;160;2.0
6;165;793;801;8;160;2.0
6;166;801;805;4;160;2.0
6;167;805;806;1;160;2.0
6;168;806;808;2;160;2.0
6;169;808;810;2;160;2.0
6;170;810;812;2;160;2.0
6;171;812;814;2;160;2.0
6;172;814;821;7;160;2.0
6;173;821;827;6;160;2.0
6;174;827;828;1;160;2.0
6;175;828;830;2;160;2.0
6;176;830;832;2;160;2.0
6;177;832;833;1;160;2.0
6;178;833;835;2;160;2.0
6;179;835;836;1;160;2.0
6;180;836;837;1;160;2.0
6;181;837;840;3;160;2.0
6;182;840;841;1;160;2.0
6;183;841;842;1;160;2.0
6;184;842;846;4;160;2.0
6;185;846;848;2;160;2.0
6;186;848;849;1;160;2.0
6;187;849;855;6;160;2.0
6;188;855;858;3;160;2.0
6;189;858;861;3;160;2.0
6;190;861;863;2;160;2.0
6;191;863;864;1;160;2.0
6;192;864;865;1;160;2.0
6;193;865;868;3;160;2.0
6;194;868;871;3;160;2.0
6;195;871;872;1;160;2.0
6;196;872;875;3;160;2.0
6;197;875;877;2;160;2.0
6;198;877;878;1;160;2.0
6;199;878;880;2;160;2.0
6;200;880;883;3;160;2.0
6;201;883;886;3;160;2.0
6;202;886;891;5;160;2.0
6;203;891;893;2;160;2.0
6;204;893;894;1;160;2.0
6;205;894;895;1;160;2.0
6;206;895;896;1;160;2.0
6;207;896;897;1;160;2.0
6;208;897;902;5;160;2.0
6;209;902;904;2;160;2.0
6;210;904;908;4;160;2.0
6;211;908;909;1;160;2.0
6;212;909;910;1;160;2.0
6;213;910;911;1;160;2.0
6;214;911;913;2;160;2.0
6;215;913;914;1;160;2.0
6;216;914;916;2;160;2.0
6;217;916;918;2;160;2.0
6;218;918;920;2;160;2.0
6;219;920;921;1;160;2.0
6;220;921;925;4;160;2.0
6;221;925;928;3;160;2.0
6;222;928;930;2;160;2.0
6;223;930;932;2;160;2.0
6;224;932;933;1;160;2.0
6;225;933;934;1;160;2.0
6;226;934;935;1;160;2.0
6;227;935;937;2;160;2.0
6;228;937;938;1;160;2.0
6;229;938;939;1;160;2.0
6;230;939;943;4;160;2.0
6;231;943;945;2;160;2.0
6;232;945;946;1;160;2.0
6;233;946;949;3;160;2.0
6;234;949;950;1;160;2.0
6;235;950;953;3;160;2.0
6;236;953;956;3;160;2.0
6;237;956;962;6;160;2.0
6;238;962;964;2;160;2.0
6;239;964;965;1;160;2.0
6;240;965;968;3;160;2.0
6;241;968;969;1;160;2.0
6;242;969;970;1;160;2.0
6;243;970;971;1;160;2.0
6;244;971;973;2;160;2.0
6;245;973;976;3;160;2.0
6;246;976;980;4;160;2.0
6;247;980;984;4;160;2.0
6;248;984;985;1;160;2.0
6;249;985;988;3;160;2.0
6;250;988;990;2;160;2.0
6;251;990;992;2;160;2.0
6;252;992;1000;8;160;2.0
6;253;1000;1003;3;160;2.0
6;254;1003;1006;3;160;2.0
6;255;1006;1007;1;160;2.0
6;256;1007;1008;1;160;2.0
6;257;1008;1009;1;160;2.0
6;258;1009;1010;1;160;2.0
6;259;1010;1013;3;160;2.0
6;260;1013;1021;8;160;2.0
6;261;1021;1025;4;160;2.0
6;262;1025;1027;2;160;2.0
6;263;1027;1028;1;160;2.0
6;264;1028;1029;1;160;2.0
6;265;1029;1030;1;160;2.0
6;266;1030;1032;2;160;2.0
6;267;1032;1033;1;160;2.0
6;268;1033;1036;3;160;2.0
6;269;1036;1038;2;160;2.0
6;270;1038;1041;3;160;2.0
6;271;1041;1043;2;160;2.0
6;272;1043;1050;7;160;2.0
6;273;1050;1053;3;160;2.0
6;274;1053;1055;2;160;2.0
6;275;1055;1058;3;160;2.0
6;276;1058;1063;5;160;2.0
6;277;1063;1064;1;160;2.0
6;278;1064;1066;2;160;2.0
6;279;1066;1070;4;160;2.0
6;280;1070;1073;3;160;2.0
6;281;1073;1078;5;160;2.0
6;282;1078;1082;4;160;2.0
6;283;1082;1083;1;160;2.0
6;284;1083;1086;3;160;2.0
6;285;1086;1088;2;160;2.0
6;286;1088;1090;2;160;2.0
6;287;1090;1094;4;160;2.0
6;288;1094;1098;4;160;2.0
6;289;1098;1103;5;160;2.0
6;290;1103;1105;2;160;2.0
6;291;1105;1108;3;160;2.0
6;292;1108;1110;2;160;2.0
6;293;1110;1113;3;160;2.0
6;294;1113;1120;7;160;2.0
6;295;1120;1121;1;160;2.0
6;296;1121;1126;5;160;2.0
6;297;1126;1130;4;160;2.0
6;298;1130;1137;7;160;2.0
6;299;1137;1150;13;160;2.0
6;300;1150;1157;7;160;2.0
6;301;1157;1159;2;160;2.0
6;302;1159;1160;1;160;2.0
6;303;1160;1166;6;160;2.0
6;304;1166;1178;12;160;2.0
6;305;1178;1180;2;160;2.0
6;306;1180;1186;6;160;2.0
6;307;1186;1190;4;160;2.0
6;308;1190;1200;10;160;2.0
6;309;1200;1201;1;160;2.0
6;310;1201;1215;14;160;2.0
6;311;1215;1217;2;160;2.0
6;312;1217;1228;11;160;2.0
6;313;1228;1233;5;160;2.0
6;314;1233;1240;7;160;2.0
6;315;1240;1261;21;160;2.0
6;316;1261;1262;1;160;2.0
6;317;1262;1265;3;160;2.0
6;318;1265;1273;8;160;2.0
6;319;1273;1277;4;160;2.0
6;320;1277;1288;11;160;2.0
6;321;1288;1291;3;160;2.0
6;322;1291;1300;9;160;2.0
6;323;1300;1305;5;160;2.0
6;324;1305;1311;6;160;2.0
6;325;1311;1315;4;160;2.0
6;326;1315;1317;2;160;2.0
6;327;1317;1319;2;160;2.0
6;328;1319;1322;3;160;2.0
6;329;1322;1327;5;160;2.0
6;330;1327;1339;12;160;2.0
6;331;1339;1343;4;160;2.0
6;332;1343;1345;2;160;2.0
6;333;1345;1349;4;160;2.0
6;334;1349;1354;5;160;2.0
6;335;1354;1361;7;160;2.0
6;336;1361;1366;5;160;2.0
6;337;1366;1369;3;160;2.0
6;338;1369;1370;1;160;2.0
6;339;1370;1375;5;160;2.0
6;340;1375;1389;14;160;2.0
6;341;1389;1391;2;160;2.0
6;342;1391;1393;2;160;2.0
6;343;1393;1397;4;160;2.0
6;344;1397;1404;7;160;2.0
6;345;1404;1419;15;160;2.0
6;346;1419;1434;15;160;2.0
6;347;1434;1449;15;160;2.0
6;348;1449;1464;15;160;2.0
6;349;1464;1479;15;160;2.0
6;350;1479;1494;15;160;2.0
6;351;1494;1509;15;160;2.0
6;352;1509;1524;15;160;2.0
6;353;1524;1539;15;160;2.0
6;354;1539;1554;15;160;2.0
6;355;1554;1569;15;160;2.0
6;356;1569;1584;15;160;2.0
6;357;1584;1599;15;160;2.0
6;358;1599;1614;15;160;2.0
6;359;1614;1629;15;160;2.0
6;360;1629;1644;15;160;2.0
6;361;1644;1659;15;160;2.0
6;362;1659;1680;21;160;2.0
7;0;250;324;74;1;2.0
7;1;324;328;4;1;2.0
7;2;328;333;5;1;2.0
7;3;333;338;5;1;2.0
7;4;338;339;1;1;2.0
7;5;339;340;1;1;2.0
7;6;340;341;1;1;2.0
7;7;341;346;5;1;2.0
7;8;346;347;1;1;2.0
7;9;347;348;1;1;2.0
7;10;348;350;2;1;2.0
7;11;350;352;2;1;2.0
7;12;352;353;1;1;2.0
7;13;353;354;1;1;2.0
7;14;354;357;3;1;2.0
7;15;357;358;1;1;2.0
7;16;358;363;5;1;2.0
7;17;363;364;1;1;2.0
7;18;364;366;2;1;2.0
7;19;366;367;1;1;2.0
7;20;367;368;1;1;2.0
7;21;368;369;1;1;2.0
7;22;369;372;3;1;2.0
7;23;372;374;2;1;2.0
7;24;374;376;2;1;2.0
7;25;376;378;2;1;2.0
7;26;378;379;1;1;2.0
7;27;379;381;2;1;2.0
7;28;381;383;2;1;2.0
7;29;383;384;1;1;2.0
7;30;384;387;3;1;2.0
7;31;387;388;1;1;2.0
7;32;388;392;4;1;2.0
7;33;392;394;2;1;2.0
7;34;394;398;4;1;2.0
7;35;398;399;1;1;2.0
7;36;399;401;2;1;2.0
7;37;401;402;1;1;2.0
7;38;402;403;1;1;2.0
7;39;403;405;2;1;2.0
7;40;405;411;6;1;2.0
7;41;411;414;3;1;2.0
7;42;414;415;1;1;2.0
7;43;415;416;1;1;2.0
7;44;416;417;1;1;2.0
7;45;417;418;1;1;2.0
7;46;418;419;1;1;2.0
7;47;419;420;1;1;2.0
7;48;420;423;3;1;2.0
7;49;423;424;1;1;2.0
7;50;424;425;1;1;2.0
7;51;425;427;2;1;2.0
7;52;427;428;1;1;2.0
7;53;428;429;1;1;2.0
7;54;429;432;3;1;2.0
7;55;432;434;2;1;2.0
7;56;434;435;1;1;2.0
7;57;435;436;1;1;2.0
7;58;436;439;3;1;2.0
7;59;439;442;3;1;2.0
7;60;442;444;2;1;2.0
7;61;444;446;2;1;2.0
7;62;446;448;2;1;2.0
7;63;448;449;1;1;2.0
7;64;449;451;2;1;2.0
7;65;451;452;1;1;2.0
7;66;452;453;1;1;2.0
7;67;453;454;1;1;2.0
7;68;454;457;3;1;2.0
7;69;457;458;1;1;2.0
7;70;458;459;1;1;2.0
7;71;459;461;2;1;2.0
7;72;461;463;2;1;2.0
7;73;463;466;3;1;2.0
7;74;466;467;1;1;2.0
7;75;467;468;1;1;2.0
7;76;468;471;3;1;2.0
7;77;471;472;1;1;2.0
7;78;472;474;2;1;2.0
7;79;474;475;1;1;2.0
7;80;475;477;2;1;2.0
7;81;477;478;1;1;2.0
7;82;478;479;1;1;2.0
7;83;479;480;1;1;2.0
7;84;480;482;2;1;2.0
7;85;482;484;2;1;2.0
7;86;484;485;1;1;2.0
7;87;485;487;2;1;2.0
7;88;487;489;2;1;2.0
7;89;489;499;10;1;2.0
7;90;499;505;6;1;2.0
7;91;505;506;1;1;2.0
7;92;506;509;3;1;2.0
7;93;509;512;3;1;2.0
7;94;512;517;5;1;2.0
7;95;517;518;1;1;2.0
7;96;518;520;2;1;2.0
7;97;520;522;2;1;2.0
7;98;522;533;11;1;2.0
7;99;533;536;3;1;2.0
7;100;536;537;1;1;2.0
7;101;537;539;2;1;2.0
7;102;539;542;3;1;2.0
7;103;542;544;2;1;2.0
7;104;544;548;4;1;2.0
7;105;548;553;5;1;2.0
7;106;553;554;1;1;2.0
7;107;554;557;3;1;2.0
7;108;557;560;3;1;2.0
7;109;560;573;13;1;2.0
7;110;573;579;6;1;2.0
7;111;579;584;5;1;2.0
7;112;584;587;3;1;2.0
7;113;587;591;4;1;2.0
7;114;591;592;1;1;2.0
7;115;592;595;3;1;2.0
7;116;595;597;2;1;2.0
7;117;597;598;1;1;2.0
7;118;598;600;2;1;2.0
7;119;600;622;22;1;2.0
7;120;622;623;1;1;2.0
7;121;623;624;1;1;2.0
7;122;624;626;2;1;2.0
7;123;626;632;6;1;2.0
7;124;632;634;2;1;2.0
7;125;634;637;3;1;2.0
7;126;637;640;3;1;2.0
7;127;640;641;1;1;2.0
7;128;641;657;16;1;2.0
7;129;657;658;1;1;2.0
7;130;658;662;4;1;2.0
7;131;662;664;2;1;2.0
7;132;664;680;16;1;2.0
7;133;680;689;9;1;2.0
7;134;689;692;3;1;2.0
7;135;692;699;7;1;2.0
7;136;699;702;3;1;2.0
7;137;702;711;9;1;2.0
7;138;711;714;3;1;2.0
7;139;714;717;3;1;2.0
7;140;717;720;3;1;2.0
7;141;720;722;2;1;2.0
7;142;722;723;1;1;2.0
7;143;723;725;2;1;2.0
7;144;725;727;2;1;2.0
7;145;727;732;5;1;2.0
7;146;732;743;11;1;2.0
7;147;743;746;3;1;2.0
7;148;746;748;2;1;2.0
7;149;748;756;8;1;2.0
7;150;756;757;1;1;2.0
7;151;757;759;2;1;2.0
7;152;759;767;8;1;2.0
7;153;767;770;3;1;2.0
7;154;770;771;1;1;2.0
7;155;771;777;6;1;2.0
7;156;777;782;5;1;2.0
7;157;782;783;1;1;2.0
7;158;783;787;4;1;2.0
7;159;787;789;2;1;2.0
7;160;789;792;3;1;2.0
7;161;792;799;7;1;2.0
7;162;799;803;4;1;2.0
7;163;803;806;3;1;2.0
7;164;806;808;2;1;2.0
7;165;808;812;4;1;2.0
7;166;812;813;1;1;2.0
7;167;813;817;4;1;2.0
7;168;817;819;2;1;2.0
7;169;819;823;4;1;2.0
7;170;823;825;2;1;2.0
7;171;825;826;1;1;2.0
7;172;826;830;4;1;2.0
7;173;830;831;1;1;2.0
7;174;831;834;3;1;2.0
7;175;834;837;3;1;2.0
7;176;837;838;1;1;2.0
7;177;838;839;1;1;2.0
7;178;839;840;1;1;2.0
7;179;840;844;4;1;2.0
7;180;844;847;3;1;2.0
7;181;847;848;1;1;2.0
7;182;848;853;5;1;2.0
7;183;853;854;1;1;2.0
7;184;854;856;2;1;2.0
7;185;856;859;3;1;2.0
7;186;859;862;3;1;2.0
7;187;862;863;1;1;2.0
7;188;863;864;1;1;2.0
7;189;864;866;2;1;2.0
7;190;866;873;7;1;2.0
7;191;873;876;3;1;2.0
7;192;876;877;1;1;2.0
7;193;877;879;2;1;2.0
7;194;879;884;5;1;2.0
7;195;884;885;1;1;2.0
7;196;885;887;2;1;2.0
7;197;887;890;3;1;2.0
7;198;890;891;1;1;2.0
7;199;891;892;1;1;2.0
7;200;892;893;1;1;2.0
7;201;893;894;1;1;2.0
7;202;894;897;3;1;2.0
7;203;897;902;5;1;2.0
7;204;902;907;5;1;2.0
7;205;907;908;1;1;2.0
7;206;908;909;1;1;2.0
7;207;909;911;2;1;2.0
7;208;911;913;2;1;2.0
7;209;913;914;1;1;2.0
7;210;914;917;3;1;2.0
7;211;917;918;1;1;2.0
7;212;918;919;1;1;2.0
7;213;919;923;4;1;2.0
7;214;923;926;3;1;2.0
7;215;926;931;5;1;2.0
7;216;931;932;1;1;2.0
7;217;932;933;1;1;2.0
7;218;933;937;4;1;2.0
7;219;937;939;2;1;2.0
7;220;939;942;3;1;2.0
7;221;942;943;1;1;2.0
7;222;943;947;4;1;2.0
7;223;947;950;3;1;2.0
7;224;950;951;1;1;2.0
7;225;951;954;3;1;2.0
7;226;954;957;3;1;2.0
7;227;957;962;5;1;2.0
7;228;962;963;1;1;2.0
7;229;963;966;3;1;2.0
7;230;966;967;1;1;2.0
7;231;967;969;2;1;2.0
7;232;969;971;2;1;2.0
7;233;971;974;3;1;2.0
7;234;974;977;3;1;2.0
7;235;977;978;1;1;2.0
7;236;978;982;4;1;2.0
7;237;982;983;1;1;2.0
7;238;983;986;3;1;2.0
7;239;986;988;2;1;2.0
7;240;988;996;8;1;2.0
7;241;996;997;1;1;2.0
7;242;997;998;1;1;2.0
7;243;998;999;1;1;2.0
7;244;999;1005;6;1;2.0
7;245;1005;1006;1;1;2.0
7;246;1006;1007;1;1;2.0
7;247;1007;1008;1;1;2.0
7;248;1008;1010;2;1;2.0
7;249;1010;1013;3;1;2.0
7;250;1013;1017;4;1;2.0
7;251;1017;1019;2;1;2.0
7;252;1019;1023;4;1;2.0
7;253;1023;1026;3;1;2.0
7;254;1026;1027;1;1;2.0
7;255;1027;1028;1;1;2.0
7;256;1028;1030;2;1;2.0
7;257;1030;1036;6;1;2.0
7;258;1036;1037;1;1;2.0
7;259;1037;1039;2;1;2.0
7;260;1039;1043;4;1;2.0
7;261;1043;1048;5;1;2.0
7;262;1048;1051;3;1;2.0
7;263;1051;1053;2;1;2.0
7;264;1053;1056;3;1;2.0
7;265;1056;1057;1;1;2.0
7;266;1057;1062;5;1;2.0
7;267;1062;1067;5;1;2.0
7;268;1067;1070;3;1;2.0
7;269;1070;1076;6;1;2.0
7;270;1076;1077;1;1;2.0
7;271;1077;1078;1;1;2.0
7;272;1078;1084;6;1;2.0
7;273;1084;1086;2;1;2.0
7;274;1086;1088;2;1;2.0
7;275;1088;1092;4;1;2.0
7;276;1092;1096;4;1;2.0
7;277;1096;1101;5;1;2.0
7;278;1101;1103;2;1;2.0
7;279;1103;1105;2;1;2.0
7;280;1105;1106;1;1;2.0
7;281;1106;1108;2;1;2.0
7;282;1108;1111;3;1;2.0
7;283;1111;1118;7;1;2.0
7;284;1118;1120;2;1;2.0
7;285;1120;1127;7;1;2.0
7;286;1127;1128;1;1;2.0
7;287;1128;1130;2;1;2.0
7;288;1130;1133;3;1;2.0
7;289;1133;1148;15;1;2.0
7;290;1148;1154;6;1;2.0
7;291;1154;1155;1;1;2.0
7;292;1155;1157;2;1;2.0
7;293;1157;1158;1;1;2.0
7;294;1158;1173;15;1;2.0
7;295;1173;1176;3;1;2.0
7;296;1176;1178;2;1;2.0
7;297;1178;1184;6;1;2.0
7;298;1184;1188;4;1;2.0
7;299;1188;1195;7;1;2.0
7;300;1195;1208;13;1;2.0
7;301;1208;1213;5;1;2.0
7;302;1213;1215;2;1;2.0
7;303;1215;1226;11;1;2.0
7;304;1226;1231;5;1;2.0
7;305;1231;1238;7;1;2.0
7;306;1238;1255;17;1;2.0
7;307;1255;1263;8;1;2.0
7;308;1263;1264;1;1;2.0
7;309;1264;1268;4;1;2.0
7;310;1268;1271;3;1;2.0
7;311;1271;1274;3;1;2.0
7;312;1274;1275;1;1;2.0
7;313;1275;1286;11;1;2.0
7;314;1286;1289;3;1;2.0
7;315;1289;1298;9;1;2.0
7;316;1298;1303;5;1;2.0
7;317;1303;1307;4;1;2.0
7;318;1307;1315;8;1;2.0
7;319;1315;1318;3;1;2.0
7;320;1318;1322;4;1;2.0
7;321;1322;1325;3;1;2.0
7;322;1325;1338;13;1;2.0
7;323;1338;1339;1;1;2.0
7;324;1339;1343;4;1;2.0
7;325;1343;1347;4;1;2.0
7;326;1347;1352;5;1;2.0
7;327;1352;1360;8;1;2.0
7;328;1360;1364;4;1;2.0
7;329;1364;1367;3;1;2.0
7;330;1367;1368;1;1;2.0
7;331;1368;1369;1;1;2.0
7;332;1369;1373;4;1;2.0
7;333;1373;1374;1;1;2.0
7;334;1374;1387;13;1;2.0
7;335;1387;1389;2;1;2.0
7;336;1389;1391;2;1;2.0
7;337;1391;1394;3;1;2.0
7;338;1394;1402;8;1;2.0
7;339;1402;1417;15;1;2.0
7;340;1417;1432;15;1;2.0
7;341;1432;1447;15;1;2.0
7;342;1447;1462;15;1;2.0
7;343;1462;1477;15;1;2.0
7;344;1477;1492;15;1;2.0
7;345;1492;1507;15;1;2.0
7;346;1507;1522;15;1;2.0
7;347;1522;1537;15;1;2.0
7;348;1537;1552;15;1;2.0
7;349;1552;1567;15;1;2.0
7;350;1567;1582;15;1;2.0
7;351;1582;1597;15;1;2.0
7;352;1597;1612;15;1;2.0
7;353;1612;1627;15;1;2.0
7;354;1627;1642;15;1;2.0
7;355;1642;1657;15;1;2.0
7;356;1657;1680;23;1;2.0
8;0;250;327;77;43;2.0
8;1;327;332;5;43;2.0
8;2;332;334;2;43;2.0
8;3;334;337;3;43;2.0
8;4;337;338;1;43;2.0
8;5;338;339;1;43;2.0
8;6;339;342;3;43;2.0
8;7;342;344;2;43;2.0
8;8;344;345;1;43;2.0
8;9;345;347;2;43;2.0
8;10;347;352;5;43;2.0
8;11;352;353;1;43;2.0
8;12;353;354;1;43;2.0
8;13;354;356;2;43;2.0
8;14;356;357;1;43;2.0
8;15;357;359;2;43;2.0
8;16;359;364;5;43;2.0
8;17;364;365;1;43;2.0
8;18;365;366;1;43;2.0
8;19;366;367;1;43;2.0
8;20;367;368;1;43;2.0
8;21;368;372;4;43;2.0
8;22;372;374;2;43;2.0
8;23;374;375;1;43;2.0
8;24;375;377;2;43;2.0
8;25;377;385;8;43;2.0
8;26;385;387;2;43;2.0
8;27;387;388;1;43;2.0
8;28;388;389;1;43;2.0
8;29;389;394;5;43;2.0
8;30;394;396;2;43;2.0
8;31;396;397;1;43;2.0
8;32;397;398;1;43;2.0
8;33;398;399;1;43;2.0
8;34;399;401;2;43;2.0
8;35;401;402;1;43;2.0
8;36;402;403;1;43;2.0
8;37;403;404;1;43;2.0
8;38;404;409;5;43;2.0
8;39;409;411;2;43;2.0
8;40;411;412;1;43;2.0
8;41;412;413;1;43;2.0
8;42;413;414;1;43;2.0
8;43;414;420;6;43;2.0
8;44;420;422;2;43;2.0
8;45;422;425;3;43;2.0
8;46;425;426;1;43;2.0
8;47;426;427;1;43;2.0
8;48;427;428;1;43;2.0
8;49;428;429;1;43;2.0
8;50;429;431;2;43;2.0
8;51;431;435;4;43;2.0
8;52;435;436;1;43;2.0
8;53;436;437;1;43;2.0
8;54;437;443;6;43;2.0
8;55;443;444;1;43;2.0
8;56;444;449;5;43;2.0
8;57;449;450;1;43;2.0
8;58;450;454;4;43;2.0
8;59;454;455;1;43;2.0
8;60;455;457;2;43;2.0
8;61;457;458;1;43;2.0
8;62;458;459;1;43;2.0
8;63;459;464;5;43;2.0
8;64;464;465;1;43;2.0
8;65;465;467;2;43;2.0
8;66;467;469;2;43;2.0
8;67;469;472;3;43;2.0
8;68;472;473;1;43;2.0
8;69;473;474;1;43;2.0
8;70;474;476;2;43;2.0
8;71;476;477;1;43;2.0
8;72;477;486;9;43;2.0
8;73;486;488;2;43;2.0
8;74;488;489;1;43;2.0
8;75;489;491;2;43;2.0
8;76;491;492;1;43;2.0
8;77;492;498;6;43;2.0
8;78;498;499;1;43;2.0
8;79;499;503;4;43;2.0
8;80;503;505;2;43;2.0
8;81;505;506;1;43;2.0
8;82;506;507;1;43;2.0
8;83;507;508;1;43;2.0
8;84;508;517;9;43;2.0
8;85;517;519;2;43;2.0
8;86;519;526;7;43;2.0
8;87;526;529;3;43;2.0
8;88;529;530;1;43;2.0
8;89;530;537;7;43;2.0
8;90;537;541;4;43;2.0
8;91;541;542;1;43;2.0
8;92;542;547;5;43;2.0
8;93;547;548;1;43;2.0
8;94;548;550;2;43;2.0
8;95;550;553;3;43;2.0
8;96;553;554;1;43;2.0
8;97;554;555;1;43;2.0
8;98;555;557;2;43;2.0
8;99;557;570;13;43;2.0
8;100;570;582;12;43;2.0
8;101;582;584;2;43;2.0
8;102;584;585;1;43;2.0
8;103;585;594;9;43;2.0
8;104;594;596;2;43;2.0
8;105;596;597;1;43;2.0
8;106;597;598;1;43;2.0
8;107;598;602;4;43;2.0
8;108;602;619;17;43;2.0
8;109;619;620;1;43;2.0
8;110;620;625;5;43;2.0
8;111;625;627;2;43;2.0
8;112;627;631;4;43;2.0
8;113;631;633;2;43;2.0
8;114;633;634;1;43;2.0
8;115;634;635;1;43;2.0
8;116;635;637;2;43;2.0
8;117;637;655;18;43;2.0
8;118;655;662;7;43;2.0
8;119;662;666;4;43;2.0
8;120;666;667;1;43;2.0
8;121;667;668;1;43;2.0
8;122;668;678;10;43;2.0
8;123;678;686;8;43;2.0
8;124;686;690;4;43;2.0
8;125;690;695;5;43;2.0
8;126;695;701;6;43;2.0
8;127;701;704;3;43;2.0
8;128;704;708;4;43;2.0
8;129;708;712;4;43;2.0
8;130;712;714;2;43;2.0
8;131;714;722;8;43;2.0
8;132;722;725;3;43;2.0
8;133;725;728;3;43;2.0
8;134;728;733;5;43;2.0
8;135;733;736;3;43;2.0
8;136;736;739;3;43;2.0
8;137;739;740;1;43;2.0
8;138;740;752;12;43;2.0
8;139;752;753;1;43;2.0
8;140;753;754;1;43;2.0
8;141;754;757;3;43;2.0
8;142;757;764;7;43;2.0
8;143;764;768;4;43;2.0
8;144;768;770;2;43;2.0
8;145;770;773;3;43;2.0
8;146;773;775;2;43;2.0
8;147;775;776;1;43;2.0
8;148;776;782;6;43;2.0
8;149;782;788;6;43;2.0
8;150;788;790;2;43;2.0
8;151;790;796;6;43;2.0
8;152;796;799;3;43;2.0
8;153;799;800;1;43;2.0
8;154;800;803;3;43;2.0
8;155;803;805;2;43;2.0
8;156;805;813;8;43;2.0
8;157;813;818;5;43;2.0
8;158;818;819;1;43;2.0
8;159;819;823;4;43;2.0
8;160;823;824;1;43;2.0
8;161;824;826;2;43;2.0
8;162;826;827;1;43;2.0
8;163;827;828;1;43;2.0
8;164;828;831;3;43;2.0
8;165;831;832;1;43;2.0
8;166;832;837;5;43;2.0
8;167;837;839;2;43;2.0
8;168;839;840;1;43;2.0
8;169;840;842;2;43;2.0
8;170;842;845;3;43;2.0
8;171;845;846;1;43;2.0
8;172;846;848;2;43;2.0
8;173;848;849;1;43;2.0
8;174;849;855;6;43;2.0
8;175;855;856;1;43;2.0
8;176;856;858;2;43;2.0
8;177;858;860;2;43;2.0
8;178;860;862;2;43;2.0
8;179;862;863;1;43;2.0
8;180;863;868;5;43;2.0
8;181;868;869;1;43;2.0
8;182;869;871;2;43;2.0
8;183;871;872;1;43;2.0
8;184;872;873;1;43;2.0
8;185;873;877;4;43;2.0
8;186;877;878;1;43;2.0
8;187;878;881;3;43;2.0
8;188;881;883;2;43;2.0
8;189;883;884;1;43;2.0
8;190;884;885;1;43;2.0
8;191;885;887;2;43;2.0
8;192;887;888;1;43;2.0
8;193;888;890;2;43;2.0
8;194;890;892;2;43;2.0
8;195;892;895;3;43;2.0
8;196;895;896;1;43;2.0
8;197;896;900;4;43;2.0
8;198;900;901;1;43;2.0
8;199;901;902;1;43;2.0
8;200;902;904;2;43;2.0
8;201;904;907;3;43;2.0
8;202;907;911;4;43;2.0
8;203;911;912;1;43;2.0
8;204;912;913;1;43;2.0
8;205;913;915;2;43;2.0
8;206;915;918;3;43;2.0
8;207;918;919;1;43;2.0
8;208;919;920;1;43;2.0
8;209;920;924;4;43;2.0
8;210;924;925;1;43;2.0
8;211;925;926;1;43;2.0
8;212;926;930;4;43;2.0
8;213;930;932;2;43;2.0
8;214;932;934;2;43;2.0
8;215;934;937;3;43;2.0
8;216;937;940;3;43;2.0
8;217;940;941;1;43;2.0
8;218;941;942;1;43;2.0
8;219;942;944;2;43;2.0
8;220;944;945;1;43;2.0
8;221;945;946;1;43;2.0
8;222;946;948;2;43;2.0
8;223;948;950;2;43;2.0
8;224;950;953;3;43;2.0
8;225;953;955;2;43;2.0
8;226;955;959;4;43;2.0
8;227;959;960;1;43;2.0
8;228;960;961;1;43;2.0
8;229;961;962;1;43;2.0
8;230;962;964;2;43;2.0
8;231;964;966;2;43;2.0
8;232;966;970;4;43;2.0
8;233;970;975;5;43;2.0
8;234;975;978;3;43;2.0
8;235;978;979;1;43;2.0
8;236;979;980;1;43;2.0
8;237;980;982;2;43;2.0
8;238;982;985;3;43;2.0
8;239;985;986;1;43;2.0
8;240;986;997;11;43;2.0
8;241;997;999;2;43;2.0
8;242;999;1000;1;43;2.0
8;243;1000;1003;3;43;2.0
8;244;1003;1004;1;43;2.0
8;245;1004;1006;2;43;2.0
8;246;1006;1008;2;43;2.0
8;247;1008;1010;2;43;2.0
8;248;1010;1014;4;43;2.0
8;249;1014;1018;4;43;2.0
8;250;1018;1020;2;43;2.0
8;251;1020;1023;3;43;2.0
8;252;1023;1024;1;43;2.0
8;253;1024;1025;1;43;2.0
8;254;1025;1026;1;43;2.0
8;255;1026;1027;1;43;2.0
8;256;1027;1029;2;43;2.0
8;257;1029;1038;9;43;2.0
8;258;1038;1040;2;43;2.0
8;259;1040;1044;4;43;2.0
8;260;1044;1047;3;43;2.0
8;261;1047;1049;2;43;2.0
8;262;1049;1050;1;43;2.0
8;263;1050;1064;14;43;2.0
8;264;1064;1065;1;43;2.0
8;265;1065;1066;1;43;2.0
8;266;1066;1069;3;43;2.0
8;267;1069;1070;1;43;2.0
8;268;1070;1073;3;43;2.0
8;269;1073;1079;6;43;2.0
8;270;1079;1081;2;43;2.0
8;271;1081;1082;1;43;2.0
8;272;1082;1083;1;43;2.0
8;273;1083;1086;3;43;2.0
8;274;1086;1087;1;43;2.0
8;275;1087;1089;2;43;2.0
8;276;1089;1090;1;43;2.0
8;277;1090;1094;4;43;2.0
8;278;1094;1098;4;43;2.0
8;279;1098;1102;4;43;2.0
8;280;1102;1105;3;43;2.0
8;281;1105;1108;3;43;2.0
8;282;1108;1116;8;43;2.0
8;283;1116;1118;2;43;2.0
8;284;1118;1121;3;43;2.0
8;285;1121;1130;9;43;2.0
8;286;1130;1135;5;43;2.0
8;287;1135;1139;4;43;2.0
8;288;1139;1142;3;43;2.0
8;289;1142;1144;2;43;2.0
8;290;1144;1148;4;43;2.0
8;291;1148;1155;7;43;2.0
8;292;1155;1156;1;43;2.0
8;293;1156;1165;9;43;2.0
8;294;1165;1175;10;43;2.0
8;295;1175;1181;6;43;2.0
8;296;1181;1182;1;43;2.0
8;297;1182;1206;24;43;2.0
8;298;1206;1208;2;43;2.0
8;299;1208;1210;2;43;2.0
8;300;1210;1217;7;43;2.0
8;301;1217;1219;2;43;2.0
8;302;1219;1225;6;43;2.0
8;303;1225;1228;3;43;2.0
8;304;1228;1256;28;43;2.0
8;305;1256;1264;8;43;2.0
8;306;1264;1268;4;43;2.0
8;307;1268;1269;1;43;2.0
8;308;1269;1277;8;43;2.0
8;309;1277;1285;8;43;2.0
8;310;1285;1286;1;43;2.0
8;311;1286;1296;10;43;2.0
8;312;1296;1309;13;43;2.0
8;313;1309;1312;3;43;2.0
8;314;1312;1318;6;43;2.0
8;315;1318;1329;11;43;2.0
8;316;1329;1331;2;43;2.0
8;317;1331;1338;7;43;2.0
8;318;1338;1340;2;43;2.0
8;319;1340;1342;2;43;2.0
8;320;1342;1343;1;43;2.0
8;321;1343;1349;6;43;2.0
8;322;1349;1351;2;43;2.0
8;323;1351;1358;7;43;2.0
8;324;1358;1360;2;43;2.0
8;325;1360;1367;7;43;2.0
8;326;1367;1370;3;43;2.0
8;327;1370;1373;3;43;2.0
8;328;1373;1374;1;43;2.0
8;329;1374;1382;8;43;2.0
8;330;1382;1384;2;43;2.0
8;331;1384;1388;4;43;2.0
8;332;1388;1390;2;43;2.0
8;333;1390;1399;9;43;2.0
8;334;1399;1414;15;43;2.0
8;335;1414;1429;15;43;2.0
8;336;1429;1444;15;43;2.0
8;337;1444;1459;15;43;2.0
8;338;1459;1474;15;43;2.0
8;339;1474;1489;15;43;2.0
8;340;1489;1504;15;43;2.0
8;341;1504;1519;15;43;2.0
8;342;1519;1534;15;43;2.0
8;343;1534;1549;15;43;2.0
8;344;1549;1564;15;43;2.0
8;345;1564;1579;15;43;2.0
8;346;1579;1594;15;43;2.0
8;347;1594;1609;15;43;2.0
8;348;1609;1624;15;43;2.0
8;349;1624;1639;15;43;2.0
8;350;1639;1654;15;43;2.0
8;351;1654;1669;15;43;2.0
8;352;1669;1680;11;43;2.0
9;0;250;326;76;4;2.0
9;1;326;328;2;4;2.0
9;2;328;331;3;4;2.0
9;3;331;333;2;4;2.0
9;4;333;337;4;4;2.0
9;5;337;338;1;4;2.0
9;6;338;339;1;4;2.0
9;7;339;340;1;4;2.0
9;8;340;341;1;4;2.0
9;9;341;344;3;4;2.0
9;10;344;346;2;4;2.0
9;11;346;347;1;4;2.0
9;12;347;348;1;4;2.0
9;13;348;349;1;4;2.0
9;14;349;351;2;4;2.0
9;15;351;353;2;4;2.0
9;16;353;356;3;4;2.0
9;17;356;357;1;4;2.0
9;18;357;361;4;4;2.0
9;19;361;364;3;4;2.0
9;20;364;366;2;4;2.0
9;21;366;368;2;4;2.0
9;22;368;369;1;4;2.0
9;23;369;371;2;4;2.0
9;24;371;374;3;4;2.0
9;25;374;375;1;4;2.0
9;26;375;376;1;4;2.0
9;27;376;379;3;4;2.0
9;28;379;381;2;4;2.0
9;29;381;386;5;4;2.0
9;30;386;387;1;4;2.0
9;31;387;388;1;4;2.0
9;32;388;390;2;4;2.0
9;33;390;391;1;4;2.0
9;34;391;394;3;4;2.0
9;35;394;396;2;4;2.0
9;36;396;397;1;4;2.0
9;37;397;399;2;4;2.0
9;38;399;401;2;4;2.0
9;39;401;402;1;4;2.0
9;40;402;403;1;4;2.0
9;41;403;404;1;4;2.0
9;42;404;410;6;4;2.0
9;43;410;414;4;4;2.0
9;44;414;416;2;4;2.0
9;45;416;417;1;4;2.0
9;46;417;419;2;4;2.0
9;47;419;420;1;4;2.0
9;48;420;422;2;4;2.0
9;49;422;424;2;4;2.0
9;50;424;426;2;4;2.0
9;51;426;427;1;4;2.0
9;52;427;428;1;4;2.0
9;53;428;431;3;4;2.0
9;54;431;433;2;4;2.0
9;55;433;434;1;4;2.0
9;56;434;435;1;4;2.0
9;57;435;438;3;4;2.0
9;58;438;441;3;4;2.0
9;59;441;446;5;4;2.0
9;60;446;448;2;4;2.0
9;61;448;449;1;4;2.0
9;62;449;450;1;4;2.0
9;63;450;451;1;4;2.0
9;64;451;454;3;4;2.0
9;65;454;456;2;4;2.0
9;66;456;457;1;4;2.0
9;67;457;458;1;4;2.0
9;68;458;459;1;4;2.0
9;69;459;461;2;4;2.0
9;70;461;463;2;4;2.0
9;71;463;466;3;4;2.0
9;72;466;467;1;4;2.0
9;73;467;469;2;4;2.0
9;74;469;471;2;4;2.0
9;75;471;473;2;4;2.0
9;76;473;476;3;4;2.0
9;77;476;477;1;4;2.0
9;78;477;478;1;4;2.0
9;79;478;479;1;4;2.0
9;80;479;482;3;4;2.0
9;81;482;485;3;4;2.0
9;82;485;486;1;4;2.0
9;83;486;489;3;4;2.0
9;84;489;491;2;4;2.0
9;85;491;498;7;4;2.0
9;86;498;503;5;4;2.0
9;87;503;504;1;4;2.0
9;88;504;507;3;4;2.0
9;89;507;508;1;4;2.0
9;90;508;511;3;4;2.0
9;91;511;517;6;4;2.0
9;92;517;519;2;4;2.0
9;93;519;520;1;4;2.0
9;94;520;531;11;4;2.0
9;95;531;534;3;4;2.0
9;96;534;537;3;4;2.0
9;97;537;539;2;4;2.0
9;98;539;541;2;4;2.0
9;99;541;543;2;4;2.0
9;100;543;547;4;4;2.0
9;101;547;552;5;4;2.0
9;102;552;553;1;4;2.0
9;103;553;554;1;4;2.0
9;104;554;556;2;4;2.0
9;105;556;559;3;4;2.0
9;106;559;573;14;4;2.0
9;107;573;578;5;4;2.0
9;108;578;586;8;4;2.0
9;109;586;587;1;4;2.0
9;110;587;589;2;4;2.0
9;111;589;591;2;4;2.0
9;112;591;594;3;4;2.0
9;113;594;597;3;4;2.0
9;114;597;598;1;4;2.0
9;115;598;621;23;4;2.0
9;116;621;622;1;4;2.0
9;117;622;623;1;4;2.0
9;118;623;624;1;4;2.0
9;119;624;631;7;4;2.0
9;120;631;634;3;4;2.0
9;121;634;635;1;4;2.0
9;122;635;639;4;4;2.0
9;123;639;656;17;4;2.0
9;124;656;657;1;4;2.0
9;125;657;661;4;4;2.0
9;126;661;666;5;4;2.0
9;127;666;679;13;4;2.0
9;128;679;687;8;4;2.0
9;129;687;692;5;4;2.0
9;130;692;698;6;4;2.0
9;131;698;699;1;4;2.0
9;132;699;701;2;4;2.0
9;133;701;709;8;4;2.0
9;134;709;716;7;4;2.0
9;135;716;717;1;4;2.0
9;136;717;718;1;4;2.0
9;137;718;722;4;4;2.0
9;138;722;724;2;4;2.0
9;139;724;727;3;4;2.0
9;140;727;731;4;4;2.0
9;141;731;741;10;4;2.0
9;142;741;744;3;4;2.0
9;143;744;746;2;4;2.0
9;144;746;754;8;4;2.0
9;145;754;755;1;4;2.0
9;146;755;759;4;4;2.0
9;147;759;761;2;4;2.0
9;148;761;767;6;4;2.0
9;149;767;769;2;4;2.0
9;150;769;777;8;4;2.0
9;151;777;781;4;4;2.0
9;152;781;782;1;4;2.0
9;153;782;787;5;4;2.0
9;154;787;788;1;4;2.0
9;155;788;792;4;4;2.0
9;156;792;798;6;4;2.0
9;157;798;801;3;4;2.0
9;158;801;804;3;4;2.0
9;159;804;806;2;4;2.0
9;160;806;811;5;4;2.0
9;161;811;813;2;4;2.0
9;162;813;817;4;4;2.0
9;163;817;818;1;4;2.0
9;164;818;819;1;4;2.0
9;165;819;821;2;4;2.0
9;166;821;823;2;4;2.0
9;167;823;824;1;4;2.0
9;168;824;829;5;4;2.0
9;169;829;834;5;4;2.0
9;170;834;835;1;4;2.0
9;171;835;837;2;4;2.0
9;172;837;838;1;4;2.0
9;173;838;843;5;4;2.0
9;174;843;847;4;4;2.0
9;175;847;848;1;4;2.0
9;176;848;853;5;4;2.0
9;177;853;854;1;4;2.0
9;178;854;856;2;4;2.0
9;179;856;858;2;4;2.0
9;180;858;861;3;4;2.0
9;181;861;862;1;4;2.0
9;182;862;864;2;4;2.0
9;183;864;866;2;4;2.0
9;184;866;871;5;4;2.0
9;185;871;872;1;4;2.0
9;186;872;874;2;4;2.0
9;187;874;875;1;4;2.0
9;188;875;877;2;4;2.0
9;189;877;878;1;4;2.0
9;190;878;879;1;4;2.0
9;191;879;884;5;4;2.0
9;192;884;887;3;4;2.0
9;193;887;888;1;4;2.0
9;194;888;889;1;4;2.0
9;195;889;891;2;4;2.0
9;196;891;892;1;4;2.0
9;197;892;893;1;4;2.0
9;198;893;897;4;4;2.0
9;199;897;901;4;4;2.0
9;200;901;902;1;4;2.0
9;201;902;905;3;4;2.0
9;202;905;907;2;4;2.0
9;203;907;908;1;4;2.0
9;204;908;909;1;4;2.0
9;205;909;913;4;4;2.0
9;206;913;916;3;4;2.0
9;207;916;917;1;4;2.0
9;208;917;918;1;4;2.0
9;209;918;921;3;4;2.0
9;210;921;924;3;4;2.0
9;211;924;929;5;4;2.0
9;212;929;931;2;4;2.0
9;213;931;932;1;4;2.0
9;214;932;933;1;4;2.0
9;215;933;935;2;4;2.0
9;216;935;937;2;4;2.0
9;217;937;939;2;4;2.0
9;218;939;942;3;4;2.0
9;219;942;946;4;4;2.0
9;220;946;947;1;4;2.0
9;221;947;948;1;4;2.0
9;222;948;949;1;4;2.0
9;223;949;953;4;4;2.0
9;224;953;957;4;4;2.0
9;225;957;961;4;4;2.0
9;226;961;962;1;4;2.0
9;227;962;964;2;4;2.0
9;228;964;965;1;4;2.0
9;229;965;967;2;4;2.0
9;230;967;968;1;4;2.0
9;231;968;969;1;4;2.0
9;232;969;970;1;4;2.0
9;233;970;973;3;4;2.0
9;234;973;976;3;4;2.0
9;235;976;977;1;4;2.0
9;236;977;981;4;4;2.0
9;237;981;982;1;4;2.0
9;238;982;984;2;4;2.0
9;239;984;985;1;4;2.0
9;240;985;986;1;4;2.0
9;241;986;997;11;4;2.0
9;242;997;998;1;4;2.0
9;243;998;999;1;4;2.0
9;244;999;1004;5;4;2.0
9;245;1004;1005;1;4;2.0
9;246;1005;1006;1;4;2.0
9;247;1006;1007;1;4;2.0
9;248;1007;1008;1;4;2.0
9;249;1008;1013;5;4;2.0
9;250;1013;1017;4;4;2.0
9;251;1017;1018;1;4;2.0
9;252;1018;1021;3;4;2.0
9;253;1021;1025;4;4;2.0
9;254;1025;1026;1;4;2.0
9;255;1026;1027;1;4;2.0
9;256;1027;1028;1;4;2.0
9;257;1028;1029;1;4;2.0
9;258;1029;1034;5;4;2.0
9;259;1034;1037;3;4;2.0
9;260;1037;1038;1;4;2.0
9;261;1038;1043;5;4;2.0
9;262;1043;1047;4;4;2.0
9;263;1047;1050;3;4;2.0
9;264;1050;1051;1;4;2.0
9;265;1051;1053;2;4;2.0
9;266;1053;1054;1;4;2.0
9;267;1054;1057;3;4;2.0
9;268;1057;1061;4;4;2.0
9;269;1061;1062;1;4;2.0
9;270;1062;1067;5;4;2.0
9;271;1067;1068;1;4;2.0
9;272;1068;1074;6;4;2.0
9;273;1074;1076;2;4;2.0
9;274;1076;1077;1;4;2.0
9;275;1077;1078;1;4;2.0
9;276;1078;1082;4;4;2.0
9;277;1082;1086;4;4;2.0
9;278;1086;1087;1;4;2.0
9;279;1087;1091;4;4;2.0
9;280;1091;1094;3;4;2.0
9;281;1094;1099;5;4;2.0
9;282;1099;1100;1;4;2.0
9;283;1100;1102;2;4;2.0
9;284;1102;1104;2;4;2.0
9;285;1104;1105;1;4;2.0
9;286;1105;1106;1;4;2.0
9;287;1106;1109;3;4;2.0
9;288;1109;1117;8;4;2.0
9;289;1117;1119;2;4;2.0
9;290;1119;1127;8;4;2.0
9;291;1127;1132;5;4;2.0
9;292;1132;1133;1;4;2.0
9;293;1133;1147;14;4;2.0
9;294;1147;1152;5;4;2.0
9;295;1152;1153;1;4;2.0
9;296;1153;1156;3;4;2.0
9;297;1156;1173;17;4;2.0
9;298;1173;1175;2;4;2.0
9;299;1175;1177;2;4;2.0
9;300;1177;1182;5;4;2.0
9;301;1182;1187;5;4;2.0
9;302;1187;1194;7;4;2.0
9;303;1194;1208;14;4;2.0
9;304;1208;1211;3;4;2.0
9;305;1211;1213;2;4;2.0
9;306;1213;1224;11;4;2.0
9;307;1224;1225;1;4;2.0
9;308;1225;1229;4;4;2.0
9;309;1229;1237;8;4;2.0
9;310;1237;1257;20;4;2.0
9;311;1257;1262;5;4;2.0
9;312;1262;1264;2;4;2.0
9;313;1264;1268;4;4;2.0
9;314;1268;1269;1;4;2.0
9;315;1269;1272;3;4;2.0
9;316;1272;1273;1;4;2.0
9;317;1273;1285;12;4;2.0
9;318;1285;1287;2;4;2.0
9;319;1287;1297;10;4;2.0
9;320;1297;1302;5;4;2.0
9;321;1302;1305;3;4;2.0
9;322;1305;1314;9;4;2.0
9;323;1314;1317;3;4;2.0
9;324;1317;1318;1;4;2.0
9;325;1318;1322;4;4;2.0
9;326;1322;1323;1;4;2.0
9;327;1323;1337;14;4;2.0
9;328;1337;1338;1;4;2.0
9;329;1338;1342;4;4;2.0
9;330;1342;1346;4;4;2.0
9;331;1346;1350;4;4;2.0
9;332;1350;1359;9;4;2.0
9;333;1359;1363;4;4;2.0
9;334;1363;1366;3;4;2.0
9;335;1366;1367;1;4;2.0
9;336;1367;1368;1;4;2.0
9;337;1368;1371;3;4;2.0
9;338;1371;1372;1;4;2.0
9;339;1372;1373;1;4;2.0
9;340;1373;1374;1;4;2.0
9;341;1374;1385;11;4;2.0
9;342;1385;1387;2;4;2.0
9;343;1387;1390;3;4;2.0
9;344;1390;1392;2;4;2.0
9;345;1392;1400;8;4;2.0
9;346;1400;1415;15;4;2.0
9;347;1415;1430;15;4;2.0
9;348;1430;1445;15;4;2.0
9;349;1445;1460;15;4;2.0
9;350;1460;1475;15;4;2.0
9;351;1475;1490;15;4;2.0
9;352;1490;1505;15;4;2.0
9;353;1505;1520;15;4;2.0
9;354;1520;1535;15;4;2.0
9;355;1535;1550;15;4;2.0
9;356;1550;1565;15;4;2.0
9;357;1565;1580;15;4;2.0
9;358;1580;1595;15;4;2.0
9;359;1595;1610;15;4;2.0
9;360;1610;1625;15;4;2.0
9;361;1625;1640;15;4;2.0
9;362;1640;1655;15;4;2.0
9;363;1655;1670;15;4;2.0
9;364;1670;1680;10;4;2.0
10;0;252;326;74;11;2.0
10;1;326;332;6;11;2.0
10;2;332;335;3;11;2.0
10;3;335;337;2;11;2.0
10;4;337;338;1;11;2.0
10;5;338;339;1;11;2.0
10;6;339;343;4;11;2.0
10;7;343;344;1;11;2.0
10;8;344;347;3;11;2.0
10;9;347;348;1;11;2.0
10;10;348;352;4;11;2.0
10;11;352;354;2;11;2.0
10;12;354;357;3;11;2.0
10;13;357;358;1;11;2.0
10;14;358;359;1;11;2.0
10;15;359;362;3;11;2.0
10;16;362;364;2;11;2.0
10;17;364;367;3;11;2.0
10;18;367;368;1;11;2.0
10;19;368;369;1;11;2.0
10;20;369;371;2;11;2.0
10;21;371;373;2;11;2.0
10;22;373;376;3;11;2.0
10;23;376;377;1;11;2.0
10;24;377;378;1;11;2.0
10;25;378;387;9;11;2.0
10;26;387;388;1;11;2.0
10;27;388;389;1;11;2.0
10;28;389;390;1;11;2.0
10;29;390;393;3;11;2.0
10;30;393;396;3;11;2.0
10;31;396;397;1;11;2.0
10;32;397;398;1;11;2.0
10;33;398;399;1;11;2.0
10;34;399;402;3;11;2.0
10;35;402;404;2;11;2.0
10;36;404;408;4;11;2.0
10;37;408;410;2;11;2.0
10;38;410;412;2;11;2.0
10;39;412;414;2;11;2.0
10;40;414;417;3;11;2.0
10;41;417;420;3;11;2.0
10;42;420;421;1;11;2.0
10;43;421;422;1;11;2.0
10;44;422;423;1;11;2.0
10;45;423;426;3;11;2.0
10;46;426;427;1;11;2.0
10;47;427;428;1;11;2.0
10;48;428;429;1;11;2.0
10;49;429;431;2;11;2.0
10;50;431;435;4;11;2.0
10;51;435;437;2;11;2.0
10;52;437;438;1;11;2.0
10;53;438;442;4;11;2.0
10;54;442;443;1;11;2.0
10;55;443;444;1;11;2.0
10;56;444;450;6;11;2.0
10;57;450;452;2;11;2.0
10;58;452;453;1;11;2.0
10;59;453;454;1;11;2.0
10;60;454;456;2;11;2.0
10;61;456;457;1;11;2.0
10;62;457;458;1;11;2.0
10;63;458;459;1;11;2.0
10;64;459;463;4;11;2.0
10;65;463;467;4;11;2.0
10;66;467;468;1;11;2.0
10;67;468;470;2;11;2.0
10;68;470;473;3;11;2.0
10;69;473;474;1;11;2.0
10;70;474;477;3;11;2.0
10;71;477;478;1;11;2.0
10;72;478;482;4;11;2.0
10;73;482;486;4;11;2.0
10;74;486;487;1;11;2.0
10;75;487;489;2;11;2.0
10;76;489;492;3;11;2.0
10;77;492;493;1;11;2.0
10;78;493;497;4;11;2.0
10;79;497;498;1;11;2.0
10;80;498;499;1;11;2.0
10;81;499;504;5;11;2.0
10;82;504;505;1;11;2.0
10;83;505;507;2;11;2.0
10;84;507;509;2;11;2.0
10;85;509;515;6;11;2.0
10;86;515;518;3;11;2.0
10;87;518;520;2;11;2.0
10;88;520;527;7;11;2.0
10;89;527;528;1;11;2.0
10;90;528;531;3;11;2.0
10;91;531;537;6;11;2.0
10;92;537;542;5;11;2.0
10;93;542;543;1;11;2.0
10;94;543;548;5;11;2.0
10;95;548;549;1;11;2.0
10;96;549;554;5;11;2.0
10;97;554;555;1;11;2.0
10;98;555;558;3;11;2.0
10;99;558;574;16;11;2.0
10;100;574;577;3;11;2.0
10;101;577;583;6;11;2.0
10;102;583;590;7;11;2.0
10;103;590;597;7;11;2.0
10;104;597;598;1;11;2.0
10;105;598;599;1;11;2.0
10;106;599;600;1;11;2.0
10;107;600;603;3;11;2.0
10;108;603;617;14;11;2.0
10;109;617;619;2;11;2.0
10;110;619;621;2;11;2.0
10;111;621;632;11;11;2.0
10;112;632;633;1;11;2.0
10;113;633;634;1;11;2.0
10;114;634;635;1;11;2.0
10;115;635;638;3;11;2.0
10;116;638;647;9;11;2.0
10;117;647;662;15;11;2.0
10;118;662;663;1;11;2.0
10;119;663;667;4;11;2.0
10;120;667;668;1;11;2.0
10;121;668;675;7;11;2.0
10;122;675;679;4;11;2.0
10;123;679;687;8;11;2.0
10;124;687;694;7;11;2.0
10;125;694;702;8;11;2.0
10;126;702;703;1;11;2.0
10;127;703;709;6;11;2.0
10;128;709;717;8;11;2.0
10;129;717;720;3;11;2.0
10;130;720;723;3;11;2.0
10;131;723;729;6;11;2.0
10;132;729;733;4;11;2.0
10;133;733;737;4;11;2.0
10;134;737;739;2;11;2.0
10;135;739;741;2;11;2.0
10;136;741;752;11;11;2.0
10;137;752;754;2;11;2.0
10;138;754;755;1;11;2.0
10;139;755;763;8;11;2.0
10;140;763;765;2;11;2.0
10;141;765;767;2;11;2.0
10;142;767;769;2;11;2.0
10;143;769;771;2;11;2.0
10;144;771;774;3;11;2.0
10;145;774;777;3;11;2.0
10;146;777;783;6;11;2.0
10;147;783;789;6;11;2.0
10;148;789;794;5;11;2.0
10;149;794;797;3;11;2.0
10;150;797;798;1;11;2.0
10;151;798;801;3;11;2.0
10;152;801;803;2;11;2.0
10;153;803;804;1;11;2.0
10;154;804;806;2;11;2.0
10;155;806;807;1;11;2.0
10;156;807;814;7;11;2.0
10;157;814;819;5;11;2.0
10;158;819;823;4;11;2.0
10;159;823;824;1;11;2.0
10;160;824;825;1;11;2.0
10;161;825;827;2;11;2.0
10;162;827;828;1;11;2.0
10;163;828;829;1;11;2.0
10;164;829;838;9;11;2.0
10;165;838;839;1;11;2.0
10;166;839;840;1;11;2.0
10;167;840;841;1;11;2.0
10;168;841;843;2;11;2.0
10;169;843;845;2;11;2.0
10;170;845;847;2;11;2.0
10;171;847;848;1;11;2.0
10;172;848;849;1;11;2.0
10;173;849;854;5;11;2.0
10;174;854;857;3;11;2.0
10;175;857;858;1;11;2.0
10;176;858;861;3;11;2.0
10;177;861;863;2;11;2.0
10;178;863;864;1;11;2.0
10;179;864;868;4;11;2.0
10;180;868;869;1;11;2.0
10;181;869;870;1;11;2.0
10;182;870;872;2;11;2.0
10;183;872;873;1;11;2.0
10;184;873;877;4;11;2.0
10;185;877;879;2;11;2.0
10;186;879;883;4;11;2.0
10;187;883;884;1;11;2.0
10;188;884;887;3;11;2.0
10;189;887;888;1;11;2.0
10;190;888;889;1;11;2.0
10;191;889;890;1;11;2.0
10;192;890;891;1;11;2.0
10;193;891;893;2;11;2.0
10;194;893;896;3;11;2.0
10;195;896;897;1;11;2.0
10;196;897;903;6;11;2.0
10;197;903;904;1;11;2.0
10;198;904;905;1;11;2.0
10;199;905;908;3;11;2.0
10;200;908;909;1;11;2.0
10;201;909;912;3;11;2.0
10;202;912;914;2;11;2.0
10;203;914;916;2;11;2.0
10;204;916;917;1;11;2.0
10;205;917;918;1;11;2.0
10;206;918;919;1;11;2.0
10;207;919;921;2;11;2.0
10;208;921;924;3;11;2.0
10;209;924;926;2;11;2.0
10;210;926;927;1;11;2.0
10;211;927;931;4;11;2.0
10;212;931;932;1;11;2.0
10;213;932;933;1;11;2.0
10;214;933;935;2;11;2.0
10;215;935;937;2;11;2.0
10;216;937;943;6;11;2.0
10;217;943;946;3;11;2.0
10;218;946;947;1;11;2.0
10;219;947;949;2;11;2.0
10;220;949;950;1;11;2.0
10;221;950;951;1;11;2.0
10;222;951;953;2;11;2.0
10;223;953;958;5;11;2.0
10;224;958;963;5;11;2.0
10;225;963;964;1;11;2.0
10;226;964;965;1;11;2.0
10;227;965;967;2;11;2.0
10;228;967;969;2;11;2.0
10;229;969;971;2;11;2.0
10;230;971;976;5;11;2.0
10;231;976;978;2;11;2.0
10;232;978;979;1;11;2.0
10;233;979;981;2;11;2.0
10;234;981;983;2;11;2.0
10;235;983;986;3;11;2.0
10;236;986;987;1;11;2.0
10;237;987;992;5;11;2.0
10;238;992;998;6;11;2.0
10;239;998;1004;6;11;2.0
10;240;1004;1005;1;11;2.0
10;241;1005;1006;1;11;2.0
10;242;1006;1007;1;11;2.0
10;243;1007;1009;2;11;2.0
10;244;1009;1010;1;11;2.0
10;245;1010;1011;1;11;2.0
10;246;1011;1014;3;11;2.0
10;247;1014;1015;1;11;2.0
10;248;1015;1019;4;11;2.0
10;249;1019;1021;2;11;2.0
10;250;1021;1025;4;11;2.0
10;251;1025;1026;1;11;2.0
10;252;1026;1027;1;11;2.0
10;253;1027;1028;1;11;2.0
10;254;1028;1034;6;11;2.0
10;255;1034;1036;2;11;2.0
10;256;1036;1038;2;11;2.0
10;257;1038;1041;3;11;2.0
10;258;1041;1044;3;11;2.0
10;259;1044;1048;4;11;2.0
10;260;1048;1051;3;11;2.0
10;261;1051;1057;6;11;2.0
10;262;1057;1066;9;11;2.0
10;263;1066;1067;1;11;2.0
10;264;1067;1068;1;11;2.0
10;265;1068;1070;2;11;2.0
10;266;1070;1071;1;11;2.0
10;267;1071;1073;2;11;2.0
10;268;1073;1082;9;11;2.0
10;269;1082;1084;2;11;2.0
10;270;1084;1086;2;11;2.0
10;271;1086;1087;1;11;2.0
10;272;1087;1088;1;11;2.0
10;273;1088;1089;1;11;2.0
10;274;1089;1091;2;11;2.0
10;275;1091;1099;8;11;2.0
10;276;1099;1103;4;11;2.0
10;277;1103;1106;3;11;2.0
10;278;1106;1109;3;11;2.0
10;279;1109;1113;4;11;2.0
10;280;1113;1116;3;11;2.0
10;281;1116;1119;3;11;2.0
10;282;1119;1131;12;11;2.0
10;283;1131;1143;12;11;2.0
10;284;1143;1145;2;11;2.0
10;285;1145;1147;2;11;2.0
10;286;1147;1154;7;11;2.0
10;287;1154;1156;2;11;2.0
10;288;1156;1157;1;11;2.0
10;289;1157;1173;16;11;2.0
10;290;1173;1176;3;11;2.0
10;291;1176;1182;6;11;2.0
10;292;1182;1183;1;11;2.0
10;293;1183;1206;23;11;2.0
10;294;1206;1207;1;11;2.0
10;295;1207;1211;4;11;2.0
10;296;1211;1218;7;11;2.0
10;297;1218;1219;1;11;2.0
10;298;1219;1226;7;11;2.0
10;299;1226;1229;3;11;2.0
10;300;1229;1233;4;11;2.0
10;301;1233;1248;15;11;2.0
10;302;1248;1265;17;11;2.0
10;303;1265;1267;2;11;2.0
10;304;1267;1269;2;11;2.0
10;305;1269;1270;1;11;2.0
10;306;1270;1274;4;11;2.0
10;307;1274;1278;4;11;2.0
10;308;1278;1286;8;11;2.0
10;309;1286;1287;1;11;2.0
10;310;1287;1288;1;11;2.0
10;311;1288;1293;5;11;2.0
10;312;1293;1310;17;11;2.0
10;313;1310;1313;3;11;2.0
10;314;1313;1317;4;11;2.0
10;315;1317;1329;12;11;2.0
10;316;1329;1330;1;11;2.0
10;317;1330;1332;2;11;2.0
10;318;1332;1339;7;11;2.0
10;319;1339;1341;2;11;2.0
10;320;1341;1343;2;11;2.0
10;321;1343;1350;7;11;2.0
10;322;1350;1352;2;11;2.0
10;323;1352;1359;7;11;2.0
10;324;1359;1368;9;11;2.0
10;325;1368;1371;3;11;2.0
10;326;1371;1374;3;11;2.0
10;327;1374;1375;1;11;2.0
10;328;1375;1381;6;11;2.0
10;329;1381;1383;2;11;2.0
10;330;1383;1385;2;11;2.0
10;331;1385;1391;6;11;2.0
10;332;1391;1394;3;11;2.0
10;333;1394;1400;6;11;2.0
10;334;1400;1415;15;11;2.0
10;335;1415;1430;15;11;2.0
10;336;1430;1445;15;11;2.0
10;337;1445;1460;15;11;2.0
10;338;1460;1475;15;11;2.0
10;339;1475;1490;15;11;2.0
10;340;1490;1505;15;11;2.0
10;341;1505;1520;15;11;2.0
10;342;1520;1535;15;11;2.0
10;343;1535;1550;15;11;2.0
10;344;1550;1565;15;11;2.0
10;345;1565;1580;15;11;2.0
10;346;1580;1595;15;11;2.0
10;347;1595;1610;15;11;2.0
10;348;1610;1625;15;11;2.0
10;349;1625;1640;15;11;2.0
10;350;1640;1655;15;11;2.0
10;351;1655;1680;25;11;2.0
11;0;250;334;84;87;2.0
11;1;334;335;1;87;2.0
11;2;335;340;5;87;2.0
11;3;340;341;1;87;2.0
11;4;341;343;2;87;2.0
11;5;343;344;1;87;2.0
11;6;344;345;1;87;2.0
11;7;345;346;1;87;2.0
11;8;346;350;4;87;2.0
11;9;350;354;4;87;2.0
11;10;354;355;1;87;2.0
11;11;355;357;2;87;2.0
11;12;357;358;1;87;2.0
11;13;358;359;1;87;2.0
11;14;359;361;2;87;2.0
11;15;361;364;3;87;2.0
11;16;364;366;2;87;2.0
11;17;366;369;3;87;2.0
11;18;369;370;1;87;2.0
11;19;370;371;1;87;2.0
11;20;371;372;1;87;2.0
11;21;372;373;1;87;2.0
11;22;373;377;4;87;2.0
11;23;377;381;4;87;2.0
11;24;381;386;5;87;2.0
11;25;386;391;5;87;2.0
11;26;391;393;2;87;2.0
11;27;393;394;1;87;2.0
11;28;394;397;3;87;2.0
11;29;397;399;2;87;2.0
11;30;399;400;1;87;2.0
11;31;400;401;1;87;2.0
11;32;401;403;2;87;2.0
11;33;403;408;5;87;2.0
11;34;408;409;1;87;2.0
11;35;409;414;5;87;2.0
11;36;414;415;1;87;2.0
11;37;415;416;1;87;2.0
11;38;416;420;4;87;2.0
11;39;420;421;1;87;2.0
11;40;421;424;3;87;2.0
11;41;424;426;2;87;2.0
11;42;426;428;2;87;2.0
11;43;428;429;1;87;2.0
11;44;429;430;1;87;2.0
11;45;430;431;1;87;2.0
11;46;431;434;3;87;2.0
11;47;434;436;2;87;2.0
11;48;436;437;1;87;2.0
11;49;437;441;4;87;2.0
11;50;441;442;1;87;2.0
11;51;442;443;1;87;2.0
11;52;443;445;2;87;2.0
11;53;445;447;2;87;2.0
11;54;447;451;4;87;2.0
11;55;451;453;2;87;2.0
11;56;453;454;1;87;2.0
11;57;454;456;2;87;2.0
11;58;456;459;3;87;2.0
11;59;459;460;1;87;2.0
11;60;460;461;1;87;2.0
11;61;461;462;1;87;2.0
11;62;462;463;1;87;2.0
11;63;463;464;1;87;2.0
11;64;464;471;7;87;2.0
11;65;471;474;3;87;2.0
11;66;474;475;1;87;2.0
11;67;475;477;2;87;2.0
11;68;477;480;3;87;2.0
11;69;480;482;2;87;2.0
11;70;482;484;2;87;2.0
11;71;484;486;2;87;2.0
11;72;486;489;3;87;2.0
11;73;489;490;1;87;2.0
11;74;490;492;2;87;2.0
11;75;492;493;1;87;2.0
11;76;493;505;12;87;2.0
11;77;505;506;1;87;2.0
11;78;506;511;5;87;2.0
11;79;511;513;2;87;2.0
11;80;513;515;2;87;2.0
11;81;515;517;2;87;2.0
11;82;517;524;7;87;2.0
11;83;524;525;1;87;2.0
11;84;525;535;10;87;2.0
11;85;535;536;1;87;2.0
11;86;536;540;4;87;2.0
11;87;540;543;3;87;2.0
11;88;543;546;3;87;2.0
11;89;546;548;2;87;2.0
11;90;548;551;3;87;2.0
11;91;551;554;3;87;2.0
11;92;554;557;3;87;2.0
11;93;557;558;1;87;2.0
11;94;558;560;2;87;2.0
11;95;560;562;2;87;2.0
11;96;562;565;3;87;2.0
11;97;565;580;15;87;2.0
11;98;580;584;4;87;2.0
11;99;584;591;7;87;2.0
11;100;591;594;3;87;2.0
11;101;594;597;3;87;2.0
11;102;597;598;1;87;2.0
11;103;598;600;2;87;2.0
11;104;600;604;4;87;2.0
11;105;604;608;4;87;2.0
11;106;608;625;17;87;2.0
11;107;625;628;3;87;2.0
11;108;628;629;1;87;2.0
11;109;629;631;2;87;2.0
11;110;631;637;6;87;2.0
11;111;637;638;1;87;2.0
11;112;638;639;1;87;2.0
11;113;639;641;2;87;2.0
11;114;641;645;4;87;2.0
11;115;645;660;15;87;2.0
11;116;660;664;4;87;2.0
11;117;664;667;3;87;2.0
11;118;667;668;1;87;2.0
11;119;668;680;12;87;2.0
11;120;680;685;5;87;2.0
11;121;685;691;6;87;2.0
11;122;691;699;8;87;2.0
11;123;699;704;5;87;2.0
11;124;704;706;2;87;2.0
11;125;706;707;1;87;2.0
11;126;707;711;4;87;2.0
11;127;711;720;9;87;2.0
11;128;720;728;8;87;2.0
11;129;728;729;1;87;2.0
11;130;729;730;1;87;2.0
11;131;730;733;3;87;2.0
11;132;733;734;1;87;2.0
11;133;734;737;3;87;2.0
11;134;737;745;8;87;2.0
11;135;745;748;3;87;2.0
11;136;748;758;10;87;2.0
11;137;758;759;1;87;2.0
11;138;759;764;5;87;2.0
11;139;764;766;2;87;2.0
11;140;766;771;5;87;2.0
11;141;771;774;3;87;2.0
11;142;774;775;1;87;2.0
11;143;775;780;5;87;2.0
11;144;780;787;7;87;2.0
11;145;787;789;2;87;2.0
11;146;789;794;5;87;2.0
11;147;794;795;1;87;2.0
11;148;795;803;8;87;2.0
11;149;803;804;1;87;2.0
11;150;804;805;1;87;2.0
11;151;805;806;1;87;2.0
11;152;806;808;2;87;2.0
11;153;808;809;1;87;2.0
11;154;809;810;1;87;2.0
11;155;810;815;5;87;2.0
11;156;815;817;2;87;2.0
11;157;817;824;7;87;2.0
11;158;824;825;1;87;2.0
11;159;825;826;1;87;2.0
11;160;826;828;2;87;2.0
11;161;828;830;2;87;2.0
11;162;830;831;1;87;2.0
11;163;831;833;2;87;2.0
11;164;833;834;1;87;2.0
11;165;834;840;6;87;2.0
11;166;840;842;2;87;2.0
11;167;842;844;2;87;2.0
11;168;844;845;1;87;2.0
11;169;845;846;1;87;2.0
11;170;846;849;3;87;2.0
11;171;849;854;5;87;2.0
11;172;854;856;2;87;2.0
11;173;856;858;2;87;2.0
11;174;858;860;2;87;2.0
11;175;860;864;4;87;2.0
11;176;864;865;1;87;2.0
11;177;865;867;2;87;2.0
11;178;867;868;1;87;2.0
11;179;868;869;1;87;2.0
11;180;869;870;1;87;2.0
11;181;870;873;3;87;2.0
11;182;873;876;3;87;2.0
11;183;876;879;3;87;2.0
11;184;879;880;1;87;2.0
11;185;880;881;1;87;2.0
11;186;881;883;2;87;2.0
11;187;883;886;3;87;2.0
11;188;886;888;2;87;2.0
11;189;888;889;1;87;2.0
11;190;889;891;2;87;2.0
11;191;891;892;1;87;2.0
11;192;892;894;2;87;2.0
11;193;894;897;3;87;2.0
11;194;897;898;1;87;2.0
11;195;898;899;1;87;2.0
11;196;899;900;1;87;2.0
11;197;900;907;7;87;2.0
11;198;907;909;2;87;2.0
11;199;909;911;2;87;2.0
11;200;911;914;3;87;2.0
11;201;914;916;2;87;2.0
11;202;916;918;2;87;2.0
11;203;918;919;1;87;2.0
11;204;919;920;1;87;2.0
11;205;920;924;4;87;2.0
11;206;924;925;1;87;2.0
11;207;925;926;1;87;2.0
11;208;926;927;1;87;2.0
11;209;927;933;6;87;2.0
11;210;933;935;2;87;2.0
11;211;935;937;2;87;2.0
11;212;937;939;2;87;2.0
11;213;939;943;4;87;2.0
11;214;943;944;1;87;2.0
11;215;944;946;2;87;2.0
11;216;946;947;1;87;2.0
11;217;947;949;2;87;2.0
11;218;949;951;2;87;2.0
11;219;951;952;1;87;2.0
11;220;952;953;1;87;2.0
11;221;953;958;5;87;2.0
11;222;958;959;1;87;2.0
11;223;959;964;5;87;2.0
11;224;964;966;2;87;2.0
11;225;966;967;1;87;2.0
11;226;967;969;2;87;2.0
11;227;969;974;5;87;2.0
11;228;974;976;2;87;2.0
11;229;976;977;1;87;2.0
11;230;977;978;1;87;2.0
11;231;978;979;1;87;2.0
11;232;979;980;1;87;2.0
11;233;980;984;4;87;2.0
11;234;984;985;1;87;2.0
11;235;985;986;1;87;2.0
11;236;986;987;1;87;2.0
11;237;987;989;2;87;2.0
11;238;989;990;1;87;2.0
11;239;990;992;2;87;2.0
11;240;992;1004;12;87;2.0
11;241;1004;1006;2;87;2.0
11;242;1006;1008;2;87;2.0
11;243;1008;1009;1;87;2.0
11;244;1009;1012;3;87;2.0
11;245;1012;1018;6;87;2.0
11;246;1018;1024;6;87;2.0
11;247;1024;1025;1;87;2.0
11;248;1025;1029;4;87;2.0
11;249;1029;1030;1;87;2.0
11;250;1030;1033;3;87;2.0
11;251;1033;1034;1;87;2.0
11;252;1034;1035;1;87;2.0
11;253;1035;1036;1;87;2.0
11;254;1036;1038;2;87;2.0
11;255;1038;1042;4;87;2.0
11;256;1042;1044;2;87;2.0
11;257;1044;1054;10;87;2.0
11;258;1054;1055;1;87;2.0
11;259;1055;1056;1;87;2.0
11;260;1056;1064;8;87;2.0
11;261;1064;1067;3;87;2.0
11;262;1067;1073;6;87;2.0
11;263;1073;1076;3;87;2.0
11;264;1076;1078;2;87;2.0
11;265;1078;1084;6;87;2.0
11;266;1084;1086;2;87;2.0
11;267;1086;1088;2;87;2.0
11;268;1088;1092;4;87;2.0
11;269;1092;1094;2;87;2.0
11;270;1094;1096;2;87;2.0
11;271;1096;1097;1;87;2.0
11;272;1097;1098;1;87;2.0
11;273;1098;1103;5;87;2.0
11;274;1103;1106;3;87;2.0
11;275;1106;1109;3;87;2.0
11;276;1109;1110;1;87;2.0
11;277;1110;1112;2;87;2.0
11;278;1112;1113;1;87;2.0
11;279;1113;1119;6;87;2.0
11;280;1119;1123;4;87;2.0
11;281;1123;1124;1;87;2.0
11;282;1124;1133;9;87;2.0
11;283;1133;1140;7;87;2.0
11;284;1140;1146;6;87;2.0
11;285;1146;1153;7;87;2.0
11;286;1153;1155;2;87;2.0
11;287;1155;1160;5;87;2.0
11;288;1160;1162;2;87;2.0
11;289;1162;1163;1;87;2.0
11;290;1163;1180;17;87;2.0
11;291;1180;1182;2;87;2.0
11;292;1182;1183;1;87;2.0
11;293;1183;1186;3;87;2.0
11;294;1186;1193;7;87;2.0
11;295;1193;1209;16;87;2.0
11;296;1209;1215;6;87;2.0
11;297;1215;1228;13;87;2.0
11;298;1228;1232;4;87;2.0
11;299;1232;1233;1;87;2.0
11;300;1233;1243;10;87;2.0
11;301;1243;1260;17;87;2.0
11;302;1260;1268;8;87;2.0
11;303;1268;1271;3;87;2.0
11;304;1271;1273;2;87;2.0
11;305;1273;1275;2;87;2.0
11;306;1275;1282;7;87;2.0
11;307;1282;1291;9;87;2.0
11;308;1291;1292;1;87;2.0
11;309;1292;1303;11;87;2.0
11;310;1303;1308;5;87;2.0
11;311;1308;1315;7;87;2.0
11;312;1315;1316;1;87;2.0
11;313;1316;1325;9;87;2.0
11;314;1325;1329;4;87;2.0
11;315;1329;1331;2;87;2.0
11;316;1331;1334;3;87;2.0
11;317;1334;1349;15;87;2.0
11;318;1349;1352;3;87;2.0
11;319;1352;1354;2;87;2.0
11;320;1354;1363;9;87;2.0
11;321;1363;1369;6;87;2.0
11;322;1369;1370;1;87;2.0
11;323;1370;1372;2;87;2.0
11;324;1372;1373;1;87;2.0
11;325;1373;1374;1;87;2.0
11;326;1374;1375;1;87;2.0
11;327;1375;1380;5;87;2.0
11;328;1380;1389;9;87;2.0
11;329;1389;1397;8;87;2.0
11;330;1397;1402;5;87;2.0
11;331;1402;1404;2;87;2.0
11;332;1404;1419;15;87;2.0
11;333;1419;1434;15;87;2.0
11;334;1434;1449;15;87;2.0
11;335;1449;1464;15;87;2.0
11;336;1464;1479;15;87;2.0
11;337;1479;1494;15;87;2.0
11;338;1494;1509;15;87;2.0
11;339;1509;1524;15;87;2.0
11;340;1524;1539;15;87;2.0
11;341;1539;1554;15;87;2.0
11;342;1554;1569;15;87;2.0
11;343;1569;1584;15;87;2.0
11;344;1584;1599;15;87;2.0
11;345;1599;1614;15;87;2.0
11;346;1614;1629;15;87;2.0
11;347;1629;1644;15;87;2.0
11;348;1644;1659;15;87;2.0
11;349;1659;1680;21;87;2.0
12;0;246;330;84;72;2.0
12;1;330;331;1;72;2.0
12;2;331;335;4;72;2.0
12;3;335;336;1;72;2.0
12;4;336;337;1;72;2.0
12;5;337;340;3;72;2.0
12;6;340;341;1;72;2.0
12;7;341;342;1;72;2.0
12;8;342;346;4;72;2.0
12;9;346;350;4;72;2.0
12;10;350;351;1;72;2.0
12;11;351;353;2;72;2.0
12;12;353;354;1;72;2.0
12;13;354;355;1;72;2.0
12;14;355;358;3;72;2.0
12;15;358;360;2;72;2.0
12;16;360;362;2;72;2.0
12;17;362;364;2;72;2.0
12;18;364;365;1;72;2.0
12;19;365;366;1;72;2.0
12;20;366;368;2;72;2.0
12;21;368;369;1;72;2.0
12;22;369;373;4;72;2.0
12;23;373;376;3;72;2.0
12;24;376;377;1;72;2.0
12;25;377;380;3;72;2.0
12;26;380;382;2;72;2.0
12;27;382;384;2;72;2.0
12;28;384;386;2;72;2.0
12;29;386;389;3;72;2.0
12;30;389;390;1;72;2.0
12;31;390;393;3;72;2.0
12;32;393;395;2;72;2.0
12;33;395;397;2;72;2.0
12;34;397;399;2;72;2.0
12;35;399;401;2;72;2.0
12;36;401;402;1;72;2.0
12;37;402;404;2;72;2.0
12;38;404;405;1;72;2.0
12;39;405;410;5;72;2.0
12;40;410;412;2;72;2.0
12;41;412;414;2;72;2.0
12;42;414;416;2;72;2.0
12;43;416;420;4;72;2.0
12;44;420;421;1;72;2.0
12;45;421;422;1;72;2.0
12;46;422;423;1;72;2.0
12;47;423;424;1;72;2.0
12;48;424;425;1;72;2.0
12;49;425;426;1;72;2.0
12;50;426;427;1;72;2.0
12;51;427;430;3;72;2.0
12;52;430;432;2;72;2.0
12;53;432;433;1;72;2.0
12;54;433;436;3;72;2.0
12;55;436;437;1;72;2.0
12;56;437;440;3;72;2.0
12;57;440;443;3;72;2.0
12;58;443;444;1;72;2.0
12;59;444;447;3;72;2.0
12;60;447;449;2;72;2.0
12;61;449;450;1;72;2.0
12;62;450;452;2;72;2.0
12;63;452;455;3;72;2.0
12;64;455;456;1;72;2.0
12;65;456;457;1;72;2.0
12;66;457;458;1;72;2.0
12;67;458;459;1;72;2.0
12;68;459;467;8;72;2.0
12;69;467;468;1;72;2.0
12;70;468;470;2;72;2.0
12;71;470;472;2;72;2.0
12;72;472;473;1;72;2.0
12;73;473;475;2;72;2.0
12;74;475;477;2;72;2.0
12;75;477;478;1;72;2.0
12;76;478;479;1;72;2.0
12;77;479;480;1;72;2.0
12;78;480;482;2;72;2.0
12;79;482;485;3;72;2.0
12;80;485;487;2;72;2.0
12;81;487;488;1;72;2.0
12;82;488;499;11;72;2.0
12;83;499;500;1;72;2.0
12;84;500;502;2;72;2.0
12;85;502;506;4;72;2.0
12;86;506;507;1;72;2.0
12;87;507;509;2;72;2.0
12;88;509;513;4;72;2.0
12;89;513;518;5;72;2.0
12;90;518;519;1;72;2.0
12;91;519;520;1;72;2.0
12;92;520;521;1;72;2.0
12;93;521;530;9;72;2.0
12;94;530;532;2;72;2.0
12;95;532;536;4;72;2.0
12;96;536;542;6;72;2.0
12;97;542;544;2;72;2.0
12;98;544;548;4;72;2.0
12;99;548;550;2;72;2.0
12;100;550;552;2;72;2.0
12;101;552;554;2;72;2.0
12;102;554;558;4;72;2.0
12;103;558;561;3;72;2.0
12;104;561;576;15;72;2.0
12;105;576;579;3;72;2.0
12;106;579;587;8;72;2.0
12;107;587;590;3;72;2.0
12;108;590;592;2;72;2.0
12;109;592;593;1;72;2.0
12;110;593;594;1;72;2.0
12;111;594;595;1;72;2.0
12;112;595;596;1;72;2.0
12;113;596;598;2;72;2.0
12;114;598;602;4;72;2.0
12;115;602;620;18;72;2.0
12;116;620;624;4;72;2.0
12;117;624;625;1;72;2.0
12;118;625;627;2;72;2.0
12;119;627;632;5;72;2.0
12;120;632;633;1;72;2.0
12;121;633;634;1;72;2.0
12;122;634;637;3;72;2.0
12;123;637;641;4;72;2.0
12;124;641;652;11;72;2.0
12;125;652;660;8;72;2.0
12;126;660;661;1;72;2.0
12;127;661;663;2;72;2.0
12;128;663;664;1;72;2.0
12;129;664;675;11;72;2.0
12;130;675;681;6;72;2.0
12;131;681;686;5;72;2.0
12;132;686;695;9;72;2.0
12;133;695;699;4;72;2.0
12;134;699;702;3;72;2.0
12;135;702;703;1;72;2.0
12;136;703;707;4;72;2.0
12;137;707;712;5;72;2.0
12;138;712;722;10;72;2.0
12;139;722;723;1;72;2.0
12;140;723;725;2;72;2.0
12;141;725;726;1;72;2.0
12;142;726;729;3;72;2.0
12;143;729;730;1;72;2.0
12;144;730;733;3;72;2.0
12;145;733;740;7;72;2.0
12;146;740;744;4;72;2.0
12;147;744;751;7;72;2.0
12;148;751;753;2;72;2.0
12;149;753;754;1;72;2.0
12;150;754;757;3;72;2.0
12;151;757;762;5;72;2.0
12;152;762;767;5;72;2.0
12;153;767;770;3;72;2.0
12;154;770;771;1;72;2.0
12;155;771;772;1;72;2.0
12;156;772;783;11;72;2.0
12;157;783;789;6;72;2.0
12;158;789;790;1;72;2.0
12;159;790;799;9;72;2.0
12;160;799;800;1;72;2.0
12;161;800;802;2;72;2.0
12;162;802;803;1;72;2.0
12;163;803;805;2;72;2.0
12;164;805;810;5;72;2.0
12;165;810;813;3;72;2.0
12;166;813;819;6;72;2.0
12;167;819;820;1;72;2.0
12;168;820;822;2;72;2.0
12;169;822;823;1;72;2.0
12;170;823;826;3;72;2.0
12;171;826;827;1;72;2.0
12;172;827;832;5;72;2.0
12;173;832;837;5;72;2.0
12;174;837;838;1;72;2.0
12;175;838;840;2;72;2.0
12;176;840;841;1;72;2.0
12;177;841;845;4;72;2.0
12;178;845;850;5;72;2.0
12;179;850;852;2;72;2.0
12;180;852;854;2;72;2.0
12;181;854;856;2;72;2.0
12;182;856;860;4;72;2.0
12;183;860;863;3;72;2.0
12;184;863;865;2;72;2.0
12;185;865;869;4;72;2.0
12;186;869;872;3;72;2.0
12;187;872;873;1;72;2.0
12;188;873;874;1;72;2.0
12;189;874;875;1;72;2.0
12;190;875;876;1;72;2.0
12;191;876;877;1;72;2.0
12;192;877;882;5;72;2.0
12;193;882;884;2;72;2.0
12;194;884;887;3;72;2.0
12;195;887;890;3;72;2.0
12;196;890;892;2;72;2.0
12;197;892;893;1;72;2.0
12;198;893;895;2;72;2.0
12;199;895;903;8;72;2.0
12;200;903;904;1;72;2.0
12;201;904;905;1;72;2.0
12;202;905;907;2;72;2.0
12;203;907;908;1;72;2.0
12;204;908;909;1;72;2.0
12;205;909;912;3;72;2.0
12;206;912;914;2;72;2.0
12;207;914;915;1;72;2.0
12;208;915;920;5;72;2.0
12;209;920;922;2;72;2.0
12;210;922;929;7;72;2.0
12;211;929;930;1;72;2.0
12;212;930;933;3;72;2.0
12;213;933;934;1;72;2.0
12;214;934;936;2;72;2.0
12;215;936;937;1;72;2.0
12;216;937;940;3;72;2.0
12;217;940;942;2;72;2.0
12;218;942;943;1;72;2.0
12;219;943;947;4;72;2.0
12;220;947;948;1;72;2.0
12;221;948;949;1;72;2.0
12;222;949;952;3;72;2.0
12;223;952;955;3;72;2.0
12;224;955;960;5;72;2.0
12;225;960;962;2;72;2.0
12;226;962;963;1;72;2.0
12;227;963;964;1;72;2.0
12;228;964;967;3;72;2.0
12;229;967;969;2;72;2.0
12;230;969;971;2;72;2.0
12;231;971;972;1;72;2.0
12;232;972;974;2;72;2.0
12;233;974;975;1;72;2.0
12;234;975;980;5;72;2.0
12;235;980;982;2;72;2.0
12;236;982;983;1;72;2.0
12;237;983;985;2;72;2.0
12;238;985;986;1;72;2.0
12;239;986;997;11;72;2.0
12;240;997;998;1;72;2.0
12;241;998;1000;2;72;2.0
12;242;1000;1002;2;72;2.0
12;243;1002;1003;1;72;2.0
12;244;1003;1007;4;72;2.0
12;245;1007;1008;1;72;2.0
12;246;1008;1012;4;72;2.0
12;247;1012;1019;7;72;2.0
12;248;1019;1020;1;72;2.0
12;249;1020;1024;4;72;2.0
12;250;1024;1025;1;72;2.0
12;251;1025;1026;1;72;2.0
12;252;1026;1027;1;72;2.0
12;253;1027;1031;4;72;2.0
12;254;1031;1032;1;72;2.0
12;255;1032;1033;1;72;2.0
12;256;1033;1034;1;72;2.0
12;257;1034;1037;3;72;2.0
12;258;1037;1040;3;72;2.0
12;259;1040;1048;8;72;2.0
12;260;1048;1050;2;72;2.0
12;261;1050;1052;2;72;2.0
12;262;1052;1057;5;72;2.0
12;263;1057;1060;3;72;2.0
12;264;1060;1062;2;72;2.0
12;265;1062;1063;1;72;2.0
12;266;1063;1069;6;72;2.0
12;267;1069;1072;3;72;2.0
12;268;1072;1080;8;72;2.0
12;269;1080;1081;1;72;2.0
12;270;1081;1082;1;72;2.0
12;271;1082;1087;5;72;2.0
12;272;1087;1088;1;72;2.0
12;273;1088;1092;4;72;2.0
12;274;1092;1093;1;72;2.0
12;275;1093;1094;1;72;2.0
12;276;1094;1098;4;72;2.0
12;277;1098;1102;4;72;2.0
12;278;1102;1103;1;72;2.0
12;279;1103;1105;2;72;2.0
12;280;1105;1106;1;72;2.0
12;281;1106;1108;2;72;2.0
12;282;1108;1113;5;72;2.0
12;283;1113;1117;4;72;2.0
12;284;1117;1119;2;72;2.0
12;285;1119;1129;10;72;2.0
12;286;1129;1136;7;72;2.0
12;287;1136;1141;5;72;2.0
12;288;1141;1148;7;72;2.0
12;289;1148;1149;1;72;2.0
12;290;1149;1151;2;72;2.0
12;291;1151;1155;4;72;2.0
12;292;1155;1156;1;72;2.0
12;293;1156;1157;1;72;2.0
12;294;1157;1176;19;72;2.0
12;295;1176;1179;3;72;2.0
12;296;1179;1181;2;72;2.0
12;297;1181;1189;8;72;2.0
12;298;1189;1203;14;72;2.0
12;299;1203;1210;7;72;2.0
12;300;1210;1211;1;72;2.0
12;301;1211;1224;13;72;2.0
12;302;1224;1226;2;72;2.0
12;303;1226;1228;2;72;2.0
12;304;1228;1239;11;72;2.0
12;305;1239;1256;17;72;2.0
12;306;1256;1264;8;72;2.0
12;307;1264;1266;2;72;2.0
12;308;1266;1268;2;72;2.0
12;309;1268;1271;3;72;2.0
12;310;1271;1276;5;72;2.0
12;311;1276;1286;10;72;2.0
12;312;1286;1299;13;72;2.0
12;313;1299;1304;5;72;2.0
12;314;1304;1310;6;72;2.0
12;315;1310;1311;1;72;2.0
12;316;1311;1321;10;72;2.0
12;317;1321;1325;4;72;2.0
12;318;1325;1326;1;72;2.0
12;319;1326;1330;4;72;2.0
12;320;1330;1342;12;72;2.0
12;321;1342;1343;1;72;2.0
12;322;1343;1348;5;72;2.0
12;323;1348;1349;1;72;2.0
12;324;1349;1357;8;72;2.0
12;325;1357;1365;8;72;2.0
12;326;1365;1366;1;72;2.0
12;327;1366;1368;2;72;2.0
12;328;1368;1369;1;72;2.0
12;329;1369;1370;1;72;2.0
12;330;1370;1376;6;72;2.0
12;331;1376;1384;8;72;2.0
12;332;1384;1385;1;72;2.0
12;333;1385;1391;6;72;2.0
12;334;1391;1396;5;72;2.0
12;335;1396;1399;3;72;2.0
12;336;1399;1414;15;72;2.0
12;337;1414;1429;15;72;2.0
12;338;1429;1444;15;72;2.0
12;339;1444;1459;15;72;2.0
12;340;1459;1474;15;72;2.0
12;341;1474;1489;15;72;2.0
12;342;1489;1504;15;72;2.0
12;343;1504;1519;15;72;2.0
12;344;1519;1534;15;72;2.0
12;345;1534;1549;15;72;2.0
12;346;1549;1564;15;72;2.0
12;347;1564;1579;15;72;2.0
12;348;1579;1594;15;72;2.0
12;349;1594;1609;15;72;2.0
12;350;1609;1624;15;72;2.0
12;351;1624;1639;15;72;2.0
12;352;1639;1654;15;72;2.0
12;353;1654;1669;15;72;2.0
12;354;1669;1680;11;72;2.0
13;0;249;326;77;58;2.0
13;1;326;327;1;58;2.0
13;2;327;330;3;58;2.0
13;3;330;331;1;58;2.0
13;4;331;333;2;58;2.0
13;5;333;337;4;58;2.0
13;6;337;338;1;58;2.0
13;7;338;340;2;58;2.0
13;8;340;341;1;58;2.0
13;9;341;342;1;58;2.0
13;10;342;345;3;58;2.0
13;11;345;348;3;58;2.0
13;12;348;349;1;58;2.0
13;13;349;350;1;58;2.0
13;14;350;352;2;58;2.0
13;15;352;355;3;58;2.0
13;16;355;357;2;58;2.0
13;17;357;358;1;58;2.0
13;18;358;363;5;58;2.0
13;19;363;364;1;58;2.0
13;20;364;365;1;58;2.0
13;21;365;367;2;58;2.0
13;22;367;368;1;58;2.0
13;23;368;372;4;58;2.0
13;24;372;373;1;58;2.0
13;25;373;376;3;58;2.0
13;26;376;377;1;58;2.0
13;27;377;380;3;58;2.0
13;28;380;383;3;58;2.0
13;29;383;385;2;58;2.0
13;30;385;387;2;58;2.0
13;31;387;391;4;58;2.0
13;32;391;392;1;58;2.0
13;33;392;393;1;58;2.0
13;34;393;398;5;58;2.0
13;35;398;399;1;58;2.0
13;36;399;400;1;58;2.0
13;37;400;402;2;58;2.0
13;38;402;403;1;58;2.0
13;39;403;404;1;58;2.0
13;40;404;411;7;58;2.0
13;41;411;415;4;58;2.0
13;42;415;417;2;58;2.0
13;43;417;418;1;58;2.0
13;44;418;423;5;58;2.0
13;45;423;425;2;58;2.0
13;46;425;426;1;58;2.0
13;47;426;427;1;58;2.0
13;48;427;432;5;58;2.0
13;49;432;433;1;58;2.0
13;50;433;434;1;58;2.0
13;51;434;435;1;58;2.0
13;52;435;436;1;58;2.0
13;53;436;438;2;58;2.0
13;54;438;442;4;58;2.0
13;55;442;444;2;58;2.0
13;56;444;445;1;58;2.0
13;57;445;447;2;58;2.0
13;58;447;450;3;58;2.0
13;59;450;451;1;58;2.0
13;60;451;453;2;58;2.0
13;61;453;457;4;58;2.0
13;62;457;458;1;58;2.0
13;63;458;460;2;58;2.0
13;64;460;462;2;58;2.0
13;65;462;465;3;58;2.0
13;66;465;468;3;58;2.0
13;67;468;470;2;58;2.0
13;68;470;472;2;58;2.0
13;69;472;474;2;58;2.0
13;70;474;475;1;58;2.0
13;71;475;477;2;58;2.0
13;72;477;478;1;58;2.0
13;73;478;479;1;58;2.0
13;74;479;480;1;58;2.0
13;75;480;484;4;58;2.0
13;76;484;487;3;58;2.0
13;77;487;488;1;58;2.0
13;78;488;492;4;58;2.0
13;79;492;499;7;58;2.0
13;80;499;504;5;58;2.0
13;81;504;505;1;58;2.0
13;82;505;508;3;58;2.0
13;83;508;509;1;58;2.0
13;84;509;512;3;58;2.0
13;85;512;515;3;58;2.0
13;86;515;518;3;58;2.0
13;87;518;520;2;58;2.0
13;88;520;521;1;58;2.0
13;89;521;532;11;58;2.0
13;90;532;533;1;58;2.0
13;91;533;535;2;58;2.0
13;92;535;536;1;58;2.0
13;93;536;537;1;58;2.0
13;94;537;542;5;58;2.0
13;95;542;545;3;58;2.0
13;96;545;548;3;58;2.0
13;97;548;552;4;58;2.0
13;98;552;553;1;58;2.0
13;99;553;554;1;58;2.0
13;100;554;557;3;58;2.0
13;101;557;560;3;58;2.0
13;102;560;571;11;58;2.0
13;103;571;579;8;58;2.0
13;104;579;584;5;58;2.0
13;105;584;585;1;58;2.0
13;106;585;587;2;58;2.0
13;107;587;590;3;58;2.0
13;108;590;592;2;58;2.0
13;109;592;595;3;58;2.0
13;110;595;596;1;58;2.0
13;111;596;598;2;58;2.0
13;112;598;599;1;58;2.0
13;113;599;620;21;58;2.0
13;114;620;622;2;58;2.0
13;115;622;625;3;58;2.0
13;116;625;632;7;58;2.0
13;117;632;633;1;58;2.0
13;118;633;636;3;58;2.0
13;119;636;640;4;58;2.0
13;120;640;654;14;58;2.0
13;121;654;655;1;58;2.0
13;122;655;656;1;58;2.0
13;123;656;658;2;58;2.0
13;124;658;662;4;58;2.0
13;125;662;667;5;58;2.0
13;126;667;680;13;58;2.0
13;127;680;688;8;58;2.0
13;128;688;690;2;58;2.0
13;129;690;697;7;58;2.0
13;130;697;699;2;58;2.0
13;131;699;702;3;58;2.0
13;132;702;710;8;58;2.0
13;133;710;716;6;58;2.0
13;134;716;717;1;58;2.0
13;135;717;719;2;58;2.0
13;136;719;723;4;58;2.0
13;137;723;725;2;58;2.0
13;138;725;732;7;58;2.0
13;139;732;742;10;58;2.0
13;140;742;745;3;58;2.0
13;141;745;748;3;58;2.0
13;142;748;755;7;58;2.0
13;143;755;756;1;58;2.0
13;144;756;757;1;58;2.0
13;145;757;762;5;58;2.0
13;146;762;765;3;58;2.0
13;147;765;766;1;58;2.0
13;148;766;770;4;58;2.0
13;149;770;776;6;58;2.0
13;150;776;782;6;58;2.0
13;151;782;783;1;58;2.0
13;152;783;785;2;58;2.0
13;153;785;789;4;58;2.0
13;154;789;799;10;58;2.0
13;155;799;802;3;58;2.0
13;156;802;805;3;58;2.0
13;157;805;807;2;58;2.0
13;158;807;812;5;58;2.0
13;159;812;815;3;58;2.0
13;160;815;817;2;58;2.0
13;161;817;819;2;58;2.0
13;162;819;823;4;58;2.0
13;163;823;824;1;58;2.0
13;164;824;825;1;58;2.0
13;165;825;829;4;58;2.0
13;166;829;830;1;58;2.0
13;167;830;831;1;58;2.0
13;168;831;835;4;58;2.0
13;169;835;836;1;58;2.0
13;170;836;837;1;58;2.0
13;171;837;838;1;58;2.0
13;172;838;839;1;58;2.0
13;173;839;844;5;58;2.0
13;174;844;845;1;58;2.0
13;175;845;847;2;58;2.0
13;176;847;851;4;58;2.0
13;177;851;855;4;58;2.0
13;178;855;857;2;58;2.0
13;179;857;859;2;58;2.0
13;180;859;860;1;58;2.0
13;181;860;862;2;58;2.0
13;182;862;865;3;58;2.0
13;183;865;867;2;58;2.0
13;184;867;873;6;58;2.0
13;185;873;874;1;58;2.0
13;186;874;875;1;58;2.0
13;187;875;876;1;58;2.0
13;188;876;877;1;58;2.0
13;189;877;879;2;58;2.0
13;190;879;883;4;58;2.0
13;191;883;884;1;58;2.0
13;192;884;885;1;58;2.0
13;193;885;889;4;58;2.0
13;194;889;890;1;58;2.0
13;195;890;891;1;58;2.0
13;196;891;892;1;58;2.0
13;197;892;893;1;58;2.0
13;198;893;894;1;58;2.0
13;199;894;896;2;58;2.0
13;200;896;900;4;58;2.0
13;201;900;902;2;58;2.0
13;202;902;904;2;58;2.0
13;203;904;906;2;58;2.0
13;204;906;907;1;58;2.0
13;205;907;908;1;58;2.0
13;206;908;909;1;58;2.0
13;207;909;910;1;58;2.0
13;208;910;912;2;58;2.0
13;209;912;914;2;58;2.0
13;210;914;915;1;58;2.0
13;211;915;916;1;58;2.0
13;212;916;917;1;58;2.0
13;213;917;919;2;58;2.0
13;214;919;922;3;58;2.0
13;215;922;925;3;58;2.0
13;216;925;930;5;58;2.0
13;217;930;932;2;58;2.0
13;218;932;933;1;58;2.0
13;219;933;934;1;58;2.0
13;220;934;935;1;58;2.0
13;221;935;936;1;58;2.0
13;222;936;937;1;58;2.0
13;223;937;939;2;58;2.0
13;224;939;943;4;58;2.0
13;225;943;946;3;58;2.0
13;226;946;947;1;58;2.0
13;227;947;949;2;58;2.0
13;228;949;950;1;58;2.0
13;229;950;954;4;58;2.0
13;230;954;955;1;58;2.0
13;231;955;962;7;58;2.0
13;232;962;963;1;58;2.0
13;233;963;964;1;58;2.0
13;234;964;965;1;58;2.0
13;235;965;966;1;58;2.0
13;236;966;967;1;58;2.0
13;237;967;969;2;58;2.0
13;238;969;971;2;58;2.0
13;239;971;974;3;58;2.0
13;240;974;975;1;58;2.0
13;241;975;976;1;58;2.0
13;242;976;977;1;58;2.0
13;243;977;982;5;58;2.0
13;244;982;983;1;58;2.0
13;245;983;985;2;58;2.0
13;246;985;986;1;58;2.0
13;247;986;987;1;58;2.0
13;248;987;995;8;58;2.0
13;249;995;997;2;58;2.0
13;250;997;998;1;58;2.0
13;251;998;999;1;58;2.0
13;252;999;1004;5;58;2.0
13;253;1004;1005;1;58;2.0
13;254;1005;1006;1;58;2.0
13;255;1006;1007;1;58;2.0
13;256;1007;1009;2;58;2.0
13;257;1009;1012;3;58;2.0
13;258;1012;1015;3;58;2.0
13;259;1015;1019;4;58;2.0
13;260;1019;1022;3;58;2.0
13;261;1022;1023;1;58;2.0
13;262;1023;1024;1;58;2.0
13;263;1024;1026;2;58;2.0
13;264;1026;1027;1;58;2.0
13;265;1027;1029;2;58;2.0
13;266;1029;1030;1;58;2.0
13;267;1030;1035;5;58;2.0
13;268;1035;1036;1;58;2.0
13;269;1036;1039;3;58;2.0
13;270;1039;1042;3;58;2.0
13;271;1042;1048;6;58;2.0
13;272;1048;1051;3;58;2.0
13;273;1051;1052;1;58;2.0
13;274;1052;1054;2;58;2.0
13;275;1054;1055;1;58;2.0
13;276;1055;1059;4;58;2.0
13;277;1059;1062;3;58;2.0
13;278;1062;1066;4;58;2.0
13;279;1066;1069;3;58;2.0
13;280;1069;1075;6;58;2.0
13;281;1075;1078;3;58;2.0
13;282;1078;1079;1;58;2.0
13;283;1079;1083;4;58;2.0
13;284;1083;1085;2;58;2.0
13;285;1085;1088;3;58;2.0
13;286;1088;1092;4;58;2.0
13;287;1092;1095;3;58;2.0
13;288;1095;1100;5;58;2.0
13;289;1100;1101;1;58;2.0
13;290;1101;1103;2;58;2.0
13;291;1103;1106;3;58;2.0
13;292;1106;1107;1;58;2.0
13;293;1107;1110;3;58;2.0
13;294;1110;1118;8;58;2.0
13;295;1118;1119;1;58;2.0
13;296;1119;1126;7;58;2.0
13;297;1126;1128;2;58;2.0
13;298;1128;1131;3;58;2.0
13;299;1131;1133;2;58;2.0
13;300;1133;1148;15;58;2.0
13;301;1148;1153;5;58;2.0
13;302;1153;1154;1;58;2.0
13;303;1154;1157;3;58;2.0
13;304;1157;1171;14;58;2.0
13;305;1171;1176;5;58;2.0
13;306;1176;1178;2;58;2.0
13;307;1178;1183;5;58;2.0
13;308;1183;1188;5;58;2.0
13;309;1188;1196;8;58;2.0
13;310;1196;1206;10;58;2.0
13;311;1206;1212;6;58;2.0
13;312;1212;1214;2;58;2.0
13;313;1214;1225;11;58;2.0
13;314;1225;1226;1;58;2.0
13;315;1226;1230;4;58;2.0
13;316;1230;1238;8;58;2.0
13;317;1238;1258;20;58;2.0
13;318;1258;1263;5;58;2.0
13;319;1263;1266;3;58;2.0
13;320;1266;1270;4;58;2.0
13;321;1270;1273;3;58;2.0
13;322;1273;1274;1;58;2.0
13;323;1274;1286;12;58;2.0
13;324;1286;1288;2;58;2.0
13;325;1288;1298;10;58;2.0
13;326;1298;1303;5;58;2.0
13;327;1303;1307;4;58;2.0
13;328;1307;1314;7;58;2.0
13;329;1314;1315;1;58;2.0
13;330;1315;1318;3;58;2.0
13;331;1318;1320;2;58;2.0
13;332;1320;1324;4;58;2.0
13;333;1324;1337;13;58;2.0
13;334;1337;1339;2;58;2.0
13;335;1339;1343;4;58;2.0
13;336;1343;1347;4;58;2.0
13;337;1347;1351;4;58;2.0
13;338;1351;1359;8;58;2.0
13;339;1359;1364;5;58;2.0
13;340;1364;1367;3;58;2.0
13;341;1367;1368;1;58;2.0
13;342;1368;1371;3;58;2.0
13;343;1371;1372;1;58;2.0
13;344;1372;1373;1;58;2.0
13;345;1373;1386;13;58;2.0
13;346;1386;1388;2;58;2.0
13;347;1388;1391;3;58;2.0
13;348;1391;1393;2;58;2.0
13;349;1393;1401;8;58;2.0
13;350;1401;1416;15;58;2.0
13;351;1416;1431;15;58;2.0
13;352;1431;1446;15;58;2.0
13;353;1446;1461;15;58;2.0
13;354;1461;1476;15;58;2.0
13;355;1476;1491;15;58;2.0
13;356;1491;1506;15;58;2.0
13;357;1506;1521;15;58;2.0
13;358;1521;1536;15;58;2.0
13;359;1536;1551;15;58;2.0
13;360;1551;1566;15;58;2.0
13;361;1566;1581;15;58;2.0
13;362;1581;1596;15;58;2.0
13;363;1596;1611;15;58;2.0
13;364;1611;1626;15;58;2.0
13;365;1626;1641;15;58;2.0
13;366;1641;1656;15;58;2.0
13;367;1656;1680;24;58;2.0
14;0;257;324;67;115;2.0
14;1;324;336;12;115;2.0
14;2;336;340;4;115;2.0
14;3;340;342;2;115;2.0
14;4;342;343;1;115;2.0
14;5;343;344;1;115;2.0
14;6;344;345;1;115;2.0
14;7;345;348;3;115;2.0
14;8;348;350;2;115;2.0
14;9;350;351;1;115;2.0
14;10;351;354;3;115;2.0
14;11;354;359;5;115;2.0
14;12;359;360;1;115;2.0
14;13;360;361;1;115;2.0
14;14;361;362;1;115;2.0
14;15;362;364;2;115;2.0
14;16;364;365;1;115;2.0
14;17;365;369;4;115;2.0
14;18;369;370;1;115;2.0
14;19;370;371;1;115;2.0
14;20;371;372;1;115;2.0
14;21;372;374;2;115;2.0
14;22;374;375;1;115;2.0
14;23;375;378;3;115;2.0
14;24;378;379;1;115;2.0
14;25;379;380;1;115;2.0
14;26;380;381;1;115;2.0
14;27;381;384;3;115;2.0
14;28;384;391;7;115;2.0
14;29;391;394;3;115;2.0
14;30;394;396;2;115;2.0
14;31;396;400;4;115;2.0
14;32;400;402;2;115;2.0
14;33;402;405;3;115;2.0
14;34;405;408;3;115;2.0
14;35;408;409;1;115;2.0
14;36;409;410;1;115;2.0
14;37;410;414;4;115;2.0
14;38;414;415;1;115;2.0
14;39;415;417;2;115;2.0
14;40;417;420;3;115;2.0
14;41;420;427;7;115;2.0
14;42;427;429;2;115;2.0
14;43;429;430;1;115;2.0
14;44;430;431;1;115;2.0
14;45;431;432;1;115;2.0
14;46;432;434;2;115;2.0
14;47;434;435;1;115;2.0
14;48;435;437;2;115;2.0
14;49;437;438;1;115;2.0
14;50;438;439;1;115;2.0
14;51;439;440;1;115;2.0
14;52;440;441;1;115;2.0
14;53;441;442;1;115;2.0
14;54;442;444;2;115;2.0
14;55;444;449;5;115;2.0
14;56;449;450;1;115;2.0
14;57;450;456;6;115;2.0
14;58;456;458;2;115;2.0
14;59;458;459;1;115;2.0
14;60;459;460;1;115;2.0
14;61;460;461;1;115;2.0
14;62;461;464;3;115;2.0
14;63;464;465;1;115;2.0
14;64;465;471;6;115;2.0
14;65;471;472;1;115;2.0
14;66;472;474;2;115;2.0
14;67;474;479;5;115;2.0
14;68;479;480;1;115;2.0
14;69;480;482;2;115;2.0
14;70;482;484;2;115;2.0
14;71;484;488;4;115;2.0
14;72;488;489;1;115;2.0
14;73;489;492;3;115;2.0
14;74;492;493;1;115;2.0
14;75;493;494;1;115;2.0
14;76;494;495;1;115;2.0
14;77;495;497;2;115;2.0
14;78;497;505;8;115;2.0
14;79;505;510;5;115;2.0
14;80;510;511;1;115;2.0
14;81;511;513;2;115;2.0
14;82;513;514;1;115;2.0
14;83;514;515;1;115;2.0
14;84;515;522;7;115;2.0
14;85;522;524;2;115;2.0
14;86;524;526;2;115;2.0
14;87;526;532;6;115;2.0
14;88;532;537;5;115;2.0
14;89;537;544;7;115;2.0
14;90;544;546;2;115;2.0
14;91;546;548;2;115;2.0
14;92;548;554;6;115;2.0
14;93;554;556;2;115;2.0
14;94;556;560;4;115;2.0
14;95;560;562;2;115;2.0
14;96;562;569;7;115;2.0
14;97;569;581;12;115;2.0
14;98;581;588;7;115;2.0
14;99;588;591;3;115;2.0
14;100;591;597;6;115;2.0
14;101;597;602;5;115;2.0
14;102;602;604;2;115;2.0
14;103;604;605;1;115;2.0
14;104;605;606;1;115;2.0
14;105;606;619;13;115;2.0
14;106;619;623;4;115;2.0
14;107;623;627;4;115;2.0
14;108;627;631;4;115;2.0
14;109;631;637;6;115;2.0
14;110;637;639;2;115;2.0
14;111;639;640;1;115;2.0
14;112;640;641;1;115;2.0
14;113;641;642;1;115;2.0
14;114;642;661;19;115;2.0
14;115;661;666;5;115;2.0
14;116;666;669;3;115;2.0
14;117;669;672;3;115;2.0
14;118;672;674;2;115;2.0
14;119;674;682;8;115;2.0
14;120;682;685;3;115;2.0
14;121;685;689;4;115;2.0
14;122;689;693;4;115;2.0
14;123;693;701;8;115;2.0
14;124;701;707;6;115;2.0
14;125;707;714;7;115;2.0
14;126;714;726;12;115;2.0
14;127;726;727;1;115;2.0
14;128;727;729;2;115;2.0
14;129;729;731;2;115;2.0
14;130;731;735;4;115;2.0
14;131;735;739;4;115;2.0
14;132;739;742;3;115;2.0
14;133;742;743;1;115;2.0
14;134;743;747;4;115;2.0
14;135;747;749;2;115;2.0
14;136;749;759;10;115;2.0
14;137;759;760;1;115;2.0
14;138;760;761;1;115;2.0
14;139;761;772;11;115;2.0
14;140;772;773;1;115;2.0
14;141;773;774;1;115;2.0
14;142;774;780;6;115;2.0
14;143;780;781;1;115;2.0
14;144;781;782;1;115;2.0
14;145;782;784;2;115;2.0
14;146;784;786;2;115;2.0
14;147;786;789;3;115;2.0
14;148;789;795;6;115;2.0
14;149;795;801;6;115;2.0
14;150;801;802;1;115;2.0
14;151;802;807;5;115;2.0
14;152;807;809;2;115;2.0
14;153;809;810;1;115;2.0
14;154;810;811;1;115;2.0
14;155;811;812;1;115;2.0
14;156;812;814;2;115;2.0
14;157;814;815;1;115;2.0
14;158;815;820;5;115;2.0
14;159;820;822;2;115;2.0
14;160;822;825;3;115;2.0
14;161;825;830;5;115;2.0
14;162;830;831;1;115;2.0
14;163;831;832;1;115;2.0
14;164;832;834;2;115;2.0
14;165;834;838;4;115;2.0
14;166;838;843;5;115;2.0
14;167;843;844;1;115;2.0
14;168;844;846;2;115;2.0
14;169;846;850;4;115;2.0
14;170;850;851;1;115;2.0
14;171;851;852;1;115;2.0
14;172;852;854;2;115;2.0
14;173;854;861;7;115;2.0
14;174;861;862;1;115;2.0
14;175;862;864;2;115;2.0
14;176;864;867;3;115;2.0
14;177;867;868;1;115;2.0
14;178;868;869;1;115;2.0
14;179;869;870;1;115;2.0
14;180;870;875;5;115;2.0
14;181;875;877;2;115;2.0
14;182;877;879;2;115;2.0
14;183;879;884;5;115;2.0
14;184;884;885;1;115;2.0
14;185;885;889;4;115;2.0
14;186;889;890;1;115;2.0
14;187;890;891;1;115;2.0
14;188;891;894;3;115;2.0
14;189;894;896;2;115;2.0
14;190;896;897;1;115;2.0
14;191;897;898;1;115;2.0
14;192;898;899;1;115;2.0
14;193;899;901;2;115;2.0
14;194;901;902;1;115;2.0
14;195;902;904;2;115;2.0
14;196;904;906;2;115;2.0
14;197;906;911;5;115;2.0
14;198;911;914;3;115;2.0
14;199;914;915;1;115;2.0
14;200;915;916;1;115;2.0
14;201;916;917;1;115;2.0
14;202;917;918;1;115;2.0
14;203;918;922;4;115;2.0
14;204;922;923;1;115;2.0
14;205;923;924;1;115;2.0
14;206;924;927;3;115;2.0
14;207;927;928;1;115;2.0
14;208;928;929;1;115;2.0
14;209;929;931;2;115;2.0
14;210;931;932;1;115;2.0
14;211;932;937;5;115;2.0
14;212;937;939;2;115;2.0
14;213;939;941;2;115;2.0
14;214;941;944;3;115;2.0
14;215;944;946;2;115;2.0
14;216;946;949;3;115;2.0
14;217;949;952;3;115;2.0
14;218;952;953;1;115;2.0
14;219;953;954;1;115;2.0
14;220;954;956;2;115;2.0
14;221;956;959;3;115;2.0
14;222;959;961;2;115;2.0
14;223;961;964;3;115;2.0
14;224;964;969;5;115;2.0
14;225;969;971;2;115;2.0
14;226;971;972;1;115;2.0
14;227;972;976;4;115;2.0
14;228;976;977;1;115;2.0
14;229;977;981;4;115;2.0
14;230;981;982;1;115;2.0
14;231;982;983;1;115;2.0
14;232;983;984;1;115;2.0
14;233;984;987;3;115;2.0
14;234;987;989;2;115;2.0
14;235;989;992;3;115;2.0
14;236;992;1002;10;115;2.0
14;237;1002;1004;2;115;2.0
14;238;1004;1006;2;115;2.0
14;239;1006;1010;4;115;2.0
14;240;1010;1011;1;115;2.0
14;241;1011;1012;1;115;2.0
14;242;1012;1013;1;115;2.0
14;243;1013;1014;1;115;2.0
14;244;1014;1016;2;115;2.0
14;245;1016;1017;1;115;2.0
14;246;1017;1021;4;115;2.0
14;247;1021;1025;4;115;2.0
14;248;1025;1027;2;115;2.0
14;249;1027;1029;2;115;2.0
14;250;1029;1031;2;115;2.0
14;251;1031;1032;1;115;2.0
14;252;1032;1034;2;115;2.0
14;253;1034;1041;7;115;2.0
14;254;1041;1043;2;115;2.0
14;255;1043;1044;1;115;2.0
14;256;1044;1046;2;115;2.0
14;257;1046;1047;1;115;2.0
14;258;1047;1050;3;115;2.0
14;259;1050;1054;4;115;2.0
14;260;1054;1057;3;115;2.0
14;261;1057;1064;7;115;2.0
14;262;1064;1072;8;115;2.0
14;263;1072;1073;1;115;2.0
14;264;1073;1074;1;115;2.0
14;265;1074;1076;2;115;2.0
14;266;1076;1078;2;115;2.0
14;267;1078;1079;1;115;2.0
14;268;1079;1088;9;115;2.0
14;269;1088;1089;1;115;2.0
14;270;1089;1092;3;115;2.0
14;271;1092;1093;1;115;2.0
14;272;1093;1094;1;115;2.0
14;273;1094;1097;3;115;2.0
14;274;1097;1100;3;115;2.0
14;275;1100;1105;5;115;2.0
14;276;1105;1109;4;115;2.0
14;277;1109;1112;3;115;2.0
14;278;1112;1115;3;115;2.0
14;279;1115;1120;5;115;2.0
14;280;1120;1123;3;115;2.0
14;281;1123;1125;2;115;2.0
14;282;1125;1127;2;115;2.0
14;283;1127;1133;6;115;2.0
14;284;1133;1148;15;115;2.0
14;285;1148;1150;2;115;2.0
14;286;1150;1151;1;115;2.0
14;287;1151;1160;9;115;2.0
14;288;1160;1162;2;115;2.0
14;289;1162;1163;1;115;2.0
14;290;1163;1180;17;115;2.0
14;291;1180;1182;2;115;2.0
14;292;1182;1187;5;115;2.0
14;293;1187;1188;1;115;2.0
14;294;1188;1193;5;115;2.0
14;295;1193;1213;20;115;2.0
14;296;1213;1217;4;115;2.0
14;297;1217;1223;6;115;2.0
14;298;1223;1232;9;115;2.0
14;299;1232;1235;3;115;2.0
14;300;1235;1240;5;115;2.0
14;301;1240;1253;13;115;2.0
14;302;1253;1262;9;115;2.0
14;303;1262;1266;4;115;2.0
14;304;1266;1275;9;115;2.0
14;305;1275;1276;1;115;2.0
14;306;1276;1280;4;115;2.0
14;307;1280;1283;3;115;2.0
14;308;1283;1292;9;115;2.0
14;309;1292;1293;1;115;2.0
14;310;1293;1300;7;115;2.0
14;311;1300;1302;2;115;2.0
14;312;1302;1303;1;115;2.0
14;313;1303;1307;4;115;2.0
14;314;1307;1316;9;115;2.0
14;315;1316;1335;19;115;2.0
14;316;1335;1336;1;115;2.0
14;317;1336;1337;1;115;2.0
14;318;1337;1340;3;115;2.0
14;319;1340;1348;8;115;2.0
14;320;1348;1349;1;115;2.0
14;321;1349;1350;1;115;2.0
14;322;1350;1356;6;115;2.0
14;323;1356;1365;9;115;2.0
14;324;1365;1366;1;115;2.0
14;325;1366;1367;1;115;2.0
14;326;1367;1374;7;115;2.0
14;327;1374;1375;1;115;2.0
14;328;1375;1376;1;115;2.0
14;329;1376;1377;1;115;2.0
14;330;1377;1388;11;115;2.0
14;331;1388;1391;3;115;2.0
14;332;1391;1397;6;115;2.0
14;333;1397;1400;3;115;2.0
14;334;1400;1406;6;115;2.0
14;335;1406;1421;15;115;2.0
14;336;1421;1436;15;115;2.0
14;337;1436;1451;15;115;2.0
14;338;1451;1466;15;115;2.0
14;339;1466;1481;15;115;2.0
14;340;1481;1496;15;115;2.0
14;341;1496;1511;15;115;2.0
14;342;1511;1526;15;115;2.0
14;343;1526;1541;15;115;2.0
14;344;1541;1556;15;115;2.0
14;345;1556;1571;15;115;2.0
14;346;1571;1586;15;115;2.0
14;347;1586;1601;15;115;2.0
14;348;1601;1616;15;115;2.0
14;349;1616;1631;15;115;2.0
14;350;1631;1646;15;115;2.0
14;351;1646;1661;15;115;2.0
14;352;1661;1680;19;115;2.0
15;0;260;341;81;159;2.0
15;1;341;344;3;159;2.0
15;2;344;346;2;159;2.0
15;3;346;347;1;159;2.0
15;4;347;349;2;159;2.0
15;5;349;351;2;159;2.0
15;6;351;356;5;159;2.0
15;7;356;357;1;159;2.0
15;8;357;358;1;159;2.0
15;9;358;359;1;159;2.0
15;10;359;363;4;159;2.0
15;11;363;364;1;159;2.0
15;12;364;365;1;159;2.0
15;13;365;366;1;159;2.0
15;14;366;369;3;159;2.0
15;15;369;371;2;159;2.0
15;16;371;373;2;159;2.0
15;17;373;374;1;159;2.0
15;18;374;375;1;159;2.0
15;19;375;377;2;159;2.0
15;20;377;381;4;159;2.0
15;21;381;382;1;159;2.0
15;22;382;385;3;159;2.0
15;23;385;386;1;159;2.0
15;24;386;391;5;159;2.0
15;25;391;395;4;159;2.0
15;26;395;397;2;159;2.0
15;27;397;398;1;159;2.0
15;28;398;403;5;159;2.0
15;29;403;404;1;159;2.0
15;30;404;405;1;159;2.0
15;31;405;406;1;159;2.0
15;32;406;408;2;159;2.0
15;33;408;412;4;159;2.0
15;34;412;414;2;159;2.0
15;35;414;415;1;159;2.0
15;36;415;416;1;159;2.0
15;37;416;418;2;159;2.0
15;38;418;419;1;159;2.0
15;39;419;421;2;159;2.0
15;40;421;424;3;159;2.0
15;41;424;426;2;159;2.0
15;42;426;430;4;159;2.0
15;43;430;432;2;159;2.0
15;44;432;433;1;159;2.0
15;45;433;434;1;159;2.0
15;46;434;435;1;159;2.0
15;47;435;436;1;159;2.0
15;48;436;437;1;159;2.0
15;49;437;441;4;159;2.0
15;50;441;443;2;159;2.0
15;51;443;445;2;159;2.0
15;52;445;446;1;159;2.0
15;53;446;447;1;159;2.0
15;54;447;449;2;159;2.0
15;55;449;456;7;159;2.0
15;56;456;458;2;159;2.0
15;57;458;461;3;159;2.0
15;58;461;462;1;159;2.0
15;59;462;464;2;159;2.0
15;60;464;465;1;159;2.0
15;61;465;466;1;159;2.0
15;62;466;467;1;159;2.0
15;63;467;471;4;159;2.0
15;64;471;475;4;159;2.0
15;65;475;476;1;159;2.0
15;66;476;477;1;159;2.0
15;67;477;479;2;159;2.0
15;68;479;481;2;159;2.0
15;69;481;483;2;159;2.0
15;70;483;485;2;159;2.0
15;71;485;486;1;159;2.0
15;72;486;491;5;159;2.0
15;73;491;493;2;159;2.0
15;74;493;494;1;159;2.0
15;75;494;495;1;159;2.0
15;76;495;498;3;159;2.0
15;77;498;500;2;159;2.0
15;78;500;506;6;159;2.0
15;79;506;509;3;159;2.0
15;80;509;511;2;159;2.0
15;81;511;515;4;159;2.0
15;82;515;516;1;159;2.0
15;83;516;517;1;159;2.0
15;84;517;521;4;159;2.0
15;85;521;525;4;159;2.0
15;86;525;528;3;159;2.0
15;87;528;533;5;159;2.0
15;88;533;539;6;159;2.0
15;89;539;541;2;159;2.0
15;90;541;549;8;159;2.0
15;91;549;550;1;159;2.0
15;92;550;555;5;159;2.0
15;93;555;560;5;159;2.0
15;94;560;561;1;159;2.0
15;95;561;562;1;159;2.0
15;96;562;565;3;159;2.0
15;97;565;580;15;159;2.0
15;98;580;584;4;159;2.0
15;99;584;589;5;159;2.0
15;100;589;596;7;159;2.0
15;101;596;597;1;159;2.0
15;102;597;603;6;159;2.0
15;103;603;604;1;159;2.0
15;104;604;605;1;159;2.0
15;105;605;610;5;159;2.0
15;106;610;629;19;159;2.0
15;107;629;631;2;159;2.0
15;108;631;637;6;159;2.0
15;109;637;638;1;159;2.0
15;110;638;640;2;159;2.0
15;111;640;641;1;159;2.0
15;112;641;643;2;159;2.0
15;113;643;645;2;159;2.0
15;114;645;646;1;159;2.0
15;115;646;666;20;159;2.0
15;116;666;667;1;159;2.0
15;117;667;670;3;159;2.0
15;118;670;673;3;159;2.0
15;119;673;681;8;159;2.0
15;120;681;684;3;159;2.0
15;121;684;695;11;159;2.0
15;122;695;700;5;159;2.0
15;123;700;704;4;159;2.0
15;124;704;707;3;159;2.0
15;125;707;708;1;159;2.0
15;126;708;715;7;159;2.0
15;127;715;716;1;159;2.0
15;128;716;726;10;159;2.0
15;129;726;730;4;159;2.0
15;130;730;734;4;159;2.0
15;131;734;737;3;159;2.0
15;132;737;738;1;159;2.0
15;133;738;743;5;159;2.0
15;134;743;749;6;159;2.0
15;135;749;751;2;159;2.0
15;136;751;756;5;159;2.0
15;137;756;762;6;159;2.0
15;138;762;763;1;159;2.0
15;139;763;771;8;159;2.0
15;140;771;775;4;159;2.0
15;141;775;776;1;159;2.0
15;142;776;778;2;159;2.0
15;143;778;779;1;159;2.0
15;144;779;783;4;159;2.0
15;145;783;787;4;159;2.0
15;146;787;790;3;159;2.0
15;147;790;796;6;159;2.0
15;148;796;803;7;159;2.0
15;149;803;804;1;159;2.0
15;150;804;805;1;159;2.0
15;151;805;808;3;159;2.0
15;152;808;809;1;159;2.0
15;153;809;811;2;159;2.0
15;154;811;812;1;159;2.0
15;155;812;814;2;159;2.0
15;156;814;817;3;159;2.0
15;157;817;819;2;159;2.0
15;158;819;822;3;159;2.0
15;159;822;826;4;159;2.0
15;160;826;831;5;159;2.0
15;161;831;832;1;159;2.0
15;162;832;833;1;159;2.0
15;163;833;835;2;159;2.0
15;164;835;836;1;159;2.0
15;165;836;837;1;159;2.0
15;166;837;843;6;159;2.0
15;167;843;844;1;159;2.0
15;168;844;845;1;159;2.0
15;169;845;846;1;159;2.0
15;170;846;848;2;159;2.0
15;171;848;850;2;159;2.0
15;172;850;853;3;159;2.0
15;173;853;857;4;159;2.0
15;174;857;858;1;159;2.0
15;175;858;861;3;159;2.0
15;176;861;863;2;159;2.0
15;177;863;867;4;159;2.0
15;178;867;869;2;159;2.0
15;179;869;870;1;159;2.0
15;180;870;872;2;159;2.0
15;181;872;874;2;159;2.0
15;182;874;878;4;159;2.0
15;183;878;880;2;159;2.0
15;184;880;881;1;159;2.0
15;185;881;884;3;159;2.0
15;186;884;892;8;159;2.0
15;187;892;893;1;159;2.0
15;188;893;895;2;159;2.0
15;189;895;896;1;159;2.0
15;190;896;897;1;159;2.0
15;191;897;900;3;159;2.0
15;192;900;903;3;159;2.0
15;193;903;907;4;159;2.0
15;194;907;910;3;159;2.0
15;195;910;913;3;159;2.0
15;196;913;914;1;159;2.0
15;197;914;915;1;159;2.0
15;198;915;916;1;159;2.0
15;199;916;918;2;159;2.0
15;200;918;922;4;159;2.0
15;201;922;923;1;159;2.0
15;202;923;924;1;159;2.0
15;203;924;925;1;159;2.0
15;204;925;928;3;159;2.0
15;205;928;929;1;159;2.0
15;206;929;930;1;159;2.0
15;207;930;931;1;159;2.0
15;208;931;933;2;159;2.0
15;209;933;936;3;159;2.0
15;210;936;937;1;159;2.0
15;211;937;939;2;159;2.0
15;212;939;940;1;159;2.0
15;213;940;941;1;159;2.0
15;214;941;943;2;159;2.0
15;215;943;950;7;159;2.0
15;216;950;951;1;159;2.0
15;217;951;952;1;159;2.0
15;218;952;953;1;159;2.0
15;219;953;955;2;159;2.0
15;220;955;956;1;159;2.0
15;221;956;958;2;159;2.0
15;222;958;967;9;159;2.0
15;223;967;970;3;159;2.0
15;224;970;971;1;159;2.0
15;225;971;973;2;159;2.0
15;226;973;974;1;159;2.0
15;227;974;978;4;159;2.0
15;228;978;983;5;159;2.0
15;229;983;984;1;159;2.0
15;230;984;985;1;159;2.0
15;231;985;987;2;159;2.0
15;232;987;988;1;159;2.0
15;233;988;989;1;159;2.0
15;234;989;990;1;159;2.0
15;235;990;991;1;159;2.0
15;236;991;993;2;159;2.0
15;237;993;994;1;159;2.0
15;238;994;1005;11;159;2.0
15;239;1005;1011;6;159;2.0
15;240;1011;1012;1;159;2.0
15;241;1012;1013;1;159;2.0
15;242;1013;1015;2;159;2.0
15;243;1015;1016;1;159;2.0
15;244;1016;1018;2;159;2.0
15;245;1018;1023;5;159;2.0
15;246;1023;1024;1;159;2.0
15;247;1024;1026;2;159;2.0
15;248;1026;1029;3;159;2.0
15;249;1029;1031;2;159;2.0
15;250;1031;1033;2;159;2.0
15;251;1033;1034;1;159;2.0
15;252;1034;1035;1;159;2.0
15;253;1035;1038;3;159;2.0
15;254;1038;1041;3;159;2.0
15;255;1041;1043;2;159;2.0
15;256;1043;1046;3;159;2.0
15;257;1046;1048;2;159;2.0
15;258;1048;1050;2;159;2.0
15;259;1050;1053;3;159;2.0
15;260;1053;1055;2;159;2.0
15;261;1055;1056;1;159;2.0
15;262;1056;1059;3;159;2.0
15;263;1059;1061;2;159;2.0
15;264;1061;1063;2;159;2.0
15;265;1063;1071;8;159;2.0
15;266;1071;1073;2;159;2.0
15;267;1073;1078;5;159;2.0
15;268;1078;1081;3;159;2.0
15;269;1081;1086;5;159;2.0
15;270;1086;1090;4;159;2.0
15;271;1090;1093;3;159;2.0
15;272;1093;1094;1;159;2.0
15;273;1094;1095;1;159;2.0
15;274;1095;1096;1;159;2.0
15;275;1096;1101;5;159;2.0
15;276;1101;1106;5;159;2.0
15;277;1106;1107;1;159;2.0
15;278;1107;1110;3;159;2.0
15;279;1110;1113;3;159;2.0
15;280;1113;1114;1;159;2.0
15;281;1114;1117;3;159;2.0
15;282;1117;1119;2;159;2.0
15;283;1119;1121;2;159;2.0
15;284;1121;1127;6;159;2.0
15;285;1127;1133;6;159;2.0
15;286;1133;1134;1;159;2.0
15;287;1134;1138;4;159;2.0
15;288;1138;1149;11;159;2.0
15;289;1149;1150;1;159;2.0
15;290;1150;1153;3;159;2.0
15;291;1153;1160;7;159;2.0
15;292;1160;1164;4;159;2.0
15;293;1164;1179;15;159;2.0
15;294;1179;1183;4;159;2.0
15;295;1183;1189;6;159;2.0
15;296;1189;1190;1;159;2.0
15;297;1190;1193;3;159;2.0
15;298;1193;1211;18;159;2.0
15;299;1211;1219;8;159;2.0
15;300;1219;1220;1;159;2.0
15;301;1220;1224;4;159;2.0
15;302;1224;1231;7;159;2.0
15;303;1231;1233;2;159;2.0
15;304;1233;1237;4;159;2.0
15;305;1237;1239;2;159;2.0
15;306;1239;1254;15;159;2.0
15;307;1254;1268;14;159;2.0
15;308;1268;1273;5;159;2.0
15;309;1273;1275;2;159;2.0
15;310;1275;1277;2;159;2.0
15;311;1277;1280;3;159;2.0
15;312;1280;1284;4;159;2.0
15;313;1284;1293;9;159;2.0
15;314;1293;1295;2;159;2.0
15;315;1295;1299;4;159;2.0
15;316;1299;1308;9;159;2.0
15;317;1308;1314;6;159;2.0
15;318;1314;1322;8;159;2.0
15;319;1322;1330;8;159;2.0
15;320;1330;1334;4;159;2.0
15;321;1334;1335;1;159;2.0
15;322;1335;1338;3;159;2.0
15;323;1338;1347;9;159;2.0
15;324;1347;1350;3;159;2.0
15;325;1350;1352;2;159;2.0
15;326;1352;1358;6;159;2.0
15;327;1358;1365;7;159;2.0
15;328;1365;1367;2;159;2.0
15;329;1367;1372;5;159;2.0
15;330;1372;1374;2;159;2.0
15;331;1374;1375;1;159;2.0
15;332;1375;1376;1;159;2.0
15;333;1376;1379;3;159;2.0
15;334;1379;1382;3;159;2.0
15;335;1382;1383;1;159;2.0
15;336;1383;1389;6;159;2.0
15;337;1389;1393;4;159;2.0
15;338;1393;1394;1;159;2.0
15;339;1394;1398;4;159;2.0
15;340;1398;1408;10;159;2.0
15;341;1408;1423;15;159;2.0
15;342;1423;1438;15;159;2.0
15;343;1438;1453;15;159;2.0
15;344;1453;1468;15;159;2.0
15;345;1468;1483;15;159;2.0
15;346;1483;1498;15;159;2.0
15;347;1498;1513;15;159;2.0
15;348;1513;1528;15;159;2.0
15;349;1528;1543;15;159;2.0
15;350;1543;1558;15;159;2.0
15;351;1558;1573;15;159;2.0
15;352;1573;1588;15;159;2.0
15;353;1588;1603;15;159;2.0
15;354;1603;1618;15;159;2.0
15;355;1618;1633;15;159;2.0
15;356;1633;1648;15;159;2.0
15;357;1648;1680;32;159;2.0
16;0;247;325;78;14;2.0
16;1;325;333;8;14;2.0
16;2;333;334;1;14;2.0
16;3;334;335;1;14;2.0
16;4;335;336;1;14;2.0
16;5;336;337;1;14;2.0
16;6;337;341;4;14;2.0
16;7;341;342;1;14;2.0
16;8;342;344;2;14;2.0
16;9;344;346;2;14;2.0
16;10;346;350;4;14;2.0
16;11;350;352;2;14;2.0
16;12;352;355;3;14;2.0
16;13;355;356;1;14;2.0
16;14;356;357;1;14;2.0
16;15;357;360;3;14;2.0
16;16;360;361;1;14;2.0
16;17;361;362;1;14;2.0
16;18;362;364;2;14;2.0
16;19;364;365;1;14;2.0
16;20;365;367;2;14;2.0
16;21;367;370;3;14;2.0
16;22;370;374;4;14;2.0
16;23;374;376;2;14;2.0
16;24;376;384;8;14;2.0
16;25;384;385;1;14;2.0
16;26;385;387;2;14;2.0
16;27;387;388;1;14;2.0
16;28;388;390;2;14;2.0
16;29;390;392;2;14;2.0
16;30;392;394;2;14;2.0
16;31;394;395;1;14;2.0
16;32;395;397;2;14;2.0
16;33;397;400;3;14;2.0
16;34;400;402;2;14;2.0
16;35;402;403;1;14;2.0
16;36;403;405;2;14;2.0
16;37;405;409;4;14;2.0
16;38;409;410;1;14;2.0
16;39;410;412;2;14;2.0
16;40;412;414;2;14;2.0
16;41;414;419;5;14;2.0
16;42;419;420;1;14;2.0
16;43;420;421;1;14;2.0
16;44;421;424;3;14;2.0
16;45;424;425;1;14;2.0
16;46;425;427;2;14;2.0
16;47;427;429;2;14;2.0
16;48;429;430;1;14;2.0
16;49;430;433;3;14;2.0
16;50;433;434;1;14;2.0
16;51;434;435;1;14;2.0
16;52;435;436;1;14;2.0
16;53;436;440;4;14;2.0
16;54;440;442;2;14;2.0
16;55;442;447;5;14;2.0
16;56;447;448;1;14;2.0
16;57;448;449;1;14;2.0
16;58;449;450;1;14;2.0
16;59;450;451;1;14;2.0
16;60;451;454;3;14;2.0
16;61;454;455;1;14;2.0
16;62;455;456;1;14;2.0
16;63;456;457;1;14;2.0
16;64;457;460;3;14;2.0
16;65;460;464;4;14;2.0
16;66;464;466;2;14;2.0
16;67;466;471;5;14;2.0
16;68;471;472;1;14;2.0
16;69;472;475;3;14;2.0
16;70;475;476;1;14;2.0
16;71;476;481;5;14;2.0
16;72;481;483;2;14;2.0
16;73;483;485;2;14;2.0
16;74;485;487;2;14;2.0
16;75;487;489;2;14;2.0
16;76;489;490;1;14;2.0
16;77;490;495;5;14;2.0
16;78;495;497;2;14;2.0
16;79;497;502;5;14;2.0
16;80;502;503;1;14;2.0
16;81;503;504;1;14;2.0
16;82;504;505;1;14;2.0
16;83;505;507;2;14;2.0
16;84;507;514;7;14;2.0
16;85;514;516;2;14;2.0
16;86;516;518;2;14;2.0
16;87;518;525;7;14;2.0
16;88;525;529;4;14;2.0
16;89;529;535;6;14;2.0
16;90;535;540;5;14;2.0
16;91;540;541;1;14;2.0
16;92;541;546;5;14;2.0
16;93;546;547;1;14;2.0
16;94;547;549;2;14;2.0
16;95;549;552;3;14;2.0
16;96;552;553;1;14;2.0
16;97;553;554;1;14;2.0
16;98;554;573;19;14;2.0
16;99;573;580;7;14;2.0
16;100;580;581;1;14;2.0
16;101;581;584;3;14;2.0
16;102;584;589;5;14;2.0
16;103;589;595;6;14;2.0
16;104;595;596;1;14;2.0
16;105;596;597;1;14;2.0
16;106;597;598;1;14;2.0
16;107;598;601;3;14;2.0
16;108;601;612;11;14;2.0
16;109;612;619;7;14;2.0
16;110;619;624;5;14;2.0
16;111;624;630;6;14;2.0
16;112;630;632;2;14;2.0
16;113;632;633;1;14;2.0
16;114;633;634;1;14;2.0
16;115;634;654;20;14;2.0
16;116;654;660;6;14;2.0
16;117;660;661;1;14;2.0
16;118;661;665;4;14;2.0
16;119;665;666;1;14;2.0
16;120;666;674;8;14;2.0
16;121;674;677;3;14;2.0
16;122;677;685;8;14;2.0
16;123;685;693;8;14;2.0
16;124;693;694;1;14;2.0
16;125;694;700;6;14;2.0
16;126;700;707;7;14;2.0
16;127;707;718;11;14;2.0
16;128;718;719;1;14;2.0
16;129;719;721;2;14;2.0
16;130;721;724;3;14;2.0
16;131;724;727;3;14;2.0
16;132;727;731;4;14;2.0
16;133;731;732;1;14;2.0
16;134;732;735;3;14;2.0
16;135;735;739;4;14;2.0
16;136;739;750;11;14;2.0
16;137;750;752;2;14;2.0
16;138;752;753;1;14;2.0
16;139;753;760;7;14;2.0
16;140;760;764;4;14;2.0
16;141;764;767;3;14;2.0
16;142;767;772;5;14;2.0
16;143;772;774;2;14;2.0
16;144;774;775;1;14;2.0
16;145;775;781;6;14;2.0
16;146;781;787;6;14;2.0
16;147;787;793;6;14;2.0
16;148;793;795;2;14;2.0
16;149;795;799;4;14;2.0
16;150;799;801;2;14;2.0
16;151;801;802;1;14;2.0
16;152;802;804;2;14;2.0
16;153;804;806;2;14;2.0
16;154;806;810;4;14;2.0
16;155;810;812;2;14;2.0
16;156;812;817;5;14;2.0
16;157;817;820;3;14;2.0
16;158;820;821;1;14;2.0
16;159;821;822;1;14;2.0
16;160;822;823;1;14;2.0
16;161;823;825;2;14;2.0
16;162;825;827;2;14;2.0
16;163;827;831;4;14;2.0
16;164;831;836;5;14;2.0
16;165;836;837;1;14;2.0
16;166;837;838;1;14;2.0
16;167;838;841;3;14;2.0
16;168;841;843;2;14;2.0
16;169;843;845;2;14;2.0
16;170;845;853;8;14;2.0
16;171;853;854;1;14;2.0
16;172;854;855;1;14;2.0
16;173;855;856;1;14;2.0
16;174;856;859;3;14;2.0
16;175;859;861;2;14;2.0
16;176;861;862;1;14;2.0
16;177;862;865;3;14;2.0
16;178;865;867;2;14;2.0
16;179;867;868;1;14;2.0
16;180;868;870;2;14;2.0
16;181;870;871;1;14;2.0
16;182;871;875;4;14;2.0
16;183;875;877;2;14;2.0
16;184;877;880;3;14;2.0
16;185;880;882;2;14;2.0
16;186;882;884;2;14;2.0
16;187;884;886;2;14;2.0
16;188;886;887;1;14;2.0
16;189;887;888;1;14;2.0
16;190;888;889;1;14;2.0
16;191;889;891;2;14;2.0
16;192;891;892;1;14;2.0
16;193;892;894;2;14;2.0
16;194;894;895;1;14;2.0
16;195;895;900;5;14;2.0
16;196;900;901;1;14;2.0
16;197;901;903;2;14;2.0
16;198;903;906;3;14;2.0
16;199;906;908;2;14;2.0
16;200;908;910;2;14;2.0
16;201;910;911;1;14;2.0
16;202;911;914;3;14;2.0
16;203;914;915;1;14;2.0
16;204;915;916;1;14;2.0
16;205;916;917;1;14;2.0
16;206;917;919;2;14;2.0
16;207;919;924;5;14;2.0
16;208;924;925;1;14;2.0
16;209;925;929;4;14;2.0
16;210;929;931;2;14;2.0
16;211;931;933;2;14;2.0
16;212;933;935;2;14;2.0
16;213;935;939;4;14;2.0
16;214;939;940;1;14;2.0
16;215;940;941;1;14;2.0
16;216;941;944;3;14;2.0
16;217;944;945;1;14;2.0
16;218;945;947;2;14;2.0
16;219;947;948;1;14;2.0
16;220;948;951;3;14;2.0
16;221;951;954;3;14;2.0
16;222;954;955;1;14;2.0
16;223;955;961;6;14;2.0
16;224;961;963;2;14;2.0
16;225;963;965;2;14;2.0
16;226;965;968;3;14;2.0
16;227;968;969;1;14;2.0
16;228;969;974;5;14;2.0
16;229;974;975;1;14;2.0
16;230;975;976;1;14;2.0
16;231;976;977;1;14;2.0
16;232;977;979;2;14;2.0
16;233;979;981;2;14;2.0
16;234;981;984;3;14;2.0
16;235;984;985;1;14;2.0
16;236;985;995;10;14;2.0
16;237;995;996;1;14;2.0
16;238;996;999;3;14;2.0
16;239;999;1000;1;14;2.0
16;240;1000;1002;2;14;2.0
16;241;1002;1003;1;14;2.0
16;242;1003;1005;2;14;2.0
16;243;1005;1007;2;14;2.0
16;244;1007;1008;1;14;2.0
16;245;1008;1009;1;14;2.0
16;246;1009;1011;2;14;2.0
16;247;1011;1013;2;14;2.0
16;248;1013;1017;4;14;2.0
16;249;1017;1019;2;14;2.0
16;250;1019;1022;3;14;2.0
16;251;1022;1023;1;14;2.0
16;252;1023;1024;1;14;2.0
16;253;1024;1025;1;14;2.0
16;254;1025;1033;8;14;2.0
16;255;1033;1036;3;14;2.0
16;256;1036;1037;1;14;2.0
16;257;1037;1039;2;14;2.0
16;258;1039;1041;2;14;2.0
16;259;1041;1043;2;14;2.0
16;260;1043;1045;2;14;2.0
16;261;1045;1046;1;14;2.0
16;262;1046;1049;3;14;2.0
16;263;1049;1056;7;14;2.0
16;264;1056;1064;8;14;2.0
16;265;1064;1065;1;14;2.0
16;266;1065;1067;2;14;2.0
16;267;1067;1068;1;14;2.0
16;268;1068;1071;3;14;2.0
16;269;1071;1077;6;14;2.0
16;270;1077;1080;3;14;2.0
16;271;1080;1082;2;14;2.0
16;272;1082;1085;3;14;2.0
16;273;1085;1086;1;14;2.0
16;274;1086;1089;3;14;2.0
16;275;1089;1093;4;14;2.0
16;276;1093;1097;4;14;2.0
16;277;1097;1101;4;14;2.0
16;278;1101;1104;3;14;2.0
16;279;1104;1107;3;14;2.0
16;280;1107;1112;5;14;2.0
16;281;1112;1114;2;14;2.0
16;282;1114;1117;3;14;2.0
16;283;1117;1120;3;14;2.0
16;284;1120;1127;7;14;2.0
16;285;1127;1141;14;14;2.0
16;286;1141;1142;1;14;2.0
16;287;1142;1143;1;14;2.0
16;288;1143;1144;1;14;2.0
16;289;1144;1152;8;14;2.0
16;290;1152;1154;2;14;2.0
16;291;1154;1155;1;14;2.0
16;292;1155;1172;17;14;2.0
16;293;1172;1174;2;14;2.0
16;294;1174;1180;6;14;2.0
16;295;1180;1181;1;14;2.0
16;296;1181;1204;23;14;2.0
16;297;1204;1209;5;14;2.0
16;298;1209;1212;3;14;2.0
16;299;1212;1216;4;14;2.0
16;300;1216;1224;8;14;2.0
16;301;1224;1227;3;14;2.0
16;302;1227;1232;5;14;2.0
16;303;1232;1255;23;14;2.0
16;304;1255;1261;6;14;2.0
16;305;1261;1264;3;14;2.0
16;306;1264;1267;3;14;2.0
16;307;1267;1268;1;14;2.0
16;308;1268;1272;4;14;2.0
16;309;1272;1276;4;14;2.0
16;310;1276;1284;8;14;2.0
16;311;1284;1285;1;14;2.0
16;312;1285;1292;7;14;2.0
16;313;1292;1295;3;14;2.0
16;314;1295;1306;11;14;2.0
16;315;1306;1308;2;14;2.0
16;316;1308;1314;6;14;2.0
16;317;1314;1327;13;14;2.0
16;318;1327;1328;1;14;2.0
16;319;1328;1330;2;14;2.0
16;320;1330;1335;5;14;2.0
16;321;1335;1339;4;14;2.0
16;322;1339;1341;2;14;2.0
16;323;1341;1348;7;14;2.0
16;324;1348;1357;9;14;2.0
16;325;1357;1358;1;14;2.0
16;326;1358;1359;1;14;2.0
16;327;1359;1366;7;14;2.0
16;328;1366;1369;3;14;2.0
16;329;1369;1370;1;14;2.0
16;330;1370;1371;1;14;2.0
16;331;1371;1378;7;14;2.0
16;332;1378;1381;3;14;2.0
16;333;1381;1383;2;14;2.0
16;334;1383;1389;6;14;2.0
16;335;1389;1392;3;14;2.0
16;336;1392;1398;6;14;2.0
16;337;1398;1413;15;14;2.0
16;338;1413;1428;15;14;2.0
16;339;1428;1443;15;14;2.0
16;340;1443;1458;15;14;2.0
16;341;1458;1473;15;14;2.0
16;342;1473;1488;15;14;2.0
16;343;1488;1503;15;14;2.0
16;344;1503;1518;15;14;2.0
16;345;1518;1533;15;14;2.0
16;346;1533;1548;15;14;2.0
16;347;1548;1563;15;14;2.0
16;348;1563;1578;15;14;2.0
16;349;1578;1593;15;14;2.0
16;350;1593;1608;15;14;2.0
16;351;1608;1623;15;14;2.0
16;352;1623;1638;15;14;2.0
16;353;1638;1653;15;14;2.0
16;354;1653;1668;15;14;2.0
16;355;1668;1680;12;14;2.0
17;0;252;333;81;99;2.0
17;1;333;336;3;99;2.0
17;2;336;338;2;99;2.0
17;3;338;339;1;99;2.0
17;4;339;340;1;99;2.0
17;5;340;341;1;99;2.0
17;6;341;344;3;99;2.0
17;7;344;345;1;99;2.0
17;8;345;347;2;99;2.0
17;9;347;349;2;99;2.0
17;10;349;353;4;99;2.0
17;11;353;355;2;99;2.0
17;12;355;358;3;99;2.0
17;13;358;359;1;99;2.0
17;14;359;360;1;99;2.0
17;15;360;361;1;99;2.0
17;16;361;365;4;99;2.0
17;17;365;367;2;99;2.0
17;18;367;368;1;99;2.0
17;19;368;369;1;99;2.0
17;20;369;370;1;99;2.0
17;21;370;376;6;99;2.0
17;22;376;377;1;99;2.0
17;23;377;378;1;99;2.0
17;24;378;379;1;99;2.0
17;25;379;387;8;99;2.0
17;26;387;388;1;99;2.0
17;27;388;390;2;99;2.0
17;28;390;391;1;99;2.0
17;29;391;396;5;99;2.0
17;30;396;398;2;99;2.0
17;31;398;399;1;99;2.0
17;32;399;400;1;99;2.0
17;33;400;403;3;99;2.0
17;34;403;405;2;99;2.0
17;35;405;406;1;99;2.0
17;36;406;408;2;99;2.0
17;37;408;411;3;99;2.0
17;38;411;413;2;99;2.0
17;39;413;415;2;99;2.0
17;40;415;418;3;99;2.0
17;41;418;421;3;99;2.0
17;42;421;422;1;99;2.0
17;43;422;423;1;99;2.0
17;44;423;424;1;99;2.0
17;45;424;427;3;99;2.0
17;46;427;428;1;99;2.0
17;47;428;429;1;99;2.0
17;48;429;430;1;99;2.0
17;49;430;431;1;99;2.0
17;50;431;432;1;99;2.0
17;51;432;435;3;99;2.0
17;52;435;437;2;99;2.0
17;53;437;438;1;99;2.0
17;54;438;439;1;99;2.0
17;55;439;445;6;99;2.0
17;56;445;446;1;99;2.0
17;57;446;450;4;99;2.0
17;58;450;451;1;99;2.0
17;59;451;452;1;99;2.0
17;60;452;455;3;99;2.0
17;61;455;456;1;99;2.0
17;62;456;457;1;99;2.0
17;63;457;458;1;99;2.0
17;64;458;459;1;99;2.0
17;65;459;460;1;99;2.0
17;66;460;465;5;99;2.0
17;67;465;466;1;99;2.0
17;68;466;467;1;99;2.0
17;69;467;469;2;99;2.0
17;70;469;471;2;99;2.0
17;71;471;474;3;99;2.0
17;72;474;475;1;99;2.0
17;73;475;478;3;99;2.0
17;74;478;479;1;99;2.0
17;75;479;480;1;99;2.0
17;76;480;487;7;99;2.0
17;77;487;488;1;99;2.0
17;78;488;490;2;99;2.0
17;79;490;493;3;99;2.0
17;80;493;494;1;99;2.0
17;81;494;500;6;99;2.0
17;82;500;501;1;99;2.0
17;83;501;505;4;99;2.0
17;84;505;507;2;99;2.0
17;85;507;508;1;99;2.0
17;86;508;510;2;99;2.0
17;87;510;513;3;99;2.0
17;88;513;519;6;99;2.0
17;89;519;521;2;99;2.0
17;90;521;528;7;99;2.0
17;91;528;531;3;99;2.0
17;92;531;532;1;99;2.0
17;93;532;538;6;99;2.0
17;94;538;543;5;99;2.0
17;95;543;544;1;99;2.0
17;96;544;549;5;99;2.0
17;97;549;550;1;99;2.0
17;98;550;552;2;99;2.0
17;99;552;553;1;99;2.0
17;100;553;555;2;99;2.0
17;101;555;556;1;99;2.0
17;102;556;559;3;99;2.0
17;103;559;564;5;99;2.0
17;104;564;584;20;99;2.0
17;105;584;586;2;99;2.0
17;106;586;587;1;99;2.0
17;107;587;588;1;99;2.0
17;108;588;598;10;99;2.0
17;109;598;599;1;99;2.0
17;110;599;600;1;99;2.0
17;111;600;604;4;99;2.0
17;112;604;620;16;99;2.0
17;113;620;622;2;99;2.0
17;114;622;627;5;99;2.0
17;115;627;633;6;99;2.0
17;116;633;635;2;99;2.0
17;117;635;636;1;99;2.0
17;118;636;639;3;99;2.0
17;119;639;657;18;99;2.0
17;120;657;663;6;99;2.0
17;121;663;664;1;99;2.0
17;122;664;668;4;99;2.0
17;123;668;669;1;99;2.0
17;124;669;673;4;99;2.0
17;125;673;680;7;99;2.0
17;126;680;684;4;99;2.0
17;127;684;688;4;99;2.0
17;128;688;697;9;99;2.0
17;129;697;703;6;99;2.0
17;130;703;706;3;99;2.0
17;131;706;710;4;99;2.0
17;132;710;718;8;99;2.0
17;133;718;720;2;99;2.0
17;134;720;724;4;99;2.0
17;135;724;727;3;99;2.0
17;136;727;730;3;99;2.0
17;137;730;734;4;99;2.0
17;138;734;738;4;99;2.0
17;139;738;740;2;99;2.0
17;140;740;742;2;99;2.0
17;141;742;753;11;99;2.0
17;142;753;755;2;99;2.0
17;143;755;756;1;99;2.0
17;144;756;763;7;99;2.0
17;145;763;766;3;99;2.0
17;146;766;770;4;99;2.0
17;147;770;772;2;99;2.0
17;148;772;775;3;99;2.0
17;149;775;777;2;99;2.0
17;150;777;778;1;99;2.0
17;151;778;784;6;99;2.0
17;152;784;790;6;99;2.0
17;153;790;798;8;99;2.0
17;154;798;801;3;99;2.0
17;155;801;802;1;99;2.0
17;156;802;804;2;99;2.0
17;157;804;805;1;99;2.0
17;158;805;807;2;99;2.0
17;159;807;815;8;99;2.0
17;160;815;820;5;99;2.0
17;161;820;825;5;99;2.0
17;162;825;826;1;99;2.0
17;163;826;828;2;99;2.0
17;164;828;829;1;99;2.0
17;165;829;830;1;99;2.0
17;166;830;834;4;99;2.0
17;167;834;837;3;99;2.0
17;168;837;839;2;99;2.0
17;169;839;840;1;99;2.0
17;170;840;842;2;99;2.0
17;171;842;844;2;99;2.0
17;172;844;846;2;99;2.0
17;173;846;848;2;99;2.0
17;174;848;850;2;99;2.0
17;175;850;851;1;99;2.0
17;176;851;852;1;99;2.0
17;177;852;857;5;99;2.0
17;178;857;858;1;99;2.0
17;179;858;859;1;99;2.0
17;180;859;862;3;99;2.0
17;181;862;864;2;99;2.0
17;182;864;865;1;99;2.0
17;183;865;870;5;99;2.0
17;184;870;871;1;99;2.0
17;185;871;873;2;99;2.0
17;186;873;874;1;99;2.0
17;187;874;878;4;99;2.0
17;188;878;880;2;99;2.0
17;189;880;885;5;99;2.0
17;190;885;886;1;99;2.0
17;191;886;887;1;99;2.0
17;192;887;889;2;99;2.0
17;193;889;890;1;99;2.0
17;194;890;892;2;99;2.0
17;195;892;894;2;99;2.0
17;196;894;897;3;99;2.0
17;197;897;898;1;99;2.0
17;198;898;904;6;99;2.0
17;199;904;906;2;99;2.0
17;200;906;907;1;99;2.0
17;201;907;909;2;99;2.0
17;202;909;913;4;99;2.0
17;203;913;914;1;99;2.0
17;204;914;917;3;99;2.0
17;205;917;919;2;99;2.0
17;206;919;920;1;99;2.0
17;207;920;921;1;99;2.0
17;208;921;922;1;99;2.0
17;209;922;925;3;99;2.0
17;210;925;927;2;99;2.0
17;211;927;928;1;99;2.0
17;212;928;932;4;99;2.0
17;213;932;934;2;99;2.0
17;214;934;936;2;99;2.0
17;215;936;938;2;99;2.0
17;216;938;942;4;99;2.0
17;217;942;944;2;99;2.0
17;218;944;946;2;99;2.0
17;219;946;947;1;99;2.0
17;220;947;948;1;99;2.0
17;221;948;950;2;99;2.0
17;222;950;952;2;99;2.0
17;223;952;954;2;99;2.0
17;224;954;957;3;99;2.0
17;225;957;961;4;99;2.0
17;226;961;964;3;99;2.0
17;227;964;966;2;99;2.0
17;228;966;967;1;99;2.0
17;229;967;968;1;99;2.0
17;230;968;972;4;99;2.0
17;231;972;977;5;99;2.0
17;232;977;979;2;99;2.0
17;233;979;980;1;99;2.0
17;234;980;981;1;99;2.0
17;235;981;982;1;99;2.0
17;236;982;984;2;99;2.0
17;237;984;987;3;99;2.0
17;238;987;988;1;99;2.0
17;239;988;999;11;99;2.0
17;240;999;1001;2;99;2.0
17;241;1001;1002;1;99;2.0
17;242;1002;1004;2;99;2.0
17;243;1004;1005;1;99;2.0
17;244;1005;1006;1;99;2.0
17;245;1006;1007;1;99;2.0
17;246;1007;1008;1;99;2.0
17;247;1008;1010;2;99;2.0
17;248;1010;1012;2;99;2.0
17;249;1012;1015;3;99;2.0
17;250;1015;1020;5;99;2.0
17;251;1020;1022;2;99;2.0
17;252;1022;1025;3;99;2.0
17;253;1025;1026;1;99;2.0
17;254;1026;1027;1;99;2.0
17;255;1027;1028;1;99;2.0
17;256;1028;1031;3;99;2.0
17;257;1031;1032;1;99;2.0
17;258;1032;1039;7;99;2.0
17;259;1039;1042;3;99;2.0
17;260;1042;1045;3;99;2.0
17;261;1045;1046;1;99;2.0
17;262;1046;1049;3;99;2.0
17;263;1049;1051;2;99;2.0
17;264;1051;1052;1;99;2.0
17;265;1052;1055;3;99;2.0
17;266;1055;1067;12;99;2.0
17;267;1067;1068;1;99;2.0
17;268;1068;1070;2;99;2.0
17;269;1070;1071;1;99;2.0
17;270;1071;1072;1;99;2.0
17;271;1072;1074;2;99;2.0
17;272;1074;1083;9;99;2.0
17;273;1083;1085;2;99;2.0
17;274;1085;1088;3;99;2.0
17;275;1088;1089;1;99;2.0
17;276;1089;1090;1;99;2.0
17;277;1090;1091;1;99;2.0
17;278;1091;1092;1;99;2.0
17;279;1092;1096;4;99;2.0
17;280;1096;1100;4;99;2.0
17;281;1100;1104;4;99;2.0
17;282;1104;1107;3;99;2.0
17;283;1107;1110;3;99;2.0
17;284;1110;1111;1;99;2.0
17;285;1111;1117;6;99;2.0
17;286;1117;1120;3;99;2.0
17;287;1120;1123;3;99;2.0
17;288;1123;1132;9;99;2.0
17;289;1132;1133;1;99;2.0
17;290;1133;1141;8;99;2.0
17;291;1141;1144;3;99;2.0
17;292;1144;1146;2;99;2.0
17;293;1146;1150;4;99;2.0
17;294;1150;1154;4;99;2.0
17;295;1154;1157;3;99;2.0
17;296;1157;1158;1;99;2.0
17;297;1158;1171;13;99;2.0
17;298;1171;1177;6;99;2.0
17;299;1177;1183;6;99;2.0
17;300;1183;1184;1;99;2.0
17;301;1184;1207;23;99;2.0
17;302;1207;1210;3;99;2.0
17;303;1210;1212;2;99;2.0
17;304;1212;1219;7;99;2.0
17;305;1219;1220;1;99;2.0
17;306;1220;1227;7;99;2.0
17;307;1227;1230;3;99;2.0
17;308;1230;1231;1;99;2.0
17;309;1231;1258;27;99;2.0
17;310;1258;1266;8;99;2.0
17;311;1266;1270;4;99;2.0
17;312;1270;1271;1;99;2.0
17;313;1271;1274;3;99;2.0
17;314;1274;1279;5;99;2.0
17;315;1279;1287;8;99;2.0
17;316;1287;1288;1;99;2.0
17;317;1288;1291;3;99;2.0
17;318;1291;1298;7;99;2.0
17;319;1298;1311;13;99;2.0
17;320;1311;1314;3;99;2.0
17;321;1314;1320;6;99;2.0
17;322;1320;1330;10;99;2.0
17;323;1330;1331;1;99;2.0
17;324;1331;1333;2;99;2.0
17;325;1333;1340;7;99;2.0
17;326;1340;1342;2;99;2.0
17;327;1342;1344;2;99;2.0
17;328;1344;1351;7;99;2.0
17;329;1351;1357;6;99;2.0
17;330;1357;1360;3;99;2.0
17;331;1360;1362;2;99;2.0
17;332;1362;1369;7;99;2.0
17;333;1369;1372;3;99;2.0
17;334;1372;1375;3;99;2.0
17;335;1375;1376;1;99;2.0
17;336;1376;1384;8;99;2.0
17;337;1384;1386;2;99;2.0
17;338;1386;1392;6;99;2.0
17;339;1392;1394;2;99;2.0
17;340;1394;1401;7;99;2.0
17;341;1401;1416;15;99;2.0
17;342;1416;1431;15;99;2.0
17;343;1431;1446;15;99;2.0
17;344;1446;1461;15;99;2.0
17;345;1461;1476;15;99;2.0
17;346;1476;1491;15;99;2.0
17;347;1491;1506;15;99;2.0
17;348;1506;1521;15;99;2.0
17;349;1521;1536;15;99;2.0
17;350;1536;1551;15;99;2.0
17;351;1551;1566;15;99;2.0
17;352;1566;1581;15;99;2.0
17;353;1581;1596;15;99;2.0
17;354;1596;1611;15;99;2.0
17;355;1611;1626;15;99;2.0
17;356;1626;1641;15;99;2.0
17;357;1641;1656;15;99;2.0
17;358;1656;1680;24;99;2.0
18;0;246;331;85;501;2.0
18;1;331;332;1;501;2.0
18;2;332;334;2;501;2.0
18;3;334;335;1;501;2.0
18;4;335;336;1;501;2.0
18;5;336;337;1;501;2.0
18;6;337;339;2;501;2.0
18;7;339;340;1;501;2.0
18;8;340;342;2;501;2.0
18;9;342;346;4;501;2.0
18;10;346;349;3;501;2.0
18;11;349;350;1;501;2.0
18;12;350;351;1;501;2.0
18;13;351;354;3;501;2.0
18;14;354;356;2;501;2.0
18;15;356;357;1;501;2.0
18;16;357;359;2;501;2.0
18;17;359;360;1;501;2.0
18;18;360;362;2;501;2.0
18;19;362;364;2;501;2.0
18;20;364;365;1;501;2.0
18;21;365;366;1;501;2.0
18;22;366;367;1;501;2.0
18;23;367;369;2;501;2.0
18;24;369;371;2;501;2.0
18;25;371;375;4;501;2.0
18;26;375;377;2;501;2.0
18;27;377;378;1;501;2.0
18;28;378;382;4;501;2.0
18;29;382;385;3;501;2.0
18;30;385;387;2;501;2.0
18;31;387;388;1;501;2.0
18;32;388;390;2;501;2.0
18;33;390;391;1;501;2.0
18;34;391;394;3;501;2.0
18;35;394;397;3;501;2.0
18;36;397;400;3;501;2.0
18;37;400;401;1;501;2.0
18;38;401;402;1;501;2.0
18;39;402;405;3;501;2.0
18;40;405;409;4;501;2.0
18;41;409;410;1;501;2.0
18;42;410;412;2;501;2.0
18;43;412;414;2;501;2.0
18;44;414;417;3;501;2.0
18;45;417;420;3;501;2.0
18;46;420;421;1;501;2.0
18;47;421;422;1;501;2.0
18;48;422;423;1;501;2.0
18;49;423;424;1;501;2.0
18;50;424;426;2;501;2.0
18;51;426;427;1;501;2.0
18;52;427;430;3;501;2.0
18;53;430;431;1;501;2.0
18;54;431;432;1;501;2.0
18;55;432;435;3;501;2.0
18;56;435;439;4;501;2.0
18;57;439;441;2;501;2.0
18;58;441;447;6;501;2.0
18;59;447;448;1;501;2.0
18;60;448;449;1;501;2.0
18;61;449;452;3;501;2.0
18;62;452;454;2;501;2.0
18;63;454;455;1;501;2.0
18;64;455;456;1;501;2.0
18;65;456;457;1;501;2.0
18;66;457;459;2;501;2.0
18;67;459;466;7;501;2.0
18;68;466;467;1;501;2.0
18;69;467;469;2;501;2.0
18;70;469;470;1;501;2.0
18;71;470;471;1;501;2.0
18;72;471;476;5;501;2.0
18;73;476;478;2;501;2.0
18;74;478;480;2;501;2.0
18;75;480;482;2;501;2.0
18;76;482;484;2;501;2.0
18;77;484;485;1;501;2.0
18;78;485;486;1;501;2.0
18;79;486;497;11;501;2.0
18;80;497;499;2;501;2.0
18;81;499;502;3;501;2.0
18;82;502;505;3;501;2.0
18;83;505;507;2;501;2.0
18;84;507;511;4;501;2.0
18;85;511;516;5;501;2.0
18;86;516;518;2;501;2.0
18;87;518;519;1;501;2.0
18;88;519;520;1;501;2.0
18;89;520;529;9;501;2.0
18;90;529;532;3;501;2.0
18;91;532;535;3;501;2.0
18;92;535;540;5;501;2.0
18;93;540;542;2;501;2.0
18;94;542;546;4;501;2.0
18;95;546;547;1;501;2.0
18;96;547;549;2;501;2.0
18;97;549;551;2;501;2.0
18;98;551;552;1;501;2.0
18;99;552;556;4;501;2.0
18;100;556;559;3;501;2.0
18;101;559;576;17;501;2.0
18;102;576;578;2;501;2.0
18;103;578;587;9;501;2.0
18;104;587;589;2;501;2.0
18;105;589;590;1;501;2.0
18;106;590;591;1;501;2.0
18;107;591;593;2;501;2.0
18;108;593;594;1;501;2.0
18;109;594;596;2;501;2.0
18;110;596;600;4;501;2.0
18;111;600;619;19;501;2.0
18;112;619;624;5;501;2.0
18;113;624;625;1;501;2.0
18;114;625;627;2;501;2.0
18;115;627;631;4;501;2.0
18;116;631;633;2;501;2.0
18;117;633;637;4;501;2.0
18;118;637;639;2;501;2.0
18;119;639;649;10;501;2.0
18;120;649;660;11;501;2.0
18;121;660;661;1;501;2.0
18;122;661;663;2;501;2.0
18;123;663;674;11;501;2.0
18;124;674;679;5;501;2.0
18;125;679;685;6;501;2.0
18;126;685;695;10;501;2.0
18;127;695;698;3;501;2.0
18;128;698;701;3;501;2.0
18;129;701;702;1;501;2.0
18;130;702;707;5;501;2.0
18;131;707;709;2;501;2.0
18;132;709;720;11;501;2.0
18;133;720;721;1;501;2.0
18;134;721;724;3;501;2.0
18;135;724;728;4;501;2.0
18;136;728;730;2;501;2.0
18;137;730;731;1;501;2.0
18;138;731;739;8;501;2.0
18;139;739;744;5;501;2.0
18;140;744;750;6;501;2.0
18;141;750;752;2;501;2.0
18;142;752;753;1;501;2.0
18;143;753;760;7;501;2.0
18;144;760;762;2;501;2.0
18;145;762;767;5;501;2.0
18;146;767;769;2;501;2.0
18;147;769;770;1;501;2.0
18;148;770;781;11;501;2.0
18;149;781;787;6;501;2.0
18;150;787;790;3;501;2.0
18;151;790;798;8;501;2.0
18;152;798;799;1;501;2.0
18;153;799;802;3;501;2.0
18;154;802;804;2;501;2.0
18;155;804;807;3;501;2.0
18;156;807;809;2;501;2.0
18;157;809;811;2;501;2.0
18;158;811;817;6;501;2.0
18;159;817;820;3;501;2.0
18;160;820;822;2;501;2.0
18;161;822;825;3;501;2.0
18;162;825;826;1;501;2.0
18;163;826;827;1;501;2.0
18;164;827;829;2;501;2.0
18;165;829;830;1;501;2.0
18;166;830;836;6;501;2.0
18;167;836;838;2;501;2.0
18;168;838;840;2;501;2.0
18;169;840;842;2;501;2.0
18;170;842;843;1;501;2.0
18;171;843;850;7;501;2.0
18;172;850;852;2;501;2.0
18;173;852;853;1;501;2.0
18;174;853;856;3;501;2.0
18;175;856;858;2;501;2.0
18;176;858;859;1;501;2.0
18;177;859;861;2;501;2.0
18;178;861;862;1;501;2.0
18;179;862;864;2;501;2.0
18;180;864;865;1;501;2.0
18;181;865;868;3;501;2.0
18;182;868;871;3;501;2.0
18;183;871;872;1;501;2.0
18;184;872;874;2;501;2.0
18;185;874;875;1;501;2.0
18;186;875;877;2;501;2.0
18;187;877;881;4;501;2.0
18;188;881;882;1;501;2.0
18;189;882;883;1;501;2.0
18;190;883;885;2;501;2.0
18;191;885;886;1;501;2.0
18;192;886;887;1;501;2.0
18;193;887;889;2;501;2.0
18;194;889;890;1;501;2.0
18;195;890;891;1;501;2.0
18;196;891;893;2;501;2.0
18;197;893;901;8;501;2.0
18;198;901;903;2;501;2.0
18;199;903;905;2;501;2.0
18;200;905;906;1;501;2.0
18;201;906;907;1;501;2.0
18;202;907;908;1;501;2.0
18;203;908;910;2;501;2.0
18;204;910;912;2;501;2.0
18;205;912;913;1;501;2.0
18;206;913;914;1;501;2.0
18;207;914;918;4;501;2.0
18;208;918;919;1;501;2.0
18;209;919;920;1;501;2.0
18;210;920;921;1;501;2.0
18;211;921;922;1;501;2.0
18;212;922;929;7;501;2.0
18;213;929;931;2;501;2.0
18;214;931;933;2;501;2.0
18;215;933;935;2;501;2.0
18;216;935;940;5;501;2.0
18;217;940;941;1;501;2.0
18;218;941;942;1;501;2.0
18;219;942;946;4;501;2.0
18;220;946;947;1;501;2.0
18;221;947;948;1;501;2.0
18;222;948;950;2;501;2.0
18;223;950;953;3;501;2.0
18;224;953;960;7;501;2.0
18;225;960;961;1;501;2.0
18;226;961;962;1;501;2.0
18;227;962;963;1;501;2.0
18;228;963;968;5;501;2.0
18;229;968;969;1;501;2.0
18;230;969;970;1;501;2.0
18;231;970;972;2;501;2.0
18;232;972;973;1;501;2.0
18;233;973;974;1;501;2.0
18;234;974;979;5;501;2.0
18;235;979;980;1;501;2.0
18;236;980;981;1;501;2.0
18;237;981;982;1;501;2.0
18;238;982;984;2;501;2.0
18;239;984;996;12;501;2.0
18;240;996;1000;4;501;2.0
18;241;1000;1001;1;501;2.0
18;242;1001;1002;1;501;2.0
18;243;1002;1006;4;501;2.0
18;244;1006;1010;4;501;2.0
18;245;1010;1017;7;501;2.0
18;246;1017;1018;1;501;2.0
18;247;1018;1019;1;501;2.0
18;248;1019;1020;1;501;2.0
18;249;1020;1023;3;501;2.0
18;250;1023;1024;1;501;2.0
18;251;1024;1025;1;501;2.0
18;252;1025;1029;4;501;2.0
18;253;1029;1030;1;501;2.0
18;254;1030;1032;2;501;2.0
18;255;1032;1033;1;501;2.0
18;256;1033;1036;3;501;2.0
18;257;1036;1038;2;501;2.0
18;258;1038;1046;8;501;2.0
18;259;1046;1049;3;501;2.0
18;260;1049;1050;1;501;2.0
18;261;1050;1052;2;501;2.0
18;262;1052;1060;8;501;2.0
18;263;1060;1061;1;501;2.0
18;264;1061;1068;7;501;2.0
18;265;1068;1070;2;501;2.0
18;266;1070;1072;2;501;2.0
18;267;1072;1080;8;501;2.0
18;268;1080;1082;2;501;2.0
18;269;1082;1086;4;501;2.0
18;270;1086;1091;5;501;2.0
18;271;1091;1092;1;501;2.0
18;272;1092;1094;2;501;2.0
18;273;1094;1097;3;501;2.0
18;274;1097;1100;3;501;2.0
18;275;1100;1101;1;501;2.0
18;276;1101;1104;3;501;2.0
18;277;1104;1107;3;501;2.0
18;278;1107;1112;5;501;2.0
18;279;1112;1116;4;501;2.0
18;280;1116;1117;1;501;2.0
18;281;1117;1120;3;501;2.0
18;282;1120;1127;7;501;2.0
18;283;1127;1136;9;501;2.0
18;284;1136;1140;4;501;2.0
18;285;1140;1147;7;501;2.0
18;286;1147;1151;4;501;2.0
18;287;1151;1154;3;501;2.0
18;288;1154;1155;1;501;2.0
18;289;1155;1174;19;501;2.0
18;290;1174;1176;2;501;2.0
18;291;1176;1177;1;501;2.0
18;292;1177;1180;3;501;2.0
18;293;1180;1187;7;501;2.0
18;294;1187;1202;15;501;2.0
18;295;1202;1209;7;501;2.0
18;296;1209;1211;2;501;2.0
18;297;1211;1224;13;501;2.0
18;298;1224;1227;3;501;2.0
18;299;1227;1237;10;501;2.0
18;300;1237;1258;21;501;2.0
18;301;1258;1262;4;501;2.0
18;302;1262;1265;3;501;2.0
18;303;1265;1267;2;501;2.0
18;304;1267;1271;4;501;2.0
18;305;1271;1274;3;501;2.0
18;306;1274;1284;10;501;2.0
18;307;1284;1285;1;501;2.0
18;308;1285;1297;12;501;2.0
18;309;1297;1302;5;501;2.0
18;310;1302;1309;7;501;2.0
18;311;1309;1311;2;501;2.0
18;312;1311;1321;10;501;2.0
18;313;1321;1324;3;501;2.0
18;314;1324;1325;1;501;2.0
18;315;1325;1332;7;501;2.0
18;316;1332;1341;9;501;2.0
18;317;1341;1346;5;501;2.0
18;318;1346;1348;2;501;2.0
18;319;1348;1356;8;501;2.0
18;320;1356;1363;7;501;2.0
18;321;1363;1365;2;501;2.0
18;322;1365;1366;1;501;2.0
18;323;1366;1368;2;501;2.0
18;324;1368;1369;1;501;2.0
18;325;1369;1376;7;501;2.0
18;326;1376;1383;7;501;2.0
18;327;1383;1385;2;501;2.0
18;328;1385;1389;4;501;2.0
18;329;1389;1394;5;501;2.0
18;330;1394;1398;4;501;2.0
18;331;1398;1413;15;501;2.0
18;332;1413;1428;15;501;2.0
18;333;1428;1443;15;501;2.0
18;334;1443;1458;15;501;2.0
18;335;1458;1473;15;501;2.0
18;336;1473;1488;15;501;2.0
18;337;1488;1503;15;501;2.0
18;338;1503;1518;15;501;2.0
18;339;1518;1533;15;501;2.0
18;340;1533;1548;15;501;2.0
18;341;1548;1563;15;501;2.0
18;342;1563;1578;15;501;2.0
18;343;1578;1593;15;501;2.0
18;344;1593;1608;15;501;2.0
18;345;1608;1623;15;501;2.0
18;346;1623;1638;15;501;2.0
18;347;1638;1653;15;501;2.0
18;348;1653;1668;15;501;2.0
18;349;1668;1680;12;501;2.0
19;0;250;320;70;66;2.0
19;1;320;340;20;66;2.0
19;2;340;341;1;66;2.0
19;3;341;342;1;66;2.0
19;4;342;345;3;66;2.0
19;5;345;346;1;66;2.0
19;6;346;347;1;66;2.0
19;7;347;349;2;66;2.0
19;8;349;350;1;66;2.0
19;9;350;357;7;66;2.0
19;10;357;359;2;66;2.0
19;11;359;362;3;66;2.0
19;12;362;363;1;66;2.0
19;13;363;365;2;66;2.0
19;14;365;367;2;66;2.0
19;15;367;368;1;66;2.0
19;16;368;369;1;66;2.0
19;17;369;372;3;66;2.0
19;18;372;377;5;66;2.0
19;19;377;378;1;66;2.0
19;20;378;380;2;66;2.0
19;21;380;385;5;66;2.0
19;22;385;391;6;66;2.0
19;23;391;392;1;66;2.0
19;24;392;394;2;66;2.0
19;25;394;397;3;66;2.0
19;26;397;399;2;66;2.0
19;27;399;400;1;66;2.0
19;28;400;402;2;66;2.0
19;29;402;403;1;66;2.0
19;30;403;407;4;66;2.0
19;31;407;408;1;66;2.0
19;32;408;410;2;66;2.0
19;33;410;414;4;66;2.0
19;34;414;415;1;66;2.0
19;35;415;416;1;66;2.0
19;36;416;417;1;66;2.0
19;37;417;420;3;66;2.0
19;38;420;422;2;66;2.0
19;39;422;424;2;66;2.0
19;40;424;427;3;66;2.0
19;41;427;428;1;66;2.0
19;42;428;429;1;66;2.0
19;43;429;430;1;66;2.0
19;44;430;431;1;66;2.0
19;45;431;432;1;66;2.0
19;46;432;434;2;66;2.0
19;47;434;435;1;66;2.0
19;48;435;437;2;66;2.0
19;49;437;439;2;66;2.0
19;50;439;440;1;66;2.0
19;51;440;441;1;66;2.0
19;52;441;442;1;66;2.0
19;53;442;447;5;66;2.0
19;54;447;450;3;66;2.0
19;55;450;452;2;66;2.0
19;56;452;454;2;66;2.0
19;57;454;458;4;66;2.0
19;58;458;460;2;66;2.0
19;59;460;461;1;66;2.0
19;60;461;462;1;66;2.0
19;61;462;463;1;66;2.0
19;62;463;464;1;66;2.0
19;63;464;470;6;66;2.0
19;64;470;473;3;66;2.0
19;65;473;477;4;66;2.0
19;66;477;479;2;66;2.0
19;67;479;481;2;66;2.0
19;68;481;482;1;66;2.0
19;69;482;483;1;66;2.0
19;70;483;487;4;66;2.0
19;71;487;489;2;66;2.0
19;72;489;491;2;66;2.0
19;73;491;492;1;66;2.0
19;74;492;493;1;66;2.0
19;75;493;494;1;66;2.0
19;76;494;504;10;66;2.0
19;77;504;505;1;66;2.0
19;78;505;507;2;66;2.0
19;79;507;511;4;66;2.0
19;80;511;512;1;66;2.0
19;81;512;514;2;66;2.0
19;82;514;517;3;66;2.0
19;83;517;523;6;66;2.0
19;84;523;524;1;66;2.0
19;85;524;525;1;66;2.0
19;86;525;529;4;66;2.0
19;87;529;535;6;66;2.0
19;88;535;541;6;66;2.0
19;89;541;542;1;66;2.0
19;90;542;547;5;66;2.0
19;91;547;551;4;66;2.0
19;92;551;552;1;66;2.0
19;93;552;553;1;66;2.0
19;94;553;557;4;66;2.0
19;95;557;559;2;66;2.0
19;96;559;560;1;66;2.0
19;97;560;562;2;66;2.0
19;98;562;565;3;66;2.0
19;99;565;583;18;66;2.0
19;100;583;585;2;66;2.0
19;101;585;590;5;66;2.0
19;102;590;597;7;66;2.0
19;103;597;599;2;66;2.0
19;104;599;600;1;66;2.0
19;105;600;601;1;66;2.0
19;106;601;602;1;66;2.0
19;107;602;603;1;66;2.0
19;108;603;607;4;66;2.0
19;109;607;625;18;66;2.0
19;110;625;628;3;66;2.0
19;111;628;632;4;66;2.0
19;112;632;634;2;66;2.0
19;113;634;636;2;66;2.0
19;114;636;637;1;66;2.0
19;115;637;639;2;66;2.0
19;116;639;640;1;66;2.0
19;117;640;645;5;66;2.0
19;118;645;661;16;66;2.0
19;119;661;667;6;66;2.0
19;120;667;669;2;66;2.0
19;121;669;671;2;66;2.0
19;122;671;682;11;66;2.0
19;123;682;685;3;66;2.0
19;124;685;691;6;66;2.0
19;125;691;703;12;66;2.0
19;126;703;704;1;66;2.0
19;127;704;707;3;66;2.0
19;128;707;710;3;66;2.0
19;129;710;711;1;66;2.0
19;130;711;721;10;66;2.0
19;131;721;727;6;66;2.0
19;132;727;728;1;66;2.0
19;133;728;730;2;66;2.0
19;134;730;732;2;66;2.0
19;135;732;736;4;66;2.0
19;136;736;737;1;66;2.0
19;137;737;739;2;66;2.0
19;138;739;745;6;66;2.0
19;139;745;748;3;66;2.0
19;140;748;757;9;66;2.0
19;141;757;758;1;66;2.0
19;142;758;759;1;66;2.0
19;143;759;765;6;66;2.0
19;144;765;770;5;66;2.0
19;145;770;771;1;66;2.0
19;146;771;775;4;66;2.0
19;147;775;777;2;66;2.0
19;148;777;779;2;66;2.0
19;149;779;781;2;66;2.0
19;150;781;787;6;66;2.0
19;151;787;788;1;66;2.0
19;152;788;794;6;66;2.0
19;153;794;795;1;66;2.0
19;154;795;799;4;66;2.0
19;155;799;803;4;66;2.0
19;156;803;805;2;66;2.0
19;157;805;806;1;66;2.0
19;158;806;808;2;66;2.0
19;159;808;810;2;66;2.0
19;160;810;817;7;66;2.0
19;161;817;824;7;66;2.0
19;162;824;828;4;66;2.0
19;163;828;829;1;66;2.0
19;164;829;830;1;66;2.0
19;165;830;831;1;66;2.0
19;166;831;832;1;66;2.0
19;167;832;835;3;66;2.0
19;168;835;841;6;66;2.0
19;169;841;842;1;66;2.0
19;170;842;843;1;66;2.0
19;171;843;844;1;66;2.0
19;172;844;846;2;66;2.0
19;173;846;848;2;66;2.0
19;174;848;849;1;66;2.0
19;175;849;855;6;66;2.0
19;176;855;859;4;66;2.0
19;177;859;861;2;66;2.0
19;178;861;864;3;66;2.0
19;179;864;865;1;66;2.0
19;180;865;867;2;66;2.0
19;181;867;868;1;66;2.0
19;182;868;872;4;66;2.0
19;183;872;874;2;66;2.0
19;184;874;875;1;66;2.0
19;185;875;876;1;66;2.0
19;186;876;878;2;66;2.0
19;187;878;881;3;66;2.0
19;188;881;882;1;66;2.0
19;189;882;887;5;66;2.0
19;190;887;890;3;66;2.0
19;191;890;891;1;66;2.0
19;192;891;894;3;66;2.0
19;193;894;896;2;66;2.0
19;194;896;897;1;66;2.0
19;195;897;898;1;66;2.0
19;196;898;899;1;66;2.0
19;197;899;901;2;66;2.0
19;198;901;907;6;66;2.0
19;199;907;909;2;66;2.0
19;200;909;910;1;66;2.0
19;201;910;913;3;66;2.0
19;202;913;914;1;66;2.0
19;203;914;915;1;66;2.0
19;204;915;919;4;66;2.0
19;205;919;920;1;66;2.0
19;206;920;921;1;66;2.0
19;207;921;924;3;66;2.0
19;208;924;925;1;66;2.0
19;209;925;929;4;66;2.0
19;210;929;933;4;66;2.0
19;211;933;935;2;66;2.0
19;212;935;937;2;66;2.0
19;213;937;938;1;66;2.0
19;214;938;939;1;66;2.0
19;215;939;942;3;66;2.0
19;216;942;945;3;66;2.0
19;217;945;948;3;66;2.0
19;218;948;949;1;66;2.0
19;219;949;950;1;66;2.0
19;220;950;951;1;66;2.0
19;221;951;952;1;66;2.0
19;222;952;956;4;66;2.0
19;223;956;957;1;66;2.0
19;224;957;959;2;66;2.0
19;225;959;965;6;66;2.0
19;226;965;967;2;66;2.0
19;227;967;968;1;66;2.0
19;228;968;969;1;66;2.0
19;229;969;973;4;66;2.0
19;230;973;975;2;66;2.0
19;231;975;976;1;66;2.0
19;232;976;979;3;66;2.0
19;233;979;980;1;66;2.0
19;234;980;981;1;66;2.0
19;235;981;985;4;66;2.0
19;236;985;987;2;66;2.0
19;237;987;988;1;66;2.0
19;238;988;989;1;66;2.0
19;239;989;990;1;66;2.0
19;240;990;991;1;66;2.0
19;241;991;1003;12;66;2.0
19;242;1003;1004;1;66;2.0
19;243;1004;1005;1;66;2.0
19;244;1005;1007;2;66;2.0
19;245;1007;1008;1;66;2.0
19;246;1008;1009;1;66;2.0
19;247;1009;1011;2;66;2.0
19;248;1011;1012;1;66;2.0
19;249;1012;1014;2;66;2.0
19;250;1014;1017;3;66;2.0
19;251;1017;1023;6;66;2.0
19;252;1023;1024;1;66;2.0
19;253;1024;1025;1;66;2.0
19;254;1025;1029;4;66;2.0
19;255;1029;1030;1;66;2.0
19;256;1030;1032;2;66;2.0
19;257;1032;1035;3;66;2.0
19;258;1035;1039;4;66;2.0
19;259;1039;1041;2;66;2.0
19;260;1041;1044;3;66;2.0
19;261;1044;1053;9;66;2.0
19;262;1053;1055;2;66;2.0
19;263;1055;1056;1;66;2.0
19;264;1056;1065;9;66;2.0
19;265;1065;1067;2;66;2.0
19;266;1067;1069;2;66;2.0
19;267;1069;1075;6;66;2.0
19;268;1075;1076;1;66;2.0
19;269;1076;1077;1;66;2.0
19;270;1077;1085;8;66;2.0
19;271;1085;1086;1;66;2.0
19;272;1086;1087;1;66;2.0
19;273;1087;1089;2;66;2.0
19;274;1089;1093;4;66;2.0
19;275;1093;1094;1;66;2.0
19;276;1094;1095;1;66;2.0
19;277;1095;1097;2;66;2.0
19;278;1097;1098;1;66;2.0
19;279;1098;1103;5;66;2.0
19;280;1103;1106;3;66;2.0
19;281;1106;1108;2;66;2.0
19;282;1108;1110;2;66;2.0
19;283;1110;1111;1;66;2.0
19;284;1111;1113;2;66;2.0
19;285;1113;1121;8;66;2.0
19;286;1121;1122;1;66;2.0
19;287;1122;1123;1;66;2.0
19;288;1123;1125;2;66;2.0
19;289;1125;1133;8;66;2.0
19;290;1133;1145;12;66;2.0
19;291;1145;1148;3;66;2.0
19;292;1148;1152;4;66;2.0
19;293;1152;1153;1;66;2.0
19;294;1153;1154;1;66;2.0
19;295;1154;1160;6;66;2.0
19;296;1160;1161;1;66;2.0
19;297;1161;1162;1;66;2.0
19;298;1162;1181;19;66;2.0
19;299;1181;1183;2;66;2.0
19;300;1183;1185;2;66;2.0
19;301;1185;1186;1;66;2.0
19;302;1186;1193;7;66;2.0
19;303;1193;1211;18;66;2.0
19;304;1211;1214;3;66;2.0
19;305;1214;1215;1;66;2.0
19;306;1215;1220;5;66;2.0
19;307;1220;1228;8;66;2.0
19;308;1228;1231;3;66;2.0
19;309;1231;1233;2;66;2.0
19;310;1233;1243;10;66;2.0
19;311;1243;1246;3;66;2.0
19;312;1246;1268;22;66;2.0
19;313;1268;1273;5;66;2.0
19;314;1273;1274;1;66;2.0
19;315;1274;1280;6;66;2.0
19;316;1280;1281;1;66;2.0
19;317;1281;1291;10;66;2.0
19;318;1291;1303;12;66;2.0
19;319;1303;1308;5;66;2.0
19;320;1308;1314;6;66;2.0
19;321;1314;1316;2;66;2.0
19;322;1316;1320;4;66;2.0
19;323;1320;1324;4;66;2.0
19;324;1324;1332;8;66;2.0
19;325;1332;1333;1;66;2.0
19;326;1333;1334;1;66;2.0
19;327;1334;1348;14;66;2.0
19;328;1348;1352;4;66;2.0
19;329;1352;1354;2;66;2.0
19;330;1354;1356;2;66;2.0
19;331;1356;1362;6;66;2.0
19;332;1362;1369;7;66;2.0
19;333;1369;1371;2;66;2.0
19;334;1371;1372;1;66;2.0
19;335;1372;1373;1;66;2.0
19;336;1373;1375;2;66;2.0
19;337;1375;1385;10;66;2.0
19;338;1385;1388;3;66;2.0
19;339;1388;1389;1;66;2.0
19;340;1389;1396;7;66;2.0
19;341;1396;1401;5;66;2.0
19;342;1401;1404;3;66;2.0
19;343;1404;1419;15;66;2.0
19;344;1419;1434;15;66;2.0
19;345;1434;1449;15;66;2.0
19;346;1449;1464;15;66;2.0
19;347;1464;1479;15;66;2.0
19;348;1479;1494;15;66;2.0
19;349;1494;1509;15;66;2.0
19;350;1509;1524;15;66;2.0
19;351;1524;1539;15;66;2.0
19;352;1539;1554;15;66;2.0
19;353;1554;1569;15;66;2.0
19;354;1569;1584;15;66;2.0
19;355;1584;1599;15;66;2.0
19;356;1599;1614;15;66;2.0
19;357;1614;1629;15;66;2.0
19;358;1629;1644;15;66;2.0
19;359;1644;1659;15;66;2.0
19;360;1659;1680;21;66;2.0
20;0;252;323;71;63;2.0
20;1;323;342;19;63;2.0
20;2;342;343;1;63;2.0
20;3;343;344;1;63;2.0
20;4;344;347;3;63;2.0
20;5;347;348;1;63;2.0
20;6;348;349;1;63;2.0
20;7;349;351;2;63;2.0
20;8;351;353;2;63;2.0
20;9;353;359;6;63;2.0
20;10;359;361;2;63;2.0
20;11;361;364;3;63;2.0
20;12;364;365;1;63;2.0
20;13;365;367;2;63;2.0
20;14;367;369;2;63;2.0
20;15;369;370;1;63;2.0
20;16;370;371;1;63;2.0
20;17;371;374;3;63;2.0
20;18;374;379;5;63;2.0
20;19;379;380;1;63;2.0
20;20;380;382;2;63;2.0
20;21;382;387;5;63;2.0
20;22;387;393;6;63;2.0
20;23;393;394;1;63;2.0
20;24;394;396;2;63;2.0
20;25;396;399;3;63;2.0
20;26;399;401;2;63;2.0
20;27;401;402;1;63;2.0
20;28;402;404;2;63;2.0
20;29;404;405;1;63;2.0
20;30;405;409;4;63;2.0
20;31;409;410;1;63;2.0
20;32;410;413;3;63;2.0
20;33;413;416;3;63;2.0
20;34;416;417;1;63;2.0
20;35;417;418;1;63;2.0
20;36;418;419;1;63;2.0
20;37;419;422;3;63;2.0
20;38;422;424;2;63;2.0
20;39;424;425;1;63;2.0
20;40;425;429;4;63;2.0
20;41;429;430;1;63;2.0
20;42;430;431;1;63;2.0
20;43;431;432;1;63;2.0
20;44;432;433;1;63;2.0
20;45;433;434;1;63;2.0
20;46;434;436;2;63;2.0
20;47;436;437;1;63;2.0
20;48;437;439;2;63;2.0
20;49;439;441;2;63;2.0
20;50;441;442;1;63;2.0
20;51;442;443;1;63;2.0
20;52;443;444;1;63;2.0
20;53;444;449;5;63;2.0
20;54;449;452;3;63;2.0
20;55;452;454;2;63;2.0
20;56;454;456;2;63;2.0
20;57;456;460;4;63;2.0
20;58;460;462;2;63;2.0
20;59;462;463;1;63;2.0
20;60;463;464;1;63;2.0
20;61;464;465;1;63;2.0
20;62;465;466;1;63;2.0
20;63;466;472;6;63;2.0
20;64;472;475;3;63;2.0
20;65;475;479;4;63;2.0
20;66;479;481;2;63;2.0
20;67;481;483;2;63;2.0
20;68;483;484;1;63;2.0
20;69;484;485;1;63;2.0
20;70;485;489;4;63;2.0
20;71;489;491;2;63;2.0
20;72;491;493;2;63;2.0
20;73;493;494;1;63;2.0
20;74;494;495;1;63;2.0
20;75;495;496;1;63;2.0
20;76;496;506;10;63;2.0
20;77;506;507;1;63;2.0
20;78;507;509;2;63;2.0
20;79;509;513;4;63;2.0
20;80;513;514;1;63;2.0
20;81;514;516;2;63;2.0
20;82;516;519;3;63;2.0
20;83;519;525;6;63;2.0
20;84;525;526;1;63;2.0
20;85;526;527;1;63;2.0
20;86;527;531;4;63;2.0
20;87;531;537;6;63;2.0
20;88;537;543;6;63;2.0
20;89;543;544;1;63;2.0
20;90;544;549;5;63;2.0
20;91;549;553;4;63;2.0
20;92;553;554;1;63;2.0
20;93;554;555;1;63;2.0
20;94;555;559;4;63;2.0
20;95;559;561;2;63;2.0
20;96;561;562;1;63;2.0
20;97;562;564;2;63;2.0
20;98;564;567;3;63;2.0
20;99;567;585;18;63;2.0
20;100;585;587;2;63;2.0
20;101;587;592;5;63;2.0
20;102;592;599;7;63;2.0
20;103;599;601;2;63;2.0
20;104;601;602;1;63;2.0
20;105;602;603;1;63;2.0
20;106;603;604;1;63;2.0
20;107;604;605;1;63;2.0
20;108;605;609;4;63;2.0
20;109;609;627;18;63;2.0
20;110;627;630;3;63;2.0
20;111;630;634;4;63;2.0
20;112;634;636;2;63;2.0
20;113;636;638;2;63;2.0
20;114;638;639;1;63;2.0
20;115;639;641;2;63;2.0
20;116;641;642;1;63;2.0
20;117;642;647;5;63;2.0
20;118;647;663;16;63;2.0
20;119;663;669;6;63;2.0
20;120;669;671;2;63;2.0
20;121;671;673;2;63;2.0
20;122;673;684;11;63;2.0
20;123;684;687;3;63;2.0
20;124;687;693;6;63;2.0
20;125;693;705;12;63;2.0
20;126;705;706;1;63;2.0
20;127;706;709;3;63;2.0
20;128;709;712;3;63;2.0
20;129;712;713;1;63;2.0
20;130;713;723;10;63;2.0
20;131;723;729;6;63;2.0
20;132;729;730;1;63;2.0
20;133;730;732;2;63;2.0
20;134;732;734;2;63;2.0
20;135;734;738;4;63;2.0
20;136;738;739;1;63;2.0
20;137;739;741;2;63;2.0
20;138;741;747;6;63;2.0
20;139;747;750;3;63;2.0
20;140;750;759;9;63;2.0
20;141;759;760;1;63;2.0
20;142;760;761;1;63;2.0
20;143;761;767;6;63;2.0
20;144;767;772;5;63;2.0
20;145;772;773;1;63;2.0
20;146;773;777;4;63;2.0
20;147;777;779;2;63;2.0
20;148;779;781;2;63;2.0
20;149;781;783;2;63;2.0
20;150;783;789;6;63;2.0
20;151;789;790;1;63;2.0
20;152;790;796;6;63;2.0
20;153;796;798;2;63;2.0
20;154;798;801;3;63;2.0
20;155;801;805;4;63;2.0
20;156;805;807;2;63;2.0
20;157;807;808;1;63;2.0
20;158;808;810;2;63;2.0
20;159;810;812;2;63;2.0
20;160;812;819;7;63;2.0
20;161;819;826;7;63;2.0
20;162;826;830;4;63;2.0
20;163;830;831;1;63;2.0
20;164;831;832;1;63;2.0
20;165;832;833;1;63;2.0
20;166;833;834;1;63;2.0
20;167;834;837;3;63;2.0
20;168;837;843;6;63;2.0
20;169;843;844;1;63;2.0
20;170;844;845;1;63;2.0
20;171;845;846;1;63;2.0
20;172;846;848;2;63;2.0
20;173;848;850;2;63;2.0
20;174;850;851;1;63;2.0
20;175;851;857;6;63;2.0
20;176;857;861;4;63;2.0
20;177;861;863;2;63;2.0
20;178;863;866;3;63;2.0
20;179;866;867;1;63;2.0
20;180;867;869;2;63;2.0
20;181;869;870;1;63;2.0
20;182;870;874;4;63;2.0
20;183;874;876;2;63;2.0
20;184;876;877;1;63;2.0
20;185;877;878;1;63;2.0
20;186;878;880;2;63;2.0
20;187;880;883;3;63;2.0
20;188;883;884;1;63;2.0
20;189;884;889;5;63;2.0
20;190;889;892;3;63;2.0
20;191;892;893;1;63;2.0
20;192;893;896;3;63;2.0
20;193;896;899;3;63;2.0
20;194;899;900;1;63;2.0
20;195;900;901;1;63;2.0
20;196;901;903;2;63;2.0
20;197;903;909;6;63;2.0
20;198;909;911;2;63;2.0
20;199;911;912;1;63;2.0
20;200;912;915;3;63;2.0
20;201;915;916;1;63;2.0
20;202;916;917;1;63;2.0
20;203;917;921;4;63;2.0
20;204;921;922;1;63;2.0
20;205;922;923;1;63;2.0
20;206;923;926;3;63;2.0
20;207;926;927;1;63;2.0
20;208;927;931;4;63;2.0
20;209;931;935;4;63;2.0
20;210;935;937;2;63;2.0
20;211;937;939;2;63;2.0
20;212;939;940;1;63;2.0
20;213;940;941;1;63;2.0
20;214;941;944;3;63;2.0
20;215;944;947;3;63;2.0
20;216;947;950;3;63;2.0
20;217;950;951;1;63;2.0
20;218;951;952;1;63;2.0
20;219;952;953;1;63;2.0
20;220;953;954;1;63;2.0
20;221;954;958;4;63;2.0
20;222;958;959;1;63;2.0
20;223;959;961;2;63;2.0
20;224;961;967;6;63;2.0
20;225;967;969;2;63;2.0
20;226;969;970;1;63;2.0
20;227;970;971;1;63;2.0
20;228;971;975;4;63;2.0
20;229;975;977;2;63;2.0
20;230;977;978;1;63;2.0
20;231;978;981;3;63;2.0
20;232;981;982;1;63;2.0
20;233;982;983;1;63;2.0
20;234;983;987;4;63;2.0
20;235;987;989;2;63;2.0
20;236;989;990;1;63;2.0
20;237;990;991;1;63;2.0
20;238;991;992;1;63;2.0
20;239;992;993;1;63;2.0
20;240;993;1005;12;63;2.0
20;241;1005;1006;1;63;2.0
20;242;1006;1007;1;63;2.0
20;243;1007;1009;2;63;2.0
20;244;1009;1010;1;63;2.0
20;245;1010;1011;1;63;2.0
20;246;1011;1013;2;63;2.0
20;247;1013;1014;1;63;2.0
20;248;1014;1016;2;63;2.0
20;249;1016;1019;3;63;2.0
20;250;1019;1025;6;63;2.0
20;251;1025;1026;1;63;2.0
20;252;1026;1027;1;63;2.0
20;253;1027;1031;4;63;2.0
20;254;1031;1032;1;63;2.0
20;255;1032;1034;2;63;2.0
20;256;1034;1037;3;63;2.0
20;257;1037;1041;4;63;2.0
20;258;1041;1043;2;63;2.0
20;259;1043;1046;3;63;2.0
20;260;1046;1055;9;63;2.0
20;261;1055;1057;2;63;2.0
20;262;1057;1058;1;63;2.0
20;263;1058;1067;9;63;2.0
20;264;1067;1069;2;63;2.0
20;265;1069;1071;2;63;2.0
20;266;1071;1077;6;63;2.0
20;267;1077;1078;1;63;2.0
20;268;1078;1079;1;63;2.0
20;269;1079;1087;8;63;2.0
20;270;1087;1088;1;63;2.0
20;271;1088;1089;1;63;2.0
20;272;1089;1091;2;63;2.0
20;273;1091;1095;4;63;2.0
20;274;1095;1096;1;63;2.0
20;275;1096;1097;1;63;2.0
20;276;1097;1099;2;63;2.0
20;277;1099;1100;1;63;2.0
20;278;1100;1105;5;63;2.0
20;279;1105;1108;3;63;2.0
20;280;1108;1110;2;63;2.0
20;281;1110;1112;2;63;2.0
20;282;1112;1113;1;63;2.0
20;283;1113;1115;2;63;2.0
20;284;1115;1123;8;63;2.0
20;285;1123;1124;1;63;2.0
20;286;1124;1125;1;63;2.0
20;287;1125;1127;2;63;2.0
20;288;1127;1135;8;63;2.0
20;289;1135;1147;12;63;2.0
20;290;1147;1150;3;63;2.0
20;291;1150;1154;4;63;2.0
20;292;1154;1155;1;63;2.0
20;293;1155;1156;1;63;2.0
20;294;1156;1162;6;63;2.0
20;295;1162;1163;1;63;2.0
20;296;1163;1164;1;63;2.0
20;297;1164;1183;19;63;2.0
20;298;1183;1185;2;63;2.0
20;299;1185;1187;2;63;2.0
20;300;1187;1188;1;63;2.0
20;301;1188;1195;7;63;2.0
20;302;1195;1213;18;63;2.0
20;303;1213;1216;3;63;2.0
20;304;1216;1217;1;63;2.0
20;305;1217;1222;5;63;2.0
20;306;1222;1230;8;63;2.0
20;307;1230;1233;3;63;2.0
20;308;1233;1235;2;63;2.0
20;309;1235;1245;10;63;2.0
20;310;1245;1249;4;63;2.0
20;311;1249;1270;21;63;2.0
20;312;1270;1275;5;63;2.0
20;313;1275;1276;1;63;2.0
20;314;1276;1282;6;63;2.0
20;315;1282;1283;1;63;2.0
20;316;1283;1293;10;63;2.0
20;317;1293;1305;12;63;2.0
20;318;1305;1310;5;63;2.0
20;319;1310;1316;6;63;2.0
20;320;1316;1318;2;63;2.0
20;321;1318;1323;5;63;2.0
20;322;1323;1326;3;63;2.0
20;323;1326;1334;8;63;2.0
20;324;1334;1335;1;63;2.0
20;325;1335;1336;1;63;2.0
20;326;1336;1350;14;63;2.0
20;327;1350;1354;4;63;2.0
20;328;1354;1356;2;63;2.0
20;329;1356;1359;3;63;2.0
20;330;1359;1364;5;63;2.0
20;331;1364;1371;7;63;2.0
20;332;1371;1373;2;63;2.0
20;333;1373;1374;1;63;2.0
20;334;1374;1375;1;63;2.0
20;335;1375;1377;2;63;2.0
20;336;1377;1387;10;63;2.0
20;337;1387;1390;3;63;2.0
20;338;1390;1391;1;63;2.0
20;339;1391;1398;7;63;2.0
20;340;1398;1403;5;63;2.0
20;341;1403;1406;3;63;2.0
20;342;1406;1421;15;63;2.0
20;343;1421;1436;15;63;2.0
20;344;1436;1451;15;63;2.0
20;345;1451;1466;15;63;2.0
20;346;1466;1481;15;63;2.0
20;347;1481;1496;15;63;2.0
20;348;1496;1511;15;63;2.0
20;349;1511;1526;15;63;2.0
20;350;1526;1541;15;63;2.0
20;351;1541;1556;15;63;2.0
20;352;1556;1571;15;63;2.0
20;353;1571;1586;15;63;2.0
20;354;1586;1601;15;63;2.0
20;355;1601;1616;15;63;2.0
20;356;1616;1631;15;63;2.0
20;357;1631;1646;15;63;2.0
20;358;1646;1661;15;63;2.0
20;359;1661;1680;19;63;2.0
21;0;249;329;80;114;2.0
21;1;329;332;3;114;2.0
21;2;332;333;1;114;2.0
21;3;333;335;2;114;2.0
21;4;335;336;1;114;2.0
21;5;336;337;1;114;2.0
21;6;337;338;1;114;2.0
21;7;338;342;4;114;2.0
21;8;342;344;2;114;2.0
21;9;344;347;3;114;2.0
21;10;347;348;1;114;2.0
21;11;348;352;4;114;2.0
21;12;352;353;1;114;2.0
21;13;353;356;3;114;2.0
21;14;356;358;2;114;2.0
21;15;358;359;1;114;2.0
21;16;359;362;3;114;2.0
21;17;362;363;1;114;2.0
21;18;363;364;1;114;2.0
21;19;364;367;3;114;2.0
21;20;367;368;1;114;2.0
21;21;368;371;3;114;2.0
21;22;371;372;1;114;2.0
21;23;372;373;1;114;2.0
21;24;373;374;1;114;2.0
21;25;374;377;3;114;2.0
21;26;377;379;2;114;2.0
21;27;379;384;5;114;2.0
21;28;384;388;4;114;2.0
21;29;388;389;1;114;2.0
21;30;389;392;3;114;2.0
21;31;392;393;1;114;2.0
21;32;393;394;1;114;2.0
21;33;394;397;3;114;2.0
21;34;397;399;2;114;2.0
21;35;399;403;4;114;2.0
21;36;403;407;4;114;2.0
21;37;407;408;1;114;2.0
21;38;408;411;3;114;2.0
21;39;411;412;1;114;2.0
21;40;412;414;2;114;2.0
21;41;414;421;7;114;2.0
21;42;421;422;1;114;2.0
21;43;422;424;2;114;2.0
21;44;424;425;1;114;2.0
21;45;425;427;2;114;2.0
21;46;427;428;1;114;2.0
21;47;428;430;2;114;2.0
21;48;430;432;2;114;2.0
21;49;432;434;2;114;2.0
21;50;434;437;3;114;2.0
21;51;437;438;1;114;2.0
21;52;438;447;9;114;2.0
21;53;447;449;2;114;2.0
21;54;449;451;2;114;2.0
21;55;451;452;1;114;2.0
21;56;452;453;1;114;2.0
21;57;453;454;1;114;2.0
21;58;454;456;2;114;2.0
21;59;456;457;1;114;2.0
21;60;457;466;9;114;2.0
21;61;466;467;1;114;2.0
21;62;467;468;1;114;2.0
21;63;468;472;4;114;2.0
21;64;472;476;4;114;2.0
21;65;476;477;1;114;2.0
21;66;477;479;2;114;2.0
21;67;479;482;3;114;2.0
21;68;482;483;1;114;2.0
21;69;483;484;1;114;2.0
21;70;484;485;1;114;2.0
21;71;485;487;2;114;2.0
21;72;487;489;2;114;2.0
21;73;489;497;8;114;2.0
21;74;497;500;3;114;2.0
21;75;500;502;2;114;2.0
21;76;502;506;4;114;2.0
21;77;506;507;1;114;2.0
21;78;507;508;1;114;2.0
21;79;508;516;8;114;2.0
21;80;516;519;3;114;2.0
21;81;519;522;3;114;2.0
21;82;522;529;7;114;2.0
21;83;529;530;1;114;2.0
21;84;530;532;2;114;2.0
21;85;532;539;7;114;2.0
21;86;539;540;1;114;2.0
21;87;540;544;4;114;2.0
21;88;544;546;2;114;2.0
21;89;546;548;2;114;2.0
21;90;548;552;4;114;2.0
21;91;552;553;1;114;2.0
21;92;553;554;1;114;2.0
21;93;554;556;2;114;2.0
21;94;556;575;19;114;2.0
21;95;575;578;3;114;2.0
21;96;578;587;9;114;2.0
21;97;587;588;1;114;2.0
21;98;588;591;3;114;2.0
21;99;591;592;1;114;2.0
21;100;592;595;3;114;2.0
21;101;595;596;1;114;2.0
21;102;596;599;3;114;2.0
21;103;599;620;21;114;2.0
21;104;620;622;2;114;2.0
21;105;622;627;5;114;2.0
21;106;627;628;1;114;2.0
21;107;628;629;1;114;2.0
21;108;629;634;5;114;2.0
21;109;634;636;2;114;2.0
21;110;636;637;1;114;2.0
21;111;637;654;17;114;2.0
21;112;654;658;4;114;2.0
21;113;658;659;1;114;2.0
21;114;659;662;3;114;2.0
21;115;662;672;10;114;2.0
21;116;672;676;4;114;2.0
21;117;676;686;10;114;2.0
21;118;686;695;9;114;2.0
21;119;695;697;2;114;2.0
21;120;697;698;1;114;2.0
21;121;698;704;6;114;2.0
21;122;704;707;3;114;2.0
21;123;707;715;8;114;2.0
21;124;715;719;4;114;2.0
21;125;719;721;2;114;2.0
21;126;721;722;1;114;2.0
21;127;722;727;5;114;2.0
21;128;727;728;1;114;2.0
21;129;728;732;4;114;2.0
21;130;732;740;8;114;2.0
21;131;740;742;2;114;2.0
21;132;742;744;2;114;2.0
21;133;744;753;9;114;2.0
21;134;753;754;1;114;2.0
21;135;754;764;10;114;2.0
21;136;764;766;2;114;2.0
21;137;766;767;1;114;2.0
21;138;767;772;5;114;2.0
21;139;772;778;6;114;2.0
21;140;778;779;1;114;2.0
21;141;779;781;2;114;2.0
21;142;781;787;6;114;2.0
21;143;787;792;5;114;2.0
21;144;792;795;3;114;2.0
21;145;795;797;2;114;2.0
21;146;797;800;3;114;2.0
21;147;800;802;2;114;2.0
21;148;802;803;1;114;2.0
21;149;803;805;2;114;2.0
21;150;805;807;2;114;2.0
21;151;807;808;1;114;2.0
21;152;808;812;4;114;2.0
21;153;812;817;5;114;2.0
21;154;817;819;2;114;2.0
21;155;819;820;1;114;2.0
21;156;820;822;2;114;2.0
21;157;822;823;1;114;2.0
21;158;823;824;1;114;2.0
21;159;824;827;3;114;2.0
21;160;827;828;1;114;2.0
21;161;828;829;1;114;2.0
21;162;829;835;6;114;2.0
21;163;835;836;1;114;2.0
21;164;836;837;1;114;2.0
21;165;837;839;2;114;2.0
21;166;839;840;1;114;2.0
21;167;840;842;2;114;2.0
21;168;842;847;5;114;2.0
21;169;847;852;5;114;2.0
21;170;852;855;3;114;2.0
21;171;855;858;3;114;2.0
21;172;858;860;2;114;2.0
21;173;860;862;2;114;2.0
21;174;862;863;1;114;2.0
21;175;863;867;4;114;2.0
21;176;867;869;2;114;2.0
21;177;869;871;2;114;2.0
21;178;871;872;1;114;2.0
21;179;872;882;10;114;2.0
21;180;882;883;1;114;2.0
21;181;883;884;1;114;2.0
21;182;884;885;1;114;2.0
21;183;885;887;2;114;2.0
21;184;887;888;1;114;2.0
21;185;888;890;2;114;2.0
21;186;890;891;1;114;2.0
21;187;891;892;1;114;2.0
21;188;892;898;6;114;2.0
21;189;898;899;1;114;2.0
21;190;899;904;5;114;2.0
21;191;904;905;1;114;2.0
21;192;905;906;1;114;2.0
21;193;906;907;1;114;2.0
21;194;907;910;3;114;2.0
21;195;910;912;2;114;2.0
21;196;912;914;2;114;2.0
21;197;914;915;1;114;2.0
21;198;915;917;2;114;2.0
21;199;917;919;2;114;2.0
21;200;919;920;1;114;2.0
21;201;920;922;2;114;2.0
21;202;922;927;5;114;2.0
21;203;927;928;1;114;2.0
21;204;928;929;1;114;2.0
21;205;929;930;1;114;2.0
21;206;930;931;1;114;2.0
21;207;931;934;3;114;2.0
21;208;934;939;5;114;2.0
21;209;939;941;2;114;2.0
21;210;941;942;1;114;2.0
21;211;942;943;1;114;2.0
21;212;943;944;1;114;2.0
21;213;944;945;1;114;2.0
21;214;945;947;2;114;2.0
21;215;947;950;3;114;2.0
21;216;950;958;8;114;2.0
21;217;958;961;3;114;2.0
21;218;961;962;1;114;2.0
21;219;962;964;2;114;2.0
21;220;964;965;1;114;2.0
21;221;965;969;4;114;2.0
21;222;969;970;1;114;2.0
21;223;970;972;2;114;2.0
21;224;972;974;2;114;2.0
21;225;974;975;1;114;2.0
21;226;975;977;2;114;2.0
21;227;977;978;1;114;2.0
21;228;978;980;2;114;2.0
21;229;980;981;1;114;2.0
21;230;981;982;1;114;2.0
21;231;982;984;2;114;2.0
21;232;984;985;1;114;2.0
21;233;985;996;11;114;2.0
21;234;996;1002;6;114;2.0
21;235;1002;1003;1;114;2.0
21;236;1003;1004;1;114;2.0
21;237;1004;1005;1;114;2.0
21;238;1005;1007;2;114;2.0
21;239;1007;1012;5;114;2.0
21;240;1012;1015;3;114;2.0
21;241;1015;1017;2;114;2.0
21;242;1017;1019;2;114;2.0
21;243;1019;1020;1;114;2.0
21;244;1020;1022;2;114;2.0
21;245;1022;1024;2;114;2.0
21;246;1024;1025;1;114;2.0
21;247;1025;1026;1;114;2.0
21;248;1026;1032;6;114;2.0
21;249;1032;1034;2;114;2.0
21;250;1034;1035;1;114;2.0
21;251;1035;1037;2;114;2.0
21;252;1037;1042;5;114;2.0
21;253;1042;1046;4;114;2.0
21;254;1046;1047;1;114;2.0
21;255;1047;1050;3;114;2.0
21;256;1050;1052;2;114;2.0
21;257;1052;1058;6;114;2.0
21;258;1058;1059;1;114;2.0
21;259;1059;1062;3;114;2.0
21;260;1062;1065;3;114;2.0
21;261;1065;1067;2;114;2.0
21;262;1067;1072;5;114;2.0
21;263;1072;1074;2;114;2.0
21;264;1074;1081;7;114;2.0
21;265;1081;1082;1;114;2.0
21;266;1082;1084;2;114;2.0
21;267;1084;1085;1;114;2.0
21;268;1085;1086;1;114;2.0
21;269;1086;1088;2;114;2.0
21;270;1088;1092;4;114;2.0
21;271;1092;1097;5;114;2.0
21;272;1097;1098;1;114;2.0
21;273;1098;1101;3;114;2.0
21;274;1101;1104;3;114;2.0
21;275;1104;1105;1;114;2.0
21;276;1105;1108;3;114;2.0
21;277;1108;1109;1;114;2.0
21;278;1109;1114;5;114;2.0
21;279;1114;1118;4;114;2.0
21;280;1118;1124;6;114;2.0
21;281;1124;1127;3;114;2.0
21;282;1127;1138;11;114;2.0
21;283;1138;1144;6;114;2.0
21;284;1144;1149;5;114;2.0
21;285;1149;1151;2;114;2.0
21;286;1151;1155;4;114;2.0
21;287;1155;1174;19;114;2.0
21;288;1174;1178;4;114;2.0
21;289;1178;1181;3;114;2.0
21;290;1181;1184;3;114;2.0
21;291;1184;1199;15;114;2.0
21;292;1199;1210;11;114;2.0
21;293;1210;1211;1;114;2.0
21;294;1211;1213;2;114;2.0
21;295;1213;1222;9;114;2.0
21;296;1222;1224;2;114;2.0
21;297;1224;1228;4;114;2.0
21;298;1228;1234;6;114;2.0
21;299;1234;1259;25;114;2.0
21;300;1259;1263;4;114;2.0
21;301;1263;1268;5;114;2.0
21;302;1268;1269;1;114;2.0
21;303;1269;1271;2;114;2.0
21;304;1271;1273;2;114;2.0
21;305;1273;1284;11;114;2.0
21;306;1284;1286;2;114;2.0
21;307;1286;1294;8;114;2.0
21;308;1294;1299;5;114;2.0
21;309;1299;1302;3;114;2.0
21;310;1302;1313;11;114;2.0
21;311;1313;1321;8;114;2.0
21;312;1321;1323;2;114;2.0
21;313;1323;1327;4;114;2.0
21;314;1327;1335;8;114;2.0
21;315;1335;1337;2;114;2.0
21;316;1337;1341;4;114;2.0
21;317;1341;1343;2;114;2.0
21;318;1343;1349;6;114;2.0
21;319;1349;1358;9;114;2.0
21;320;1358;1360;2;114;2.0
21;321;1360;1363;3;114;2.0
21;322;1363;1366;3;114;2.0
21;323;1366;1367;1;114;2.0
21;324;1367;1370;3;114;2.0
21;325;1370;1372;2;114;2.0
21;326;1372;1373;1;114;2.0
21;327;1373;1378;5;114;2.0
21;328;1378;1384;6;114;2.0
21;329;1384;1385;1;114;2.0
21;330;1385;1389;4;114;2.0
21;331;1389;1399;10;114;2.0
21;332;1399;1414;15;114;2.0
21;333;1414;1429;15;114;2.0
21;334;1429;1444;15;114;2.0
21;335;1444;1459;15;114;2.0
21;336;1459;1474;15;114;2.0
21;337;1474;1489;15;114;2.0
21;338;1489;1504;15;114;2.0
21;339;1504;1519;15;114;2.0
21;340;1519;1534;15;114;2.0
21;341;1534;1549;15;114;2.0
21;342;1549;1564;15;114;2.0
21;343;1564;1579;15;114;2.0
21;344;1579;1594;15;114;2.0
21;345;1594;1609;15;114;2.0
21;346;1609;1624;15;114;2.0
21;347;1624;1639;15;114;2.0
21;348;1639;1654;15;114;2.0
21;349;1654;1669;15;114;2.0
21;350;1669;1680;11;114;2.0
22;0;243;332;89;42;2.0
22;1;332;333;1;42;2.0
22;2;333;334;1;42;2.0
22;3;334;337;3;42;2.0
22;4;337;339;2;42;2.0
22;5;339;344;5;42;2.0
22;6;344;345;1;42;2.0
22;7;345;348;3;42;2.0
22;8;348;349;1;42;2.0
22;9;349;351;2;42;2.0
22;10;351;352;1;42;2.0
22;11;352;354;2;42;2.0
22;12;354;359;5;42;2.0
22;13;359;360;1;42;2.0
22;14;360;361;1;42;2.0
22;15;361;362;1;42;2.0
22;16;362;363;1;42;2.0
22;17;363;364;1;42;2.0
22;18;364;365;1;42;2.0
22;19;365;369;4;42;2.0
22;20;369;370;1;42;2.0
22;21;370;371;1;42;2.0
22;22;371;374;3;42;2.0
22;23;374;383;9;42;2.0
22;24;383;385;2;42;2.0
22;25;385;391;6;42;2.0
22;26;391;394;3;42;2.0
22;27;394;396;2;42;2.0
22;28;396;397;1;42;2.0
22;29;397;398;1;42;2.0
22;30;398;404;6;42;2.0
22;31;404;406;2;42;2.0
22;32;406;408;2;42;2.0
22;33;408;409;1;42;2.0
22;34;409;417;8;42;2.0
22;35;417;418;1;42;2.0
22;36;418;419;1;42;2.0
22;37;419;421;2;42;2.0
22;38;421;422;1;42;2.0
22;39;422;423;1;42;2.0
22;40;423;424;1;42;2.0
22;41;424;425;1;42;2.0
22;42;425;426;1;42;2.0
22;43;426;429;3;42;2.0
22;44;429;431;2;42;2.0
22;45;431;435;4;42;2.0
22;46;435;439;4;42;2.0
22;47;439;443;4;42;2.0
22;48;443;444;1;42;2.0
22;49;444;450;6;42;2.0
22;50;450;451;1;42;2.0
22;51;451;452;1;42;2.0
22;52;452;453;1;42;2.0
22;53;453;454;1;42;2.0
22;54;454;462;8;42;2.0
22;55;462;463;1;42;2.0
22;56;463;464;1;42;2.0
22;57;464;465;1;42;2.0
22;58;465;466;1;42;2.0
22;59;466;469;3;42;2.0
22;60;469;471;2;42;2.0
22;61;471;472;1;42;2.0
22;62;472;480;8;42;2.0
22;63;480;481;1;42;2.0
22;64;481;483;2;42;2.0
22;65;483;484;1;42;2.0
22;66;484;486;2;42;2.0
22;67;486;493;7;42;2.0
22;68;493;499;6;42;2.0
22;69;499;500;1;42;2.0
22;70;500;501;1;42;2.0
22;71;501;503;2;42;2.0
22;72;503;505;2;42;2.0
22;73;505;512;7;42;2.0
22;74;512;513;1;42;2.0
22;75;513;514;1;42;2.0
22;76;514;521;7;42;2.0
22;77;521;524;3;42;2.0
22;78;524;529;5;42;2.0
22;79;529;533;4;42;2.0
22;80;533;536;3;42;2.0
22;81;536;542;6;42;2.0
22;82;542;543;1;42;2.0
22;83;543;548;5;42;2.0
22;84;548;550;2;42;2.0
22;85;550;551;1;42;2.0
22;86;551;554;3;42;2.0
22;87;554;572;18;42;2.0
22;88;572;577;5;42;2.0
22;89;577;584;7;42;2.0
22;90;584;585;1;42;2.0
22;91;585;589;4;42;2.0
22;92;589;591;2;42;2.0
22;93;591;592;1;42;2.0
22;94;592;593;1;42;2.0
22;95;593;594;1;42;2.0
22;96;594;596;2;42;2.0
22;97;596;614;18;42;2.0
22;98;614;619;5;42;2.0
22;99;619;625;6;42;2.0
22;100;625;626;1;42;2.0
22;101;626;628;2;42;2.0
22;102;628;630;2;42;2.0
22;103;630;631;1;42;2.0
22;104;631;634;3;42;2.0
22;105;634;655;21;42;2.0
22;106;655;656;1;42;2.0
22;107;656;658;2;42;2.0
22;108;658;661;3;42;2.0
22;109;661;663;2;42;2.0
22;110;663;674;11;42;2.0
22;111;674;680;6;42;2.0
22;112;680;692;12;42;2.0
22;113;692;695;3;42;2.0
22;114;695;696;1;42;2.0
22;115;696;703;7;42;2.0
22;116;703;704;1;42;2.0
22;117;704;716;12;42;2.0
22;118;716;717;1;42;2.0
22;119;717;719;2;42;2.0
22;120;719;724;5;42;2.0
22;121;724;725;1;42;2.0
22;122;725;728;3;42;2.0
22;123;728;731;3;42;2.0
22;124;731;734;3;42;2.0
22;125;734;739;5;42;2.0
22;126;739;747;8;42;2.0
22;127;747;748;1;42;2.0
22;128;748;763;15;42;2.0
22;129;763;764;1;42;2.0
22;130;764;769;5;42;2.0
22;131;769;771;2;42;2.0
22;132;771;775;4;42;2.0
22;133;775;776;1;42;2.0
22;134;776;777;1;42;2.0
22;135;777;783;6;42;2.0
22;136;783;791;8;42;2.0
22;137;791;792;1;42;2.0
22;138;792;794;2;42;2.0
22;139;794;797;3;42;2.0
22;140;797;798;1;42;2.0
22;141;798;799;1;42;2.0
22;142;799;805;6;42;2.0
22;143;805;807;2;42;2.0
22;144;807;809;2;42;2.0
22;145;809;813;4;42;2.0
22;146;813;817;4;42;2.0
22;147;817;821;4;42;2.0
22;148;821;823;2;42;2.0
22;149;823;824;1;42;2.0
22;150;824;831;7;42;2.0
22;151;831;832;1;42;2.0
22;152;832;834;2;42;2.0
22;153;834;836;2;42;2.0
22;154;836;837;1;42;2.0
22;155;837;840;3;42;2.0
22;156;840;841;1;42;2.0
22;157;841;842;1;42;2.0
22;158;842;849;7;42;2.0
22;159;849;851;2;42;2.0
22;160;851;852;1;42;2.0
22;161;852;853;1;42;2.0
22;162;853;854;1;42;2.0
22;163;854;855;1;42;2.0
22;164;855;857;2;42;2.0
22;165;857;864;7;42;2.0
22;166;864;866;2;42;2.0
22;167;866;867;1;42;2.0
22;168;867;868;1;42;2.0
22;169;868;869;1;42;2.0
22;170;869;873;4;42;2.0
22;171;873;874;1;42;2.0
22;172;874;877;3;42;2.0
22;173;877;881;4;42;2.0
22;174;881;883;2;42;2.0
22;175;883;884;1;42;2.0
22;176;884;885;1;42;2.0
22;177;885;886;1;42;2.0
22;178;886;887;1;42;2.0
22;179;887;889;2;42;2.0
22;180;889;891;2;42;2.0
22;181;891;895;4;42;2.0
22;182;895;896;1;42;2.0
22;183;896;898;2;42;2.0
22;184;898;902;4;42;2.0
22;185;902;904;2;42;2.0
22;186;904;906;2;42;2.0
22;187;906;907;1;42;2.0
22;188;907;909;2;42;2.0
22;189;909;912;3;42;2.0
22;190;912;913;1;42;2.0
22;191;913;914;1;42;2.0
22;192;914;919;5;42;2.0
22;193;919;921;2;42;2.0
22;194;921;924;3;42;2.0
22;195;924;925;1;42;2.0
22;196;925;927;2;42;2.0
22;197;927;928;1;42;2.0
22;198;928;933;5;42;2.0
22;199;933;937;4;42;2.0
22;200;937;940;3;42;2.0
22;201;940;941;1;42;2.0
22;202;941;943;2;42;2.0
22;203;943;944;1;42;2.0
22;204;944;946;2;42;2.0
22;205;946;947;1;42;2.0
22;206;947;948;1;42;2.0
22;207;948;955;7;42;2.0
22;208;955;957;2;42;2.0
22;209;957;958;1;42;2.0
22;210;958;959;1;42;2.0
22;211;959;961;2;42;2.0
22;212;961;962;1;42;2.0
22;213;962;965;3;42;2.0
22;214;965;967;2;42;2.0
22;215;967;969;2;42;2.0
22;216;969;973;4;42;2.0
22;217;973;974;1;42;2.0
22;218;974;975;1;42;2.0
22;219;975;977;2;42;2.0
22;220;977;979;2;42;2.0
22;221;979;980;1;42;2.0
22;222;980;981;1;42;2.0
22;223;981;992;11;42;2.0
22;224;992;997;5;42;2.0
22;225;997;998;1;42;2.0
22;226;998;999;1;42;2.0
22;227;999;1000;1;42;2.0
22;228;1000;1001;1;42;2.0
22;229;1001;1002;1;42;2.0
22;230;1002;1003;1;42;2.0
22;231;1003;1004;1;42;2.0
22;232;1004;1006;2;42;2.0
22;233;1006;1008;2;42;2.0
22;234;1008;1012;4;42;2.0
22;235;1012;1013;1;42;2.0
22;236;1013;1014;1;42;2.0
22;237;1014;1018;4;42;2.0
22;238;1018;1019;1;42;2.0
22;239;1019;1021;2;42;2.0
22;240;1021;1023;2;42;2.0
22;241;1023;1029;6;42;2.0
22;242;1029;1032;3;42;2.0
22;243;1032;1033;1;42;2.0
22;244;1033;1034;1;42;2.0
22;245;1034;1036;2;42;2.0
22;246;1036;1038;2;42;2.0
22;247;1038;1042;4;42;2.0
22;248;1042;1044;2;42;2.0
22;249;1044;1049;5;42;2.0
22;250;1049;1056;7;42;2.0
22;251;1056;1061;5;42;2.0
22;252;1061;1064;3;42;2.0
22;253;1064;1066;2;42;2.0
22;254;1066;1068;2;42;2.0
22;255;1068;1069;1;42;2.0
22;256;1069;1075;6;42;2.0
22;257;1075;1078;3;42;2.0
22;258;1078;1080;2;42;2.0
22;259;1080;1081;1;42;2.0
22;260;1081;1082;1;42;2.0
22;261;1082;1086;4;42;2.0
22;262;1086;1089;3;42;2.0
22;263;1089;1092;3;42;2.0
22;264;1092;1094;2;42;2.0
22;265;1094;1097;3;42;2.0
22;266;1097;1099;2;42;2.0
22;267;1099;1100;1;42;2.0
22;268;1100;1102;2;42;2.0
22;269;1102;1111;9;42;2.0
22;270;1111;1112;1;42;2.0
22;271;1112;1121;9;42;2.0
22;272;1121;1124;3;42;2.0
22;273;1124;1137;13;42;2.0
22;274;1137;1140;3;42;2.0
22;275;1140;1141;1;42;2.0
22;276;1141;1142;1;42;2.0
22;277;1142;1148;6;42;2.0
22;278;1148;1149;1;42;2.0
22;279;1149;1150;1;42;2.0
22;280;1150;1151;1;42;2.0
22;281;1151;1170;19;42;2.0
22;282;1170;1172;2;42;2.0
22;283;1172;1175;3;42;2.0
22;284;1175;1177;2;42;2.0
22;285;1177;1181;4;42;2.0
22;286;1181;1201;20;42;2.0
22;287;1201;1204;3;42;2.0
22;288;1204;1208;4;42;2.0
22;289;1208;1212;4;42;2.0
22;290;1212;1219;7;42;2.0
22;291;1219;1220;1;42;2.0
22;292;1220;1222;2;42;2.0
22;293;1222;1232;10;42;2.0
22;294;1232;1256;24;42;2.0
22;295;1256;1258;2;42;2.0
22;296;1258;1262;4;42;2.0
22;297;1262;1265;3;42;2.0
22;298;1265;1268;3;42;2.0
22;299;1268;1270;2;42;2.0
22;300;1270;1272;2;42;2.0
22;301;1272;1280;8;42;2.0
22;302;1280;1292;12;42;2.0
22;303;1292;1296;4;42;2.0
22;304;1296;1306;10;42;2.0
22;305;1306;1309;3;42;2.0
22;306;1309;1318;9;42;2.0
22;307;1318;1324;6;42;2.0
22;308;1324;1325;1;42;2.0
22;309;1325;1326;1;42;2.0
22;310;1326;1332;6;42;2.0
22;311;1332;1337;5;42;2.0
22;312;1337;1339;2;42;2.0
22;313;1339;1340;1;42;2.0
22;314;1340;1343;3;42;2.0
22;315;1343;1352;9;42;2.0
22;316;1352;1358;6;42;2.0
22;317;1358;1360;2;42;2.0
22;318;1360;1361;1;42;2.0
22;319;1361;1362;1;42;2.0
22;320;1362;1364;2;42;2.0
22;321;1364;1367;3;42;2.0
22;322;1367;1368;1;42;2.0
22;323;1368;1377;9;42;2.0
22;324;1377;1378;1;42;2.0
22;325;1378;1382;4;42;2.0
22;326;1382;1385;3;42;2.0
22;327;1385;1390;5;42;2.0
22;328;1390;1393;3;42;2.0
22;329;1393;1408;15;42;2.0
22;330;1408;1423;15;42;2.0
22;331;1423;1438;15;42;2.0
22;332;1438;1453;15;42;2.0
22;333;1453;1468;15;42;2.0
22;334;1468;1483;15;42;2.0
22;335;1483;1498;15;42;2.0
22;336;1498;1513;15;42;2.0
22;337;1513;1528;15;42;2.0
22;338;1528;1543;15;42;2.0
22;339;1543;1558;15;42;2.0
22;340;1558;1573;15;42;2.0
22;341;1573;1588;15;42;2.0
22;342;1588;1603;15;42;2.0
22;343;1603;1618;15;42;2.0
22;344;1618;1633;15;42;2.0
22;345;1633;1648;15;42;2.0
22;346;1648;1663;15;42;2.0
22;347;1663;1680;17;42;2.0
23;0;245;332;87;25;2.0
23;1;332;333;1;25;2.0
23;2;333;334;1;25;2.0
23;3;334;337;3;25;2.0
23;4;337;338;1;25;2.0
23;5;338;339;1;25;2.0
23;6;339;343;4;25;2.0
23;7;343;345;2;25;2.0
23;8;345;347;2;25;2.0
23;9;347;348;1;25;2.0
23;10;348;351;3;25;2.0
23;11;351;353;2;25;2.0
23;12;353;358;5;25;2.0
23;13;358;359;1;25;2.0
23;14;359;360;1;25;2.0
23;15;360;361;1;25;2.0
23;16;361;362;1;25;2.0
23;17;362;363;1;25;2.0
23;18;363;365;2;25;2.0
23;19;365;369;4;25;2.0
23;20;369;370;1;25;2.0
23;21;370;371;1;25;2.0
23;22;371;374;3;25;2.0
23;23;374;382;8;25;2.0
23;24;382;383;1;25;2.0
23;25;383;384;1;25;2.0
23;26;384;385;1;25;2.0
23;27;385;391;6;25;2.0
23;28;391;393;2;25;2.0
23;29;393;394;1;25;2.0
23;30;394;396;2;25;2.0
23;31;396;397;1;25;2.0
23;32;397;398;1;25;2.0
23;33;398;404;6;25;2.0
23;34;404;406;2;25;2.0
23;35;406;408;2;25;2.0
23;36;408;409;1;25;2.0
23;37;409;416;7;25;2.0
23;38;416;417;1;25;2.0
23;39;417;418;1;25;2.0
23;40;418;420;2;25;2.0
23;41;420;421;1;25;2.0
23;42;421;423;2;25;2.0
23;43;423;425;2;25;2.0
23;44;425;429;4;25;2.0
23;45;429;431;2;25;2.0
23;46;431;432;1;25;2.0
23;47;432;435;3;25;2.0
23;48;435;438;3;25;2.0
23;49;438;444;6;25;2.0
23;50;444;450;6;25;2.0
23;51;450;451;1;25;2.0
23;52;451;452;1;25;2.0
23;53;452;453;1;25;2.0
23;54;453;454;1;25;2.0
23;55;454;461;7;25;2.0
23;56;461;463;2;25;2.0
23;57;463;464;1;25;2.0
23;58;464;465;1;25;2.0
23;59;465;467;2;25;2.0
23;60;467;468;1;25;2.0
23;61;468;471;3;25;2.0
23;62;471;472;1;25;2.0
23;63;472;480;8;25;2.0
23;64;480;481;1;25;2.0
23;65;481;483;2;25;2.0
23;66;483;486;3;25;2.0
23;67;486;492;6;25;2.0
23;68;492;498;6;25;2.0
23;69;498;499;1;25;2.0
23;70;499;501;2;25;2.0
23;71;501;502;1;25;2.0
23;72;502;505;3;25;2.0
23;73;505;511;6;25;2.0
23;74;511;513;2;25;2.0
23;75;513;514;1;25;2.0
23;76;514;521;7;25;2.0
23;77;521;525;4;25;2.0
23;78;525;529;4;25;2.0
23;79;529;532;3;25;2.0
23;80;532;535;3;25;2.0
23;81;535;536;1;25;2.0
23;82;536;541;5;25;2.0
23;83;541;543;2;25;2.0
23;84;543;547;4;25;2.0
23;85;547;548;1;25;2.0
23;86;548;549;1;25;2.0
23;87;549;550;1;25;2.0
23;88;550;551;1;25;2.0
23;89;551;553;2;25;2.0
23;90;553;572;19;25;2.0
23;91;572;577;5;25;2.0
23;92;577;584;7;25;2.0
23;93;584;585;1;25;2.0
23;94;585;588;3;25;2.0
23;95;588;591;3;25;2.0
23;96;591;592;1;25;2.0
23;97;592;593;1;25;2.0
23;98;593;596;3;25;2.0
23;99;596;615;19;25;2.0
23;100;615;619;4;25;2.0
23;101;619;625;6;25;2.0
23;102;625;626;1;25;2.0
23;103;626;628;2;25;2.0
23;104;628;629;1;25;2.0
23;105;629;631;2;25;2.0
23;106;631;633;2;25;2.0
23;107;633;634;1;25;2.0
23;108;634;655;21;25;2.0
23;109;655;656;1;25;2.0
23;110;656;657;1;25;2.0
23;111;657;661;4;25;2.0
23;112;661;662;1;25;2.0
23;113;662;673;11;25;2.0
23;114;673;681;8;25;2.0
23;115;681;692;11;25;2.0
23;116;692;695;3;25;2.0
23;117;695;696;1;25;2.0
23;118;696;703;7;25;2.0
23;119;703;704;1;25;2.0
23;120;704;716;12;25;2.0
23;121;716;718;2;25;2.0
23;122;718;723;5;25;2.0
23;123;723;725;2;25;2.0
23;124;725;727;2;25;2.0
23;125;727;731;4;25;2.0
23;126;731;735;4;25;2.0
23;127;735;739;4;25;2.0
23;128;739;747;8;25;2.0
23;129;747;748;1;25;2.0
23;130;748;749;1;25;2.0
23;131;749;763;14;25;2.0
23;132;763;764;1;25;2.0
23;133;764;768;4;25;2.0
23;134;768;771;3;25;2.0
23;135;771;775;4;25;2.0
23;136;775;776;1;25;2.0
23;137;776;782;6;25;2.0
23;138;782;791;9;25;2.0
23;139;791;792;1;25;2.0
23;140;792;795;3;25;2.0
23;141;795;797;2;25;2.0
23;142;797;798;1;25;2.0
23;143;798;799;1;25;2.0
23;144;799;800;1;25;2.0
23;145;800;805;5;25;2.0
23;146;805;808;3;25;2.0
23;147;808;812;4;25;2.0
23;148;812;818;6;25;2.0
23;149;818;821;3;25;2.0
23;150;821;822;1;25;2.0
23;151;822;823;1;25;2.0
23;152;823;824;1;25;2.0
23;153;824;831;7;25;2.0
23;154;831;832;1;25;2.0
23;155;832;834;2;25;2.0
23;156;834;835;1;25;2.0
23;157;835;836;1;25;2.0
23;158;836;837;1;25;2.0
23;159;837;839;2;25;2.0
23;160;839;841;2;25;2.0
23;161;841;843;2;25;2.0
23;162;843;849;6;25;2.0
23;163;849;851;2;25;2.0
23;164;851;852;1;25;2.0
23;165;852;855;3;25;2.0
23;166;855;857;2;25;2.0
23;167;857;858;1;25;2.0
23;168;858;863;5;25;2.0
23;169;863;866;3;25;2.0
23;170;866;867;1;25;2.0
23;171;867;869;2;25;2.0
23;172;869;872;3;25;2.0
23;173;872;873;1;25;2.0
23;174;873;878;5;25;2.0
23;175;878;881;3;25;2.0
23;176;881;882;1;25;2.0
23;177;882;883;1;25;2.0
23;178;883;884;1;25;2.0
23;179;884;885;1;25;2.0
23;180;885;886;1;25;2.0
23;181;886;887;1;25;2.0
23;182;887;889;2;25;2.0
23;183;889;891;2;25;2.0
23;184;891;895;4;25;2.0
23;185;895;896;1;25;2.0
23;186;896;899;3;25;2.0
23;187;899;901;2;25;2.0
23;188;901;902;1;25;2.0
23;189;902;904;2;25;2.0
23;190;904;906;2;25;2.0
23;191;906;907;1;25;2.0
23;192;907;908;1;25;2.0
23;193;908;910;2;25;2.0
23;194;910;912;2;25;2.0
23;195;912;913;1;25;2.0
23;196;913;914;1;25;2.0
23;197;914;915;1;25;2.0
23;198;915;919;4;25;2.0
23;199;919;920;1;25;2.0
23;200;920;921;1;25;2.0
23;201;921;924;3;25;2.0
23;202;924;925;1;25;2.0
23;203;925;926;1;25;2.0
23;204;926;929;3;25;2.0
23;205;929;932;3;25;2.0
23;206;932;936;4;25;2.0
23;207;936;940;4;25;2.0
23;208;940;941;1;25;2.0
23;209;941;943;2;25;2.0
23;210;943;944;1;25;2.0
23;211;944;946;2;25;2.0
23;212;946;947;1;25;2.0
23;213;947;955;8;25;2.0
23;214;955;956;1;25;2.0
23;215;956;959;3;25;2.0
23;216;959;961;2;25;2.0
23;217;961;962;1;25;2.0
23;218;962;964;2;25;2.0
23;219;964;967;3;25;2.0
23;220;967;970;3;25;2.0
23;221;970;972;2;25;2.0
23;222;972;973;1;25;2.0
23;223;973;974;1;25;2.0
23;224;974;975;1;25;2.0
23;225;975;976;1;25;2.0
23;226;976;979;3;25;2.0
23;227;979;980;1;25;2.0
23;228;980;981;1;25;2.0
23;229;981;991;10;25;2.0
23;230;991;998;7;25;2.0
23;231;998;999;1;25;2.0
23;232;999;1000;1;25;2.0
23;233;1000;1001;1;25;2.0
23;234;1001;1002;1;25;2.0
23;235;1002;1003;1;25;2.0
23;236;1003;1004;1;25;2.0
23;237;1004;1005;1;25;2.0
23;238;1005;1006;1;25;2.0
23;239;1006;1008;2;25;2.0
23;240;1008;1012;4;25;2.0
23;241;1012;1015;3;25;2.0
23;242;1015;1019;4;25;2.0
23;243;1019;1020;1;25;2.0
23;244;1020;1021;1;25;2.0
23;245;1021;1022;1;25;2.0
23;246;1022;1023;1;25;2.0
23;247;1023;1029;6;25;2.0
23;248;1029;1032;3;25;2.0
23;249;1032;1034;2;25;2.0
23;250;1034;1035;1;25;2.0
23;251;1035;1038;3;25;2.0
23;252;1038;1041;3;25;2.0
23;253;1041;1044;3;25;2.0
23;254;1044;1045;1;25;2.0
23;255;1045;1049;4;25;2.0
23;256;1049;1055;6;25;2.0
23;257;1055;1060;5;25;2.0
23;258;1060;1061;1;25;2.0
23;259;1061;1064;3;25;2.0
23;260;1064;1066;2;25;2.0
23;261;1066;1067;1;25;2.0
23;262;1067;1069;2;25;2.0
23;263;1069;1076;7;25;2.0
23;264;1076;1077;1;25;2.0
23;265;1077;1080;3;25;2.0
23;266;1080;1081;1;25;2.0
23;267;1081;1085;4;25;2.0
23;268;1085;1089;4;25;2.0
23;269;1089;1093;4;25;2.0
23;270;1093;1094;1;25;2.0
23;271;1094;1096;2;25;2.0
23;272;1096;1099;3;25;2.0
23;273;1099;1100;1;25;2.0
23;274;1100;1103;3;25;2.0
23;275;1103;1110;7;25;2.0
23;276;1110;1111;1;25;2.0
23;277;1111;1113;2;25;2.0
23;278;1113;1121;8;25;2.0
23;279;1121;1124;3;25;2.0
23;280;1124;1137;13;25;2.0
23;281;1137;1139;2;25;2.0
23;282;1139;1141;2;25;2.0
23;283;1141;1148;7;25;2.0
23;284;1148;1150;2;25;2.0
23;285;1150;1169;19;25;2.0
23;286;1169;1171;2;25;2.0
23;287;1171;1176;5;25;2.0
23;288;1176;1177;1;25;2.0
23;289;1177;1181;4;25;2.0
23;290;1181;1200;19;25;2.0
23;291;1200;1205;5;25;2.0
23;292;1205;1208;3;25;2.0
23;293;1208;1212;4;25;2.0
23;294;1212;1219;7;25;2.0
23;295;1219;1223;4;25;2.0
23;296;1223;1231;8;25;2.0
23;297;1231;1256;25;25;2.0
23;298;1256;1259;3;25;2.0
23;299;1259;1263;4;25;2.0
23;300;1263;1264;1;25;2.0
23;301;1264;1268;4;25;2.0
23;302;1268;1270;2;25;2.0
23;303;1270;1272;2;25;2.0
23;304;1272;1279;7;25;2.0
23;305;1279;1281;2;25;2.0
23;306;1281;1291;10;25;2.0
23;307;1291;1296;5;25;2.0
23;308;1296;1306;10;25;2.0
23;309;1306;1308;2;25;2.0
23;310;1308;1318;10;25;2.0
23;311;1318;1323;5;25;2.0
23;312;1323;1324;1;25;2.0
23;313;1324;1326;2;25;2.0
23;314;1326;1333;7;25;2.0
23;315;1333;1336;3;25;2.0
23;316;1336;1338;2;25;2.0
23;317;1338;1340;2;25;2.0
23;318;1340;1344;4;25;2.0
23;319;1344;1353;9;25;2.0
23;320;1353;1357;4;25;2.0
23;321;1357;1360;3;25;2.0
23;322;1360;1361;1;25;2.0
23;323;1361;1362;1;25;2.0
23;324;1362;1365;3;25;2.0
23;325;1365;1368;3;25;2.0
23;326;1368;1369;1;25;2.0
23;327;1369;1377;8;25;2.0
23;328;1377;1379;2;25;2.0
23;329;1379;1382;3;25;2.0
23;330;1382;1384;2;25;2.0
23;331;1384;1390;6;25;2.0
23;332;1390;1394;4;25;2.0
23;333;1394;1409;15;25;2.0
23;334;1409;1424;15;25;2.0
23;335;1424;1439;15;25;2.0
23;336;1439;1454;15;25;2.0
23;337;1454;1469;15;25;2.0
23;338;1469;1484;15;25;2.0
23;339;1484;1499;15;25;2.0
23;340;1499;1514;15;25;2.0
23;341;1514;1529;15;25;2.0
23;342;1529;1544;15;25;2.0
23;343;1544;1559;15;25;2.0
23;344;1559;1574;15;25;2.0
23;345;1574;1589;15;25;2.0
23;346;1589;1604;15;25;2.0
23;347;1604;1619;15;25;2.0
23;348;1619;1634;15;25;2.0
23;349;1634;1649;15;25;2.0
23;350;1649;1664;15;25;2.0
23;351;1664;1680;16;25;2.0
24;0;240;330;90;0;0.83
24;1;330;333;3;0;0.83
24;2;333;334;1;0;0.83
24;3;334;336;2;0;0.83
24;4;336;337;1;0;0.83
24;5;337;338;1;0;0.83
24;6;338;339;1;0;0.83
24;7;339;341;2;0;0.83
24;8;341;342;1;0;0.83
24;9;342;349;7;0;0.83
24;10;349;351;2;0;0.83
24;11;351;352;1;0;0.83
24;12;352;354;2;0;0.83
24;13;354;355;1;0;0.83
24;14;355;359;4;0;0.83
24;15;359;360;1;0;0.83
24;16;360;361;1;0;0.83
24;17;361;362;1;0;0.83
24;18;362;364;2;0;0.83
24;19;364;366;2;0;0.83
24;20;366;369;3;0;0.83
24;21;369;371;2;0;0.83
24;22;371;372;1;0;0.83
24;23;372;377;5;0;0.83
24;24;377;378;1;0;0.83
24;25;378;384;6;0;0.83
24;26;384;386;2;0;0.83
24;27;386;389;3;0;0.83
24;28;389;392;3;0;0.83
24;29;392;394;2;0;0.83
24;30;394;395;1;0;0.83
24;31;395;397;2;0;0.83
24;32;397;398;1;0;0.83
24;33;398;400;2;0;0.83
24;34;400;401;1;0;0.83
24;35;401;407;6;0;0.83
24;36;407;408;1;0;0.83
24;37;408;409;1;0;0.83
24;38;409;412;3;0;0.83
24;39;412;417;5;0;0.83
24;40;417;419;2;0;0.83
24;41;419;420;1;0;0.83
24;42;420;421;1;0;0.83
24;43;421;422;1;0;0.83
24;44;422;424;2;0;0.83
24;45;424;426;2;0;0.83
24;46;426;429;3;0;0.83
24;47;429;432;3;0;0.83
24;48;432;435;3;0;0.83
24;49;435;439;4;0;0.83
24;50;439;446;7;0;0.83
24;51;446;447;1;0;0.83
24;52;447;449;2;0;0.83
24;53;449;450;1;0;0.83
24;54;450;451;1;0;0.83
24;55;451;454;3;0;0.83
24;56;454;455;1;0;0.83
24;57;455;456;1;0;0.83
24;58;456;457;1;0;0.83
24;59;457;461;4;0;0.83
24;60;461;465;4;0;0.83
24;61;465;467;2;0;0.83
24;62;467;469;2;0;0.83
24;63;469;472;3;0;0.83
24;64;472;474;2;0;0.83
24;65;474;475;1;0;0.83
24;66;475;477;2;0;0.83
24;67;477;482;5;0;0.83
24;68;482;484;2;0;0.83
24;69;484;485;1;0;0.83
24;70;485;487;2;0;0.83
24;71;487;496;9;0;0.83
24;72;496;499;3;0;0.83
24;73;499;502;3;0;0.83
24;74;502;503;1;0;0.83
24;75;503;505;2;0;0.83
24;76;505;506;1;0;0.83
24;77;506;509;3;0;0.83
24;78;509;515;6;0;0.83
24;79;515;516;1;0;0.83
24;80;516;517;1;0;0.83
24;81;517;522;5;0;0.83
24;82;522;527;5;0;0.83
24;83;527;532;5;0;0.83
24;84;532;536;4;0;0.83
24;85;536;539;3;0;0.83
24;86;539;544;5;0;0.83
24;87;544;545;1;0;0.83
24;88;545;548;3;0;0.83
24;89;548;549;1;0;0.83
24;90;549;551;2;0;0.83
24;91;551;554;3;0;0.83
24;92;554;557;3;0;0.83
24;93;557;575;18;0;0.83
24;94;575;578;3;0;0.83
24;95;578;587;9;0;0.83
24;96;587;589;2;0;0.83
24;97;589;592;3;0;0.83
24;98;592;593;1;0;0.83
24;99;593;594;1;0;0.83
24;100;594;595;1;0;0.83
24;101;595;596;1;0;0.83
24;102;596;600;4;0;0.83
24;103;600;617;17;0;0.83
24;104;617;620;3;0;0.83
24;105;620;627;7;0;0.83
24;106;627;629;2;0;0.83
24;107;629;631;2;0;0.83
24;108;631;637;6;0;0.83
24;109;637;656;19;0;0.83
24;110;656;659;3;0;0.83
24;111;659;661;2;0;0.83
24;112;661;662;1;0;0.83
24;113;662;663;1;0;0.83
24;114;663;674;11;0;0.83
24;115;674;677;3;0;0.83
24;116;677;683;6;0;0.83
24;117;683;695;12;0;0.83
24;118;695;697;2;0;0.83
24;119;697;699;2;0;0.83
24;120;699;704;5;0;0.83
24;121;704;707;3;0;0.83
24;122;707;716;9;0;0.83
24;123;716;720;4;0;0.83
24;124;720;722;2;0;0.83
24;125;722;724;2;0;0.83
24;126;724;728;4;0;0.83
24;127;728;729;1;0;0.83
24;128;729;732;3;0;0.83
24;129;732;737;5;0;0.83
24;130;737;740;3;0;0.83
24;131;740;750;10;0;0.83
24;132;750;751;1;0;0.83
24;133;751;762;11;0;0.83
24;134;762;764;2;0;0.83
24;135;764;767;3;0;0.83
24;136;767;769;2;0;0.83
24;137;769;772;3;0;0.83
24;138;772;776;4;0;0.83
24;139;776;779;3;0;0.83
24;140;779;780;1;0;0.83
24;141;780;786;6;0;0.83
24;142;786;792;6;0;0.83
24;143;792;795;3;0;0.83
24;144;795;797;2;0;0.83
24;145;797;798;1;0;0.83
24;146;798;800;2;0;0.83
24;147;800;802;2;0;0.83
24;148;802;805;3;0;0.83
24;149;805;809;4;0;0.83
24;150;809;816;7;0;0.83
24;151;816;820;4;0;0.83
24;152;820;821;1;0;0.83
24;153;821;822;1;0;0.83
24;154;822;824;2;0;0.83
24;155;824;825;1;0;0.83
24;156;825;826;1;0;0.83
24;157;826;827;1;0;0.83
24;158;827;832;5;0;0.83
24;159;832;834;2;0;0.83
24;160;834;835;1;0;0.83
24;161;835;836;1;0;0.83
24;162;836;838;2;0;0.83
24;163;838;840;2;0;0.83
24;164;840;841;1;0;0.83
24;165;841;842;1;0;0.83
24;166;842;852;10;0;0.83
24;167;852;853;1;0;0.83
24;168;853;856;3;0;0.83
24;169;856;857;1;0;0.83
24;170;857;858;1;0;0.83
24;171;858;859;1;0;0.83
24;172;859;860;1;0;0.83
24;173;860;864;4;0;0.83
24;174;864;867;3;0;0.83
24;175;867;868;1;0;0.83
24;176;868;870;2;0;0.83
24;177;870;872;2;0;0.83
24;178;872;873;1;0;0.83
24;179;873;874;1;0;0.83
24;180;874;876;2;0;0.83
24;181;876;878;2;0;0.83
24;182;878;879;1;0;0.83
24;183;879;883;4;0;0.83
24;184;883;884;1;0;0.83
24;185;884;886;2;0;0.83
24;186;886;887;1;0;0.83
24;187;887;889;2;0;0.83
24;188;889;890;1;0;0.83
24;189;890;891;1;0;0.83
24;190;891;892;1;0;0.83
24;191;892;896;4;0;0.83
24;192;896;899;3;0;0.83
24;193;899;901;2;0;0.83
24;194;901;905;4;0;0.83
24;195;905;907;2;0;0.83
24;196;907;911;4;0;0.83
24;197;911;912;1;0;0.83
24;198;912;913;1;0;0.83
24;199;913;914;1;0;0.83
24;200;914;916;2;0;0.83
24;201;916;917;1;0;0.83
24;202;917;921;4;0;0.83
24;203;921;922;1;0;0.83
24;204;922;925;3;0;0.83
24;205;925;927;2;0;0.83
24;206;927;929;2;0;0.83
24;207;929;930;1;0;0.83
24;208;930;931;1;0;0.83
24;209;931;936;5;0;0.83
24;210;936;940;4;0;0.83
24;211;940;941;1;0;0.83
24;212;941;942;1;0;0.83
24;213;942;944;2;0;0.83
24;214;944;947;3;0;0.83
24;215;947;948;1;0;0.83
24;216;948;950;2;0;0.83
24;217;950;951;1;0;0.83
24;218;951;959;8;0;0.83
24;219;959;960;1;0;0.83
24;220;960;961;1;0;0.83
24;221;961;962;1;0;0.83
24;222;962;965;3;0;0.83
24;223;965;968;3;0;0.83
24;224;968;971;3;0;0.83
24;225;971;972;1;0;0.83
24;226;972;973;1;0;0.83
24;227;973;974;1;0;0.83
24;228;974;977;3;0;0.83
24;229;977;979;2;0;0.83
24;230;979;980;1;0;0.83
24;231;980;982;2;0;0.83
24;232;982;983;1;0;0.83
24;233;983;995;12;0;0.83
24;234;995;998;3;0;0.83
24;235;998;999;1;0;0.83
24;236;999;1000;1;0;0.83
24;237;1000;1002;2;0;0.83
24;238;1002;1004;2;0;0.83
24;239;1004;1005;1;0;0.83
24;240;1005;1006;1;0;0.83
24;241;1006;1010;4;0;0.83
24;242;1010;1015;5;0;0.83
24;243;1015;1016;1;0;0.83
24;244;1016;1017;1;0;0.83
24;245;1017;1021;4;0;0.83
24;246;1021;1022;1;0;0.83
24;247;1022;1026;4;0;0.83
24;248;1026;1027;1;0;0.83
24;249;1027;1032;5;0;0.83
24;250;1032;1033;1;0;0.83
24;251;1033;1035;2;0;0.83
24;252;1035;1036;1;0;0.83
24;253;1036;1045;9;0;0.83
24;254;1045;1047;2;0;0.83
24;255;1047;1048;1;0;0.83
24;256;1048;1052;4;0;0.83
24;257;1052;1059;7;0;0.83
24;258;1059;1061;2;0;0.83
24;259;1061;1062;1;0;0.83
24;260;1062;1068;6;0;0.83
24;261;1068;1070;2;0;0.83
24;262;1070;1072;2;0;0.83
24;263;1072;1078;6;0;0.83
24;264;1078;1081;3;0;0.83
24;265;1081;1082;1;0;0.83
24;266;1082;1085;3;0;0.83
24;267;1085;1086;1;0;0.83
24;268;1086;1089;3;0;0.83
24;269;1089;1090;1;0;0.83
24;270;1090;1092;2;0;0.83
24;271;1092;1095;3;0;0.83
24;272;1095;1098;3;0;0.83
24;273;1098;1100;2;0;0.83
24;274;1100;1102;2;0;0.83
24;275;1102;1103;1;0;0.83
24;276;1103;1105;2;0;0.83
24;277;1105;1112;7;0;0.83
24;278;1112;1113;1;0;0.83
24;279;1113;1115;2;0;0.83
24;280;1115;1122;7;0;0.83
24;281;1122;1125;3;0;0.83
24;282;1125;1138;13;0;0.83
24;283;1138;1140;2;0;0.83
24;284;1140;1144;4;0;0.83
24;285;1144;1145;1;0;0.83
24;286;1145;1151;6;0;0.83
24;287;1151;1152;1;0;0.83
24;288;1152;1154;2;0;0.83
24;289;1154;1173;19;0;0.83
24;290;1173;1175;2;0;0.83
24;291;1175;1178;3;0;0.83
24;292;1178;1185;7;0;0.83
24;293;1185;1202;17;0;0.83
24;294;1202;1207;5;0;0.83
24;295;1207;1211;4;0;0.83
24;296;1211;1213;2;0;0.83
24;297;1213;1220;7;0;0.83
24;298;1220;1223;3;0;0.83
24;299;1223;1225;2;0;0.83
24;300;1225;1235;10;0;0.83
24;301;1235;1256;21;0;0.83
24;302;1256;1260;4;0;0.83
24;303;1260;1265;5;0;0.83
24;304;1265;1271;6;0;0.83
24;305;1271;1273;2;0;0.83
24;306;1273;1274;1;0;0.83
24;307;1274;1283;9;0;0.83
24;308;1283;1295;12;0;0.83
24;309;1295;1300;5;0;0.83
24;310;1300;1306;6;0;0.83
24;311;1306;1308;2;0;0.83
24;312;1308;1321;13;0;0.83
24;313;1321;1324;3;0;0.83
24;314;1324;1325;1;0;0.83
24;315;1325;1327;2;0;0.83
24;316;1327;1330;3;0;0.83
24;317;1330;1340;10;0;0.83
24;318;1340;1342;2;0;0.83
24;319;1342;1344;2;0;0.83
24;320;1344;1346;2;0;0.83
24;321;1346;1353;7;0;0.83
24;322;1353;1361;8;0;0.83
24;323;1361;1362;1;0;0.83
24;324;1362;1364;2;0;0.83
24;325;1364;1365;1;0;0.83
24;326;1365;1366;1;0;0.83
24;327;1366;1367;1;0;0.83
24;328;1367;1378;11;0;0.83
24;329;1378;1381;3;0;0.83
24;330;1381;1385;4;0;0.83
24;331;1385;1388;3;0;0.83
24;332;1388;1394;6;0;0.83
24;333;1394;1396;2;0;0.83
24;334;1396;1411;15;0;0.83
24;335;1411;1426;15;0;0.83
24;336;1426;1441;15;0;0.83
24;337;1441;1456;15;0;0.83
24;338;1456;1471;15;0;0.83
24;339;1471;1486;15;0;0.83
24;340;1486;1501;15;0;0.83
24;341;1501;1516;15;0;0.83
24;342;1516;1531;15;0;0.83
24;343;1531;1546;15;0;0.83
24;344;1546;1561;15;0;0.83
24;345;1561;1576;15;0;0.83
24;346;1576;1591;15;0;0.83
24;347;1591;1606;15;0;0.83
24;348;1606;1621;15;0;0.83
24;349;1621;1636;15;0;0.83
24;350;1636;1651;15;0;0.83
24;351;1651;1666;15;0;0.83
24;352;1666;1680;14;0;0.83
25;0;240;330;90;0;0.83
25;1;330;333;3;0;0.83
25;2;333;334;1;0;0.83
25;3;334;336;2;0;0.83
25;4;336;337;1;0;0.83
25;5;337;338;1;0;0.83
25;6;338;339;1;0;0.83
25;7;339;341;2;0;0.83
25;8;341;342;1;0;0.83
25;9;342;349;7;0;0.83
25;10;349;351;2;0;0.83
25;11;351;352;1;0;0.83
25;12;352;354;2;0;0.83
25;13;354;355;1;0;0.83
25;14;355;359;4;0;0.83
25;15;359;360;1;0;0.83
25;16;360;361;1;0;0.83
25;17;361;362;1;0;0.83
25;18;362;364;2;0;0.83
25;19;364;366;2;0;0.83
25;20;366;369;3;0;0.83
25;21;369;371;2;0;0.83
25;22;371;372;1;0;0.83
25;23;372;377;5;0;0.83
25;24;377;378;1;0;0.83
25;25;378;384;6;0;0.83
25;26;384;386;2;0;0.83
25;27;386;389;3;0;0.83
25;28;389;392;3;0;0.83
25;29;392;394;2;0;0.83
25;30;394;395;1;0;0.83
25;31;395;397;2;0;0.83
25;32;397;398;1;0;0.83
25;33;398;400;2;0;0.83
25;34;400;401;1;0;0.83
25;35;401;407;6;0;0.83
25;36;407;408;1;0;0.83
25;37;408;409;1;0;0.83
25;38;409;412;3;0;0.83
25;39;412;417;5;0;0.83
25;40;417;419;2;0;0.83
25;41;419;420;1;0;0.83
25;42;420;421;1;0;0.83
25;43;421;422;1;0;0.83
25;44;422;424;2;0;0.83
25;45;424;426;2;0;0.83
25;46;426;429;3;0;0.83
25;47;429;432;3;0;0.83
25;48;432;435;3;0;0.83
25;49;435;439;4;0;0.83
25;50;439;446;7;0;0.83
25;51;446;447;1;0;0.83
25;52;447;449;2;0;0.83
25;53;449;450;1;0;0.83
25;54;450;451;1;0;0.83
25;55;451;454;3;0;0.83
25;56;454;455;1;0;0.83
25;57;455;456;1;0;0.83
25;58;456;457;1;0;0.83
25;59;457;461;4;0;0.83
25;60;461;465;4;0;0.83
25;61;465;467;2;0;0.83
25;62;467;469;2;0;0.83
25;63;469;472;3;0;0.83
25;64;472;474;2;0;0.83
25;65;474;475;1;0;0.83
25;66;475;477;2;0;0.83
25;67;477;482;5;0;0.83
25;68;482;484;2;0;0.83
25;69;484;485;1;0;0.83
25;70;485;487;2;0;0.83
25;71;487;496;9;0;0.83
25;72;496;499;3;0;0.83
25;73;499;502;3;0;0.83
25;74;502;503;1;0;0.83
25;75;503;505;2;0;0.83
25;76;505;506;1;0;0.83
25;77;506;509;3;0;0.83
25;78;509;515;6;0;0.83
25;79;515;516;1;0;0.83
25;80;516;517;1;0;0.83
25;81;517;522;5;0;0.83
25;82;522;527;5;0;0.83
25;83;527;532;5;0;0.83
25;84;532;536;4;0;0.83
25;85;536;539;3;0;0.83
25;86;539;544;5;0;0.83
25;87;544;545;1;0;0.83
25;88;545;548;3;0;0.83
25;89;548;549;1;0;0.83
25;90;549;551;2;0;0.83
25;91;551;554;3;0;0.83
25;92;554;557;3;0;0.83
25;93;557;575;18;0;0.83
25;94;575;578;3;0;0.83
25;95;578;587;9;0;0.83
25;96;587;589;2;0;0.83
25;97;589;592;3;0;0.83
25;98;592;593;1;0;0.83
25;99;593;594;1;0;0.83
25;100;594;595;1;0;0.83
25;101;595;596;1;0;0.83
25;102;596;600;4;0;0.83
25;103;600;617;17;0;0.83
25;104;617;620;3;0;0.83
25;105;620;627;7;0;0.83
25;106;627;629;2;0;0.83
25;107;629;631;2;0;0.83
25;108;631;637;6;0;0.83
25;109;637;656;19;0;0.83
25;110;656;659;3;0;0.83
25;111;659;661;2;0;0.83
25;112;661;662;1;0;0.83
25;113;662;663;1;0;0.83
25;114;663;674;11;0;0.83
25;115;674;677;3;0;0.83
25;116;677;683;6;0;0.83
25;117;683;695;12;0;0.83
25;118;695;697;2;0;0.83
25;119;697;699;2;0;0.83
25;120;699;704;5;0;0.83
25;121;704;707;3;0;0.83
25;122;707;716;9;0;0.83
25;123;716;720;4;0;0.83
25;124;720;722;2;0;0.83
25;125;722;724;2;0;0.83
25;126;724;728;4;0;0.83
25;127;728;729;1;0;0.83
25;128;729;732;3;0;0.83
25;129;732;737;5;0;0.83
25;130;737;740;3;0;0.83
25;131;740;750;10;0;0.83
25;132;750;751;1;0;0.83
25;133;751;762;11;0;0.83
25;134;762;764;2;0;0.83
25;135;764;767;3;0;0.83
25;136;767;769;2;0;0.83
25;137;769;772;3;0;0.83
25;138;772;776;4;0;0.83
25;139;776;779;3;0;0.83
25;140;779;780;1;0;0.83
25;141;780;786;6;0;0.83
25;142;786;792;6;0;0.83
25;143;792;795;3;0;0.83
25;144;795;797;2;0;0.83
25;145;797;798;1;0;0.83
25;146;798;800;2;0;0.83
25;147;800;802;2;0;0.83
25;148;802;805;3;0;0.83
25;149;805;809;4;0;0.83
25;150;809;816;7;0;0.83
25;151;816;820;4;0;0.83
25;152;820;821;1;0;0.83
25;153;821;822;1;0;0.83
25;154;822;824;2;0;0.83
25;155;824;825;1;0;0.83
25;156;825;826;1;0;0.83
25;157;826;827;1;0;0.83
25;158;827;832;5;0;0.83
25;159;832;834;2;0;0.83
25;160;834;835;1;0;0.83
25;161;835;836;1;0;0.83
25;162;836;838;2;0;0.83
25;163;838;840;2;0;0.83
25;164;840;841;1;0;0.83
25;165;841;842;1;0;0.83
25;166;842;852;10;0;0.83
25;167;852;853;1;0;0.83
25;168;853;856;3;0;0.83
25;169;856;857;1;0;0.83
25;170;857;858;1;0;0.83
25;171;858;859;1;0;0.83
25;172;859;860;1;0;0.83
25;173;860;864;4;0;0.83
25;174;864;867;3;0;0.83
25;175;867;868;1;0;0.83
25;176;868;870;2;0;0.83
25;177;870;872;2;0;0.83
25;178;872;873;1;0;0.83
25;179;873;874;1;0;0.83
25;180;874;876;2;0;0.83
25;181;876;878;2;0;0.83
25;182;878;879;1;0;0.83
25;183;879;883;4;0;0.83
25;184;883;884;1;0;0.83
25;185;884;886;2;0;0.83
25;186;886;887;1;0;0.83
25;187;887;889;2;0;0.83
25;188;889;890;1;0;0.83
25;189;890;891;1;0;0.83
25;190;891;892;1;0;0.83
25;191;892;896;4;0;0.83
25;192;896;899;3;0;0.83
25;193;899;901;2;0;0.83
25;194;901;905;4;0;0.83
25;195;905;907;2;0;0.83
25;196;907;911;4;0;0.83
25;197;911;912;1;0;0.83
25;198;912;913;1;0;0.83
25;199;913;914;1;0;0.83
25;200;914;916;2;0;0.83
25;201;916;917;1;0;0.83
25;202;917;921;4;0;0.83
25;203;921;922;1;0;0.83
25;204;922;925;3;0;0.83
25;205;925;927;2;0;0.83
25;206;927;929;2;0;0.83
25;207;929;930;1;0;0.83
25;208;930;931;1;0;0.83
25;209;931;936;5;0;0.83
25;210;936;940;4;0;0.83
25;211;940;941;1;0;0.83
25;212;941;942;1;0;0.83
25;213;942;944;2;0;0.83
25;214;944;947;3;0;0.83
25;215;947;948;1;0;0.83
25;216;948;950;2;0;0.83
25;217;950;951;1;0;0.83
25;218;951;959;8;0;0.83
25;219;959;960;1;0;0.83
25;220;960;961;1;0;0.83
25;221;961;962;1;0;0.83
25;222;962;965;3;0;0.83
25;223;965;968;3;0;0.83
25;224;968;971;3;0;0.83
25;225;971;972;1;0;0.83
25;226;972;973;1;0;0.83
25;227;973;974;1;0;0.83
25;228;974;977;3;0;0.83
25;229;977;979;2;0;0.83
25;230;979;980;1;0;0.83
25;231;980;982;2;0;0.83
25;232;982;983;1;0;0.83
25;233;983;995;12;0;0.83
25;234;995;998;3;0;0.83
25;235;998;999;1;0;0.83
25;236;999;1000;1;0;0.83
25;237;1000;1002;2;0;0.83
25;238;1002;1004;2;0;0.83
25;239;1004;1005;1;0;0.83
25;240;1005;1006;1;0;0.83
25;241;1006;1010;4;0;0.83
25;242;1010;1015;5;0;0.83
25;243;1015;1016;1;0;0.83
25;244;1016;1017;1;0;0.83
25;245;1017;1021;4;0;0.83
25;246;1021;1022;1;0;0.83
25;247;1022;1026;4;0;0.83
25;248;1026;1027;1;0;0.83
25;249;1027;1032;5;0;0.83
25;250;1032;1033;1;0;0.83
25;251;1033;1035;2;0;0.83
25;252;1035;1036;1;0;0.83
25;253;1036;1045;9;0;0.83
25;254;1045;1047;2;0;0.83
25;255;1047;1048;1;0;0.83
25;256;1048;1052;4;0;0.83
25;257;1052;1059;7;0;0.83
25;258;1059;1061;2;0;0.83
25;259;1061;1062;1;0;0.83
25;260;1062;1068;6;0;0.83
25;261;1068;1070;2;0;0.83
25;262;1070;1072;2;0;0.83
25;263;1072;1078;6;0;0.83
25;264;1078;1081;3;0;0.83
25;265;1081;1082;1;0;0.83
25;266;1082;1085;3;0;0.83
25;267;1085;1086;1;0;0.83
25;268;1086;1089;3;0;0.83
25;269;1089;1090;1;0;0.83
25;270;1090;1092;2;0;0.83
25;271;1092;1095;3;0;0.83
25;272;1095;1098;3;0;0.83
25;273;1098;1100;2;0;0.83
25;274;1100;1102;2;0;0.83
25;275;1102;1103;1;0;0.83
25;276;1103;1105;2;0;0.83
25;277;1105;1112;7;0;0.83
25;278;1112;1113;1;0;0.83
25;279;1113;1115;2;0;0.83
25;280;1115;1122;7;0;0.83
25;281;1122;1125;3;0;0.83
25;282;1125;1138;13;0;0.83
25;283;1138;1140;2;0;0.83
25;284;1140;1144;4;0;0.83
25;285;1144;1145;1;0;0.83
25;286;1145;1151;6;0;0.83
25;287;1151;1152;1;0;0.83
25;288;1152;1154;2;0;0.83
25;289;1154;1173;19;0;0.83
25;290;1173;1175;2;0;0.83
25;291;1175;1178;3;0;0.83
25;292;1178;1185;7;0;0.83
25;293;1185;1202;17;0;0.83
25;294;1202;1207;5;0;0.83
25;295;1207;1211;4;0;0.83
25;296;1211;1213;2;0;0.83
25;297;1213;1220;7;0;0.83
25;298;1220;1223;3;0;0.83
25;299;1223;1225;2;0;0.83
25;300;1225;1235;10;0;0.83
25;301;1235;1256;21;0;0.83
25;302;1256;1260;4;0;0.83
25;303;1260;1265;5;0;0.83
25;304;1265;1271;6;0;0.83
25;305;1271;1273;2;0;0.83
25;306;1273;1274;1;0;0.83
25;307;1274;1283;9;0;0.83
25;308;1283;1295;12;0;0.83
25;309;1295;1300;5;0;0.83
25;310;1300;1306;6;0;0.83
25;311;1306;1308;2;0;0.83
25;312;1308;1321;13;0;0.83
25;313;1321;1324;3;0;0.83
25;314;1324;1325;1;0;0.83
25;315;1325;1327;2;0;0.83
25;316;1327;1330;3;0;0.83
25;317;1330;1340;10;0;0.83
25;318;1340;1342;2;0;0.83
25;319;1342;1344;2;0;0.83
25;320;1344;1346;2;0;0.83
25;321;1346;1353;7;0;0.83
25;322;1353;1361;8;0;0.83
25;323;1361;1362;1;0;0.83
25;324;1362;1364;2;0;0.83
25;325;1364;1365;1;0;0.83
25;326;1365;1366;1;0;0.83
25;327;1366;1367;1;0;0.83
25;328;1367;1378;11;0;0.83
25;329;1378;1381;3;0;0.83
25;330;1381;1385;4;0;0.83
25;331;1385;1388;3;0;0.83
25;332;1388;1394;6;0;0.83
25;333;1394;1396;2;0;0.83
25;334;1396;1411;15;0;0.83
25;335;1411;1426;15;0;0.83
25;336;1426;1441;15;0;0.83
25;337;1441;1456;15;0;0.83
25;338;1456;1471;15;0;0.83
25;339;1471;1486;15;0;0.83
25;340;1486;1501;15;0;0.83
25;341;1501;1516;15;0;0.83
25;342;1516;1531;15;0;0.83
25;343;1531;1546;15;0;0.83
25;344;1546;1561;15;0;0.83
25;345;1561;1576;15;0;0.83
25;346;1576;1591;15;0;0.83
25;347;1591;1606;15;0;0.83
25;348;1606;1621;15;0;0.83
25;349;1621;1636;15;0;0.83
25;350;1636;1651;15;0;0.83
25;351;1651;1666;15;0;0.83
25;352;1666;1680;14;0;0.83
26;0;240;330;90;0;0.83
26;1;330;333;3;0;0.83
26;2;333;334;1;0;0.83
26;3;334;336;2;0;0.83
26;4;336;337;1;0;0.83
26;5;337;338;1;0;0.83
26;6;338;339;1;0;0.83
26;7;339;341;2;0;0.83
26;8;341;342;1;0;0.83
26;9;342;349;7;0;0.83
26;10;349;351;2;0;0.83
26;11;351;352;1;0;0.83
26;12;352;354;2;0;0.83
26;13;354;355;1;0;0.83
26;14;355;359;4;0;0.83
26;15;359;360;1;0;0.83
26;16;360;361;1;0;0.83
26;17;361;362;1;0;0.83
26;18;362;364;2;0;0.83
26;19;364;366;2;0;0.83
26;20;366;369;3;0;0.83
26;21;369;371;2;0;0.83
26;22;371;372;1;0;0.83
26;23;372;377;5;0;0.83
26;24;377;378;1;0;0.83
26;25;378;384;6;0;0.83
26;26;384;386;2;0;0.83
26;27;386;389;3;0;0.83
26;28;389;392;3;0;0.83
26;29;392;394;2;0;0.83
26;30;394;395;1;0;0.83
26;31;395;397;2;0;0.83
26;32;397;398;1;0;0.83
26;33;398;400;2;0;0.83
26;34;400;401;1;0;0.83
26;35;401;407;6;0;0.83
26;36;407;408;1;0;0.83
26;37;408;409;1;0;0.83
26;38;409;412;3;0;0.83
26;39;412;417;5;0;0.83
26;40;417;419;2;0;0.83
26;41;419;420;1;0;0.83
26;42;420;421;1;0;0.83
26;43;421;422;1;0;0.83
26;44;422;424;2;0;0.83
26;45;424;426;2;0;0.83
26;46;426;429;3;0;0.83
26;47;429;432;3;0;0.83
26;48;432;435;3;0;0.83
26;49;435;439;4;0;0.83
26;50;439;446;7;0;0.83
26;51;446;447;1;0;0.83
26;52;447;449;2;0;0.83
26;53;449;450;1;0;0.83
26;54;450;451;1;0;0.83
26;55;451;454;3;0;0.83
26;56;454;455;1;0;0.83
26;57;455;456;1;0;0.83
26;58;456;457;1;0;0.83
26;59;457;461;4;0;0.83
26;60;461;465;4;0;0.83
26;61;465;467;2;0;0.83
26;62;467;469;2;0;0.83
26;63;469;472;3;0;0.83
26;64;472;474;2;0;0.83
26;65;474;475;1;0;0.83
26;66;475;477;2;0;0.83
26;67;477;482;5;0;0.83
26;68;482;484;2;0;0.83
26;69;484;485;1;0;0.83
26;70;485;487;2;0;0.83
26;71;487;496;9;0;0.83
26;72;496;499;3;0;0.83
26;73;499;502;3;0;0.83
26;74;502;503;1;0;0.83
26;75;503;505;2;0;0.83
26;76;505;506;1;0;0.83
26;77;506;509;3;0;0.83
26;78;509;515;6;0;0.83
26;79;515;516;1;0;0.83
26;80;516;517;1;0;0.83
26;81;517;522;5;0;0.83
26;82;522;527;5;0;0.83
26;83;527;532;5;0;0.83
26;84;532;536;4;0;0.83
26;85;536;539;3;0;0.83
26;86;539;544;5;0;0.83
26;87;544;545;1;0;0.83
26;88;545;548;3;0;0.83
26;89;548;549;1;0;0.83
26;90;549;551;2;0;0.83
26;91;551;554;3;0;0.83
26;92;554;557;3;0;0.83
26;93;557;575;18;0;0.83
26;94;575;578;3;0;0.83
26;95;578;587;9;0;0.83
26;96;587;589;2;0;0.83
26;97;589;592;3;0;0.83
26;98;592;593;1;0;0.83
26;99;593;594;1;0;0.83
26;100;594;595;1;0;0.83
26;101;595;596;1;0;0.83
26;102;596;600;4;0;0.83
26;103;600;617;17;0;0.83
26;104;617;620;3;0;0.83
26;105;620;627;7;0;0.83
26;106;627;629;2;0;0.83
26;107;629;631;2;0;0.83
26;108;631;637;6;0;0.83
26;109;637;656;19;0;0.83
26;110;656;659;3;0;0.83
26;111;659;661;2;0;0.83
26;112;661;662;1;0;0.83
26;113;662;663;1;0;0.83
26;114;663;674;11;0;0.83
26;115;674;677;3;0;0.83
26;116;677;683;6;0;0.83
26;117;683;695;12;0;0.83
26;118;695;697;2;0;0.83
26;119;697;699;2;0;0.83
26;120;699;704;5;0;0.83
26;121;704;707;3;0;0.83
26;122;707;716;9;0;0.83
26;123;716;720;4;0;0.83
26;124;720;722;2;0;0.83
26;125;722;724;2;0;0.83
26;126;724;728;4;0;0.83
26;127;728;729;1;0;0.83
26;128;729;732;3;0;0.83
26;129;732;737;5;0;0.83
26;130;737;740;3;0;0.83
26;131;740;750;10;0;0.83
26;132;750;751;1;0;0.83
26;133;751;762;11;0;0.83
26;134;762;764;2;0;0.83
26;135;764;767;3;0;0.83
26;136;767;769;2;0;0.83
26;137;769;772;3;0;0.83
26;138;772;776;4;0;0.83
26;139;776;779;3;0;0.83
26;140;779;780;1;0;0.83
26;141;780;786;6;0;0.83
26;142;786;792;6;0;0.83
26;143;792;795;3;0;0.83
26;144;795;797;2;0;0.83
26;145;797;798;1;0;0.83
26;146;798;800;2;0;0.83
26;147;800;802;2;0;0.83
26;148;802;805;3;0;0.83
26;149;805;809;4;0;0.83
26;150;809;816;7;0;0.83
26;151;816;820;4;0;0.83
26;152;820;821;1;0;0.83
26;153;821;822;1;0;0.83
26;154;822;824;2;0;0.83
26;155;824;825;1;0;0.83
26;156;825;826;1;0;0.83
26;157;826;827;1;0;0.83
26;158;827;832;5;0;0.83
26;159;832;834;2;0;0.83
26;160;834;835;1;0;0.83
26;161;835;836;1;0;0.83
26;162;836;838;2;0;0.83
26;163;838;840;2;0;0.83
26;164;840;841;1;0;0.83
26;165;841;842;1;0;0.83
26;166;842;852;10;0;0.83
26;167;852;853;1;0;0.83
26;168;853;856;3;0;0.83
26;169;856;857;1;0;0.83
26;170;857;858;1;0;0.83
26;171;858;859;1;0;0.83
26;172;859;860;1;0;0.83
26;173;860;864;4;0;0.83
26;174;864;867;3;0;0.83
26;175;867;868;1;0;0.83
26;176;868;870;2;0;0.83
26;177;870;872;2;0;0.83
26;178;872;873;1;0;0.83
26;179;873;874;1;0;0.83
26;180;874;876;2;0;0.83
26;181;876;878;2;0;0.83
26;182;878;879;1;0;0.83
26;183;879;883;4;0;0.83
26;184;883;884;1;0;0.83
26;185;884;886;2;0;0.83
26;186;886;887;1;0;0.83
26;187;887;889;2;0;0.83
26;188;889;890;1;0;0.83
26;189;890;891;1;0;0.83
26;190;891;892;1;0;0.83
26;191;892;896;4;0;0.83
26;192;896;899;3;0;0.83
26;193;899;901;2;0;0.83
26;194;901;905;4;0;0.83
26;195;905;907;2;0;0.83
26;196;907;911;4;0;0.83
26;197;911;912;1;0;0.83
26;198;912;913;1;0;0.83
26;199;913;914;1;0;0.83
26;200;914;916;2;0;0.83
26;201;916;917;1;0;0.83
26;202;917;921;4;0;0.83
26;203;921;922;1;0;0.83
26;204;922;925;3;0;0.83
26;205;925;927;2;0;0.83
26;206;927;929;2;0;0.83
26;207;929;930;1;0;0.83
26;208;930;931;1;0;0.83
26;209;931;936;5;0;0.83
26;210;936;940;4;0;0.83
26;211;940;941;1;0;0.83
26;212;941;942;1;0;0.83
26;213;942;944;2;0;0.83
26;214;944;947;3;0;0.83
26;215;947;948;1;0;0.83
26;216;948;950;2;0;0.83
26;217;950;951;1;0;0.83
26;218;951;959;8;0;0.83
26;219;959;960;1;0;0.83
26;220;960;961;1;0;0.83
26;221;961;962;1;0;0.83
26;222;962;965;3;0;0.83
26;223;965;968;3;0;0.83
26;224;968;971;3;0;0.83
26;225;971;972;1;0;0.83
26;226;972;973;1;0;0.83
26;227;973;974;1;0;0.83
26;228;974;977;3;0;0.83
26;229;977;979;2;0;0.83
26;230;979;980;1;0;0.83
26;231;980;982;2;0;0.83
26;232;982;983;1;0;0.83
26;233;983;995;12;0;0.83
26;234;995;998;3;0;0.83
26;235;998;999;1;0;0.83
26;236;999;1000;1;0;0.83
26;237;1000;1002;2;0;0.83
26;238;1002;1004;2;0;0.83
26;239;1004;1005;1;0;0.83
26;240;1005;1006;1;0;0.83
26;241;1006;1010;4;0;0.83
26;242;1010;1015;5;0;0.83
26;243;1015;1016;1;0;0.83
26;244;1016;1017;1;0;0.83
26;245;1017;1021;4;0;0.83
26;246;1021;1022;1;0;0.83
26;247;1022;1026;4;0;0.83
26;248;1026;1027;1;0;0.83
26;249;1027;1032;5;0;0.83
26;250;1032;1033;1;0;0.83
26;251;1033;1035;2;0;0.83
26;252;1035;1036;1;0;0.83
26;253;1036;1045;9;0;0.83
26;254;1045;1047;2;0;0.83
26;255;1047;1048;1;0;0.83
26;256;1048;1052;4;0;0.83
26;257;1052;1059;7;0;0.83
26;258;1059;1061;2;0;0.83
26;259;1061;1062;1;0;0.83
26;260;1062;1068;6;0;0.83
26;261;1068;1070;2;0;0.83
26;262;1070;1072;2;0;0.83
26;263;1072;1078;6;0;0.83
26;264;1078;1081;3;0;0.83
26;265;1081;1082;1;0;0.83
26;266;1082;1085;3;0;0.83
26;267;1085;1086;1;0;0.83
26;268;1086;1089;3;0;0.83
26;269;1089;1090;1;0;0.83
26;270;1090;1092;2;0;0.83
26;271;1092;1095;3;0;0.83
26;272;1095;1098;3;0;0.83
26;273;1098;1100;2;0;0.83
26;274;1100;1102;2;0;0.83
26;275;1102;1103;1;0;0.83
26;276;1103;1105;2;0;0.83
26;277;1105;1112;7;0;0.83
26;278;1112;1113;1;0;0.83
26;279;1113;1115;2;0;0.83
26;280;1115;1122;7;0;0.83
26;281;1122;1125;3;0;0.83
26;282;1125;1138;13;0;0.83
26;283;1138;1140;2;0;0.83
26;284;1140;1144;4;0;0.83
26;285;1144;1145;1;0;0.83
26;286;1145;1151;6;0;0.83
26;287;1151;1152;1;0;0.83
26;288;1152;1154;2;0;0.83
26;289;1154;1173;19;0;0.83
26;290;1173;1175;2;0;0.83
26;291;1175;1178;3;0;0.83
26;292;1178;1185;7;0;0.83
26;293;1185;1202;17;0;0.83
26;294;1202;1207;5;0;0.83
26;295;1207;1211;4;0;0.83
26;296;1211;1213;2;0;0.83
26;297;1213;1220;7;0;0.83
26;298;1220;1223;3;0;0.83
26;299;1223;1225;2;0;0.83
26;300;1225;1235;10;0;0.83
26;301;1235;1256;21;0;0.83
26;302;1256;1260;4;0;0.83
26;303;1260;1265;5;0;0.83
26;304;1265;1271;6;0;0.83
26;305;1271;1273;2;0;0.83
26;306;1273;1274;1;0;0.83
26;307;1274;1283;9;0;0.83
26;308;1283;1295;12;0;0.83
26;309;1295;1300;5;0;0.83
26;310;1300;1306;6;0;0.83
26;311;1306;1308;2;0;0.83
26;312;1308;1321;13;0;0.83
26;313;1321;1324;3;0;0.83
26;314;1324;1325;1;0;0.83
26;315;1325;1327;2;0;0.83
26;316;1327;1330;3;0;0.83
26;317;1330;1340;10;0;0.83
26;318;1340;1342;2;0;0.83
26;319;1342;1344;2;0;0.83
26;320;1344;1346;2;0;0.83
26;321;1346;1353;7;0;0.83
26;322;1353;1361;8;0;0.83
26;323;1361;1362;1;0;0.83
26;324;1362;1364;2;0;0.83
26;325;1364;1365;1;0;0.83
26;326;1365;1366;1;0;0.83
26;327;1366;1367;1;0;0.83
26;328;1367;1378;11;0;0.83
26;329;1378;1381;3;0;0.83
26;330;1381;1385;4;0;0.83
26;331;1385;1388;3;0;0.83
26;332;1388;1394;6;0;0.83
26;333;1394;1396;2;0;0.83
26;334;1396;1411;15;0;0.83
26;335;1411;1426;15;0;0.83
26;336;1426;1441;15;0;0.83
26;337;1441;1456;15;0;0.83
26;338;1456;1471;15;0;0.83
26;339;1471;1486;15;0;0.83
26;340;1486;1501;15;0;0.83
26;341;1501;1516;15;0;0.83
26;342;1516;1531;15;0;0.83
26;343;1531;1546;15;0;0.83
26;344;1546;1561;15;0;0.83
26;345;1561;1576;15;0;0.83
26;346;1576;1591;15;0;0.83
26;347;1591;1606;15;0;0.83
26;348;1606;1621;15;0;0.83
26;349;1621;1636;15;0;0.83
26;350;1636;1651;15;0;0.83
26;351;1651;1666;15;0;0.83
26;352;1666;1680;14;0;0.83
27;0;240;330;90;0;0.83
27;1;330;333;3;0;0.83
27;2;333;334;1;0;0.83
27;3;334;336;2;0;0.83
27;4;336;337;1;0;0.83
27;5;337;338;1;0;0.83
27;6;338;339;1;0;0.83
27;7;339;341;2;0;0.83
27;8;341;342;1;0;0.83
27;9;342;349;7;0;0.83
27;10;349;351;2;0;0.83
27;11;351;352;1;0;0.83
27;12;352;354;2;0;0.83
27;13;354;355;1;0;0.83
27;14;355;359;4;0;0.83
27;15;359;360;1;0;0.83
27;16;360;361;1;0;0.83
27;17;361;362;1;0;0.83
27;18;362;364;2;0;0.83
27;19;364;366;2;0;0.83
27;20;366;369;3;0;0.83
27;21;369;371;2;0;0.83
27;22;371;372;1;0;0.83
27;23;372;377;5;0;0.83
27;24;377;378;1;0;0.83
27;25;378;384;6;0;0.83
27;26;384;386;2;0;0.83
27;27;386;389;3;0;0.83
27;28;389;392;3;0;0.83
27;29;392;394;2;0;0.83
27;30;394;395;1;0;0.83
27;31;395;397;2;0;0.83
27;32;397;398;1;0;0.83
27;33;398;400;2;0;0.83
27;34;400;401;1;0;0.83
27;35;401;407;6;0;0.83
27;36;407;408;1;0;0.83
27;37;408;409;1;0;0.83
27;38;409;412;3;0;0.83
27;39;412;417;5;0;0.83
27;40;417;419;2;0;0.83
27;41;419;420;1;0;0.83
27;42;420;421;1;0;0.83
27;43;421;422;1;0;0.83
27;44;422;424;2;0;0.83
27;45;424;426;2;0;0.83
27;46;426;429;3;0;0.83
27;47;429;432;3;0;0.83
27;48;432;435;3;0;0.83
27;49;435;439;4;0;0.83
27;50;439;446;7;0;0.83
27;51;446;447;1;0;0.83
27;52;447;449;2;0;0.83
27;53;449;450;1;0;0.83
27;54;450;451;1;0;0.83
27;55;451;454;3;0;0.83
27;56;454;455;1;0;0.83
27;57;455;456;1;0;0.83
27;58;456;457;1;0;0.83
27;59;457;461;4;0;0.83
27;60;461;465;4;0;0.83
27;61;465;467;2;0;0.83
27;62;467;469;2;0;0.83
27;63;469;472;3;0;0.83
27;64;472;474;2;0;0.83
27;65;474;475;1;0;0.83
27;66;475;477;2;0;0.83
27;67;477;482;5;0;0.83
27;68;482;484;2;0;0.83
27;69;484;485;1;0;0.83
27;70;485;487;2;0;0.83
27;71;487;496;9;0;0.83
27;72;496;499;3;0;0.83
27;73;499;502;3;0;0.83
27;74;502;503;1;0;0.83
27;75;503;505;2;0;0.83
27;76;505;506;1;0;0.83
27;77;506;509;3;0;0.83
27;78;509;515;6;0;0.83
27;79;515;516;1;0;0.83
27;80;516;517;1;0;0.83
27;81;517;522;5;0;0.83
27;82;522;527;5;0;0.83
27;83;527;532;5;0;0.83
27;84;532;536;4;0;0.83
27;85;536;539;3;0;0.83
27;86;539;544;5;0;0.83
27;87;544;545;1;0;0.83
27;88;545;548;3;0;0.83
27;89;548;549;1;0;0.83
27;90;549;551;2;0;0.83
27;91;551;554;3;0;0.83
27;92;554;557;3;0;0.83
27;93;557;575;18;0;0.83
27;94;575;578;3;0;0.83
27;95;578;587;9;0;0.83
27;96;587;589;2;0;0.83
27;97;589;592;3;0;0.83
27;98;592;593;1;0;0.83
27;99;593;594;1;0;0.83
27;100;594;595;1;0;0.83
27;101;595;596;1;0;0.83
27;102;596;600;4;0;0.83
27;103;600;617;17;0;0.83
27;104;617;620;3;0;0.83
27;105;620;627;7;0;0.83
27;106;627;629;2;0;0.83
27;107;629;631;2;0;0.83
27;108;631;637;6;0;0.83
27;109;637;656;19;0;0.83
27;110;656;659;3;0;0.83
27;111;659;661;2;0;0.83
27;112;661;662;1;0;0.83
27;113;662;663;1;0;0.83
27;114;663;674;11;0;0.83
27;115;674;677;3;0;0.83
27;116;677;683;6;0;0.83
27;117;683;695;12;0;0.83
27;118;695;697;2;0;0.83
27;119;697;699;2;0;0.83
27;120;699;704;5;0;0.83
27;121;704;707;3;0;0.83
27;122;707;716;9;0;0.83
27;123;716;720;4;0;0.83
27;124;720;722;2;0;0.83
27;125;722;724;2;0;0.83
27;126;724;728;4;0;0.83
27;127;728;729;1;0;0.83
27;128;729;732;3;0;0.83
27;129;732;737;5;0;0.83
27;130;737;740;3;0;0.83
27;131;740;750;10;0;0.83
27;132;750;751;1;0;0.83
27;133;751;762;11;0;0.83
27;134;762;764;2;0;0.83
27;135;764;767;3;0;0.83
27;136;767;769;2;0;0.83
27;137;769;772;3;0;0.83
27;138;772;776;4;0;0.83
27;139;776;779;3;0;0.83
27;140;779;780;1;0;0.83
27;141;780;786;6;0;0.83
27;142;786;792;6;0;0.83
27;143;792;795;3;0;0.83
27;144;795;797;2;0;0.83
27;145;797;798;1;0;0.83
27;146;798;800;2;0;0.83
27;147;800;802;2;0;0.83
27;148;802;805;3;0;0.83
27;149;805;809;4;0;0.83
27;150;809;816;7;0;0.83
27;151;816;820;4;0;0.83
27;152;820;821;1;0;0.83
27;153;821;822;1;0;0.83
27;154;822;824;2;0;0.83
27;155;824;825;1;0;0.83
27;156;825;826;1;0;0.83
27;157;826;827;1;0;0.83
27;158;827;832;5;0;0.83
27;159;832;834;2;0;0.83
27;160;834;835;1;0;0.83
27;161;835;836;1;0;0.83
27;162;836;838;2;0;0.83
27;163;838;840;2;0;0.83
27;164;840;841;1;0;0.83
27;165;841;842;1;0;0.83
27;166;842;852;10;0;0.83
27;167;852;853;1;0;0.83
27;168;853;856;3;0;0.83
27;169;856;857;1;0;0.83
27;170;857;858;1;0;0.83
27;171;858;859;1;0;0.83
27;172;859;860;1;0;0.83
27;173;860;864;4;0;0.83
27;174;864;867;3;0;0.83
27;175;867;868;1;0;0.83
27;176;868;870;2;0;0.83
27;177;870;872;2;0;0.83
27;178;872;873;1;0;0.83
27;179;873;874;1;0;0.83
27;180;874;876;2;0;0.83
27;181;876;878;2;0;0.83
27;182;878;879;1;0;0.83
27;183;879;883;4;0;0.83
27;184;883;884;1;0;0.83
27;185;884;886;2;0;0.83
27;186;886;887;1;0;0.83
27;187;887;889;2;0;0.83
27;188;889;890;1;0;0.83
27;189;890;891;1;0;0.83
27;190;891;892;1;0;0.83
27;191;892;896;4;0;0.83
27;192;896;899;3;0;0.83
27;193;899;901;2;0;0.83
27;194;901;905;4;0;0.83
27;195;905;907;2;0;0.83
27;196;907;911;4;0;0.83
27;197;911;912;1;0;0.83
27;198;912;913;1;0;0.83
27;199;913;914;1;0;0.83
27;200;914;916;2;0;0.83
27;201;916;917;1;0;0.83
27;202;917;921;4;0;0.83
27;203;921;922;1;0;0.83
27;204;922;925;3;0;0.83
27;205;925;927;2;0;0.83
27;206;927;929;2;0;0.83
27;207;929;930;1;0;0.83
27;208;930;931;1;0;0.83
27;209;931;936;5;0;0.83
27;210;936;940;4;0;0.83
27;211;940;941;1;0;0.83
27;212;941;942;1;0;0.83
27;213;942;944;2;0;0.83
27;214;944;947;3;0;0.83
27;215;947;948;1;0;0.83
27;216;948;950;2;0;0.83
27;217;950;951;1;0;0.83
27;218;951;959;8;0;0.83
27;219;959;960;1;0;0.83
27;220;960;961;1;0;0.83
27;221;961;962;1;0;0.83
27;222;962;965;3;0;0.83
27;223;965;968;3;0;0.83
27;224;968;971;3;0;0.83
27;225;971;972;1;0;0.83
27;226;972;973;1;0;0.83
27;227;973;974;1;0;0.83
27;228;974;977;3;0;0.83
27;229;977;979;2;0;0.83
27;230;979;980;1;0;0.83
27;231;980;982;2;0;0.83
27;232;982;983;1;0;0.83
27;233;983;995;12;0;0.83
27;234;995;998;3;0;0.83
27;235;998;999;1;0;0.83
27;236;999;1000;1;0;0.83
27;237;1000;1002;2;0;0.83
27;238;1002;1004;2;0;0.83
27;239;1004;1005;1;0;0.83
27;240;1005;1006;1;0;0.83
27;241;1006;1010;4;0;0.83
27;242;1010;1015;5;0;0.83
27;243;1015;1016;1;0;0.83
27;244;1016;1017;1;0;0.83
27;245;1017;1021;4;0;0.83
27;246;1021;1022;1;0;0.83
27;247;1022;1026;4;0;0.83
27;248;1026;1027;1;0;0.83
27;249;1027;1032;5;0;0.83
27;250;1032;1033;1;0;0.83
27;251;1033;1035;2;0;0.83
27;252;1035;1036;1;0;0.83
27;253;1036;1045;9;0;0.83
27;254;1045;1047;2;0;0.83
27;255;1047;1048;1;0;0.83
27;256;1048;1052;4;0;0.83
27;257;1052;1059;7;0;0.83
27;258;1059;1061;2;0;0.83
27;259;1061;1062;1;0;0.83
27;260;1062;1068;6;0;0.83
27;261;1068;1070;2;0;0.83
27;262;1070;1072;2;0;0.83
27;263;1072;1078;6;0;0.83
27;264;1078;1081;3;0;0.83
27;265;1081;1082;1;0;0.83
27;266;1082;1085;3;0;0.83
27;267;1085;1086;1;0;0.83
27;268;1086;1089;3;0;0.83
27;269;1089;1090;1;0;0.83
27;270;1090;1092;2;0;0.83
27;271;1092;1095;3;0;0.83
27;272;1095;1098;3;0;0.83
27;273;1098;1100;2;0;0.83
27;274;1100;1102;2;0;0.83
27;275;1102;1103;1;0;0.83
27;276;1103;1105;2;0;0.83
27;277;1105;1112;7;0;0.83
27;278;1112;1113;1;0;0.83
27;279;1113;1115;2;0;0.83
27;280;1115;1122;7;0;0.83
27;281;1122;1125;3;0;0.83
27;282;1125;1138;13;0;0.83
27;283;1138;1140;2;0;0.83
27;284;1140;1144;4;0;0.83
27;285;1144;1145;1;0;0.83
27;286;1145;1151;6;0;0.83
27;287;1151;1152;1;0;0.83
27;288;1152;1154;2;0;0.83
27;289;1154;1173;19;0;0.83
27;290;1173;1175;2;0;0.83
27;291;1175;1178;3;0;0.83
27;292;1178;1185;7;0;0.83
27;293;1185;1202;17;0;0.83
27;294;1202;1207;5;0;0.83
27;295;1207;1211;4;0;0.83
27;296;1211;1213;2;0;0.83
27;297;1213;1220;7;0;0.83
27;298;1220;1223;3;0;0.83
27;299;1223;1225;2;0;0.83
27;300;1225;1235;10;0;0.83
27;301;1235;1256;21;0;0.83
27;302;1256;1260;4;0;0.83
27;303;1260;1265;5;0;0.83
27;304;1265;1271;6;0;0.83
27;305;1271;1273;2;0;0.83
27;306;1273;1274;1;0;0.83
27;307;1274;1283;9;0;0.83
27;308;1283;1295;12;0;0.83
27;309;1295;1300;5;0;0.83
27;310;1300;1306;6;0;0.83
27;311;1306;1308;2;0;0.83
27;312;1308;1321;13;0;0.83
27;313;1321;1324;3;0;0.83
27;314;1324;1325;1;0;0.83
27;315;1325;1327;2;0;0.83
27;316;1327;1330;3;0;0.83
27;317;1330;1340;10;0;0.83
27;318;1340;1342;2;0;0.83
27;319;1342;1344;2;0;0.83
27;320;1344;1346;2;0;0.83
27;321;1346;1353;7;0;0.83
27;322;1353;1361;8;0;0.83
27;323;1361;1362;1;0;0.83
27;324;1362;1364;2;0;0.83
27;325;1364;1365;1;0;0.83
27;326;1365;1366;1;0;0.83
27;327;1366;1367;1;0;0.83
27;328;1367;1378;11;0;0.83
27;329;1378;1381;3;0;0.83
27;330;1381;1385;4;0;0.83
27;331;1385;1388;3;0;0.83
27;332;1388;1394;6;0;0.83
27;333;1394;1396;2;0;0.83
27;334;1396;1411;15;0;0.83
27;335;1411;1426;15;0;0.83
27;336;1426;1441;15;0;0.83
27;337;1441;1456;15;0;0.83
27;338;1456;1471;15;0;0.83
27;339;1471;1486;15;0;0.83
27;340;1486;1501;15;0;0.83
27;341;1501;1516;15;0;0.83
27;342;1516;1531;15;0;0.83
27;343;1531;1546;15;0;0.83
27;344;1546;1561;15;0;0.83
27;345;1561;1576;15;0;0.83
27;346;1576;1591;15;0;0.83
27;347;1591;1606;15;0;0.83
27;348;1606;1621;15;0;0.83
27;349;1621;1636;15;0;0.83
27;350;1636;1651;15;0;0.83
27;351;1651;1666;15;0;0.83
27;352;1666;1680;14;0;0.83
28;0;240;330;90;0;0.83
28;1;330;333;3;0;0.83
28;2;333;334;1;0;0.83
28;3;334;336;2;0;0.83
28;4;336;337;1;0;0.83
28;5;337;338;1;0;0.83
28;6;338;339;1;0;0.83
28;7;339;341;2;0;0.83
28;8;341;342;1;0;0.83
28;9;342;349;7;0;0.83
28;10;349;351;2;0;0.83
28;11;351;352;1;0;0.83
28;12;352;354;2;0;0.83
28;13;354;355;1;0;0.83
28;14;355;359;4;0;0.83
28;15;359;360;1;0;0.83
28;16;360;361;1;0;0.83
28;17;361;362;1;0;0.83
28;18;362;364;2;0;0.83
28;19;364;366;2;0;0.83
28;20;366;369;3;0;0.83
28;21;369;371;2;0;0.83
28;22;371;372;1;0;0.83
28;23;372;377;5;0;0.83
28;24;377;378;1;0;0.83
28;25;378;384;6;0;0.83
28;26;384;386;2;0;0.83
28;27;386;389;3;0;0.83
28;28;389;392;3;0;0.83
28;29;392;394;2;0;0.83
28;30;394;395;1;0;0.83
28;31;395;397;2;0;0.83
28;32;397;398;1;0;0.83
28;33;398;400;2;0;0.83
28;34;400;401;1;0;0.83
28;35;401;407;6;0;0.83
28;36;407;408;1;0;0.83
28;37;408;409;1;0;0.83
28;38;409;412;3;0;0.83
28;39;412;417;5;0;0.83
28;40;417;419;2;0;0.83
28;41;419;420;1;0;0.83
28;42;420;421;1;0;0.83
28;43;421;422;1;0;0.83
28;44;422;424;2;0;0.83
28;45;424;426;2;0;0.83
28;46;426;429;3;0;0.83
28;47;429;432;3;0;0.83
28;48;432;435;3;0;0.83
28;49;435;439;4;0;0.83
28;50;439;446;7;0;0.83
28;51;446;447;1;0;0.83
28;52;447;449;2;0;0.83
28;53;449;450;1;0;0.83
28;54;450;451;1;0;0.83
28;55;451;454;3;0;0.83
28;56;454;455;1;0;0.83
28;57;455;456;1;0;0.83
28;58;456;457;1;0;0.83
28;59;457;461;4;0;0.83
28;60;461;465;4;0;0.83
28;61;465;467;2;0;0.83
28;62;467;469;2;0;0.83
28;63;469;472;3;0;0.83
28;64;472;474;2;0;0.83
28;65;474;475;1;0;0.83
28;66;475;477;2;0;0.83
28;67;477;482;5;0;0.83
28;68;482;484;2;0;0.83
28;69;484;485;1;0;0.83
28;70;485;487;2;0;0.83
28;71;487;496;9;0;0.83
28;72;496;499;3;0;0.83
28;73;499;502;3;0;0.83
28;74;502;503;1;0;0.83
28;75;503;505;2;0;0.83
28;76;505;506;1;0;0.83
28;77;506;509;3;0;0.83
28;78;509;515;6;0;0.83
28;79;515;516;1;0;0.83
28;80;516;517;1;0;0.83
28;81;517;522;5;0;0.83
28;82;522;527;5;0;0.83
28;83;527;532;5;0;0.83
28;84;532;536;4;0;0.83
28;85;536;539;3;0;0.83
28;86;539;544;5;0;0.83
28;87;544;545;1;0;0.83
28;88;545;548;3;0;0.83
28;89;548;549;1;0;0.83
28;90;549;551;2;0;0.83
28;91;551;554;3;0;0.83
28;92;554;557;3;0;0.83
28;93;557;575;18;0;0.83
28;94;575;578;3;0;0.83
28;95;578;587;9;0;0.83
28;96;587;589;2;0;0.83
28;97;589;592;3;0;0.83
28;98;592;593;1;0;0.83
28;99;593;594;1;0;0.83
28;100;594;595;1;0;0.83
28;101;595;596;1;0;0.83
28;102;596;600;4;0;0.83
28;103;600;617;17;0;0.83
28;104;617;620;3;0;0.83
28;105;620;627;7;0;0.83
28;106;627;629;2;0;0.83
28;107;629;631;2;0;0.83
28;108;631;637;6;0;0.83
28;109;637;656;19;0;0.83
28;110;656;659;3;0;0.83
28;111;659;661;2;0;0.83
28;112;661;662;1;0;0.83
28;113;662;663;1;0;0.83
28;114;663;674;11;0;0.83
28;115;674;677;3;0;0.83
28;116;677;683;6;0;0.83
28;117;683;695;12;0;0.83
28;118;695;697;2;0;0.83
28;119;697;699;2;0;0.83
28;120;699;704;5;0;0.83
28;121;704;707;3;0;0.83
28;122;707;716;9;0;0.83
28;123;716;720;4;0;0.83
28;124;720;722;2;0;0.83
28;125;722;724;2;0;0.83
28;126;724;728;4;0;0.83
28;127;728;729;1;0;0.83
28;128;729;732;3;0;0.83
28;129;732;737;5;0;0.83
28;130;737;740;3;0;0.83
28;131;740;750;10;0;0.83
28;132;750;751;1;0;0.83
28;133;751;762;11;0;0.83
28;134;762;764;2;0;0.83
28;135;764;767;3;0;0.83
28;136;767;769;2;0;0.83
28;137;769;772;3;0;0.83
28;138;772;776;4;0;0.83
28;139;776;779;3;0;0.83
28;140;779;780;1;0;0.83
28;141;780;786;6;0;0.83
28;142;786;792;6;0;0.83
28;143;792;795;3;0;0.83
28;144;795;797;2;0;0.83
28;145;797;798;1;0;0.83
28;146;798;800;2;0;0.83
28;147;800;802;2;0;0.83
28;148;802;805;3;0;0.83
28;149;805;809;4;0;0.83
28;150;809;816;7;0;0.83
28;151;816;820;4;0;0.83
28;152;820;821;1;0;0.83
28;153;821;822;1;0;0.83
28;154;822;824;2;0;0.83
28;155;824;825;1;0;0.83
28;156;825;826;1;0;0.83
28;157;826;827;1;0;0.83
28;158;827;832;5;0;0.83
28;159;832;834;2;0;0.83
28;160;834;835;1;0;0.83
28;161;835;836;1;0;0.83
28;162;836;838;2;0;0.83
28;163;838;840;2;0;0.83
28;164;840;841;1;0;0.83
28;165;841;842;1;0;0.83
28;166;842;852;10;0;0.83
28;167;852;853;1;0;0.83
28;168;853;856;3;0;0.83
28;169;856;857;1;0;0.83
28;170;857;858;1;0;0.83
28;171;858;859;1;0;0.83
28;172;859;860;1;0;0.83
28;173;860;864;4;0;0.83
28;174;864;867;3;0;0.83
28;175;867;868;1;0;0.83
28;176;868;870;2;0;0.83
28;177;870;872;2;0;0.83
28;178;872;873;1;0;0.83
28;179;873;874;1;0;0.83
28;180;874;876;2;0;0.83
28;181;876;878;2;0;0.83
28;182;878;879;1;0;0.83
28;183;879;883;4;0;0.83
28;184;883;884;1;0;0.83
28;185;884;886;2;0;0.83
28;186;886;887;1;0;0.83
28;187;887;889;2;0;0.83
28;188;889;890;1;0;0.83
28;189;890;891;1;0;0.83
28;190;891;892;1;0;0.83
28;191;892;896;4;0;0.83
28;192;896;899;3;0;0.83
28;193;899;901;2;0;0.83
28;194;901;905;4;0;0.83
28;195;905;907;2;0;0.83
28;196;907;911;4;0;0.83
28;197;911;912;1;0;0.83
28;198;912;913;1;0;0.83
28;199;913;914;1;0;0.83
28;200;914;916;2;0;0.83
28;201;916;917;1;0;0.83
28;202;917;921;4;0;0.83
28;203;921;922;1;0;0.83
28;204;922;925;3;0;0.83
28;205;925;927;2;0;0.83
28;206;927;929;2;0;0.83
28;207;929;930;1;0;0.83
28;208;930;931;1;0;0.83
28;209;931;936;5;0;0.83
28;210;936;940;4;0;0.83
28;211;940;941;1;0;0.83
28;212;941;942;1;0;0.83
28;213;942;944;2;0;0.83
28;214;944;947;3;0;0.83
28;215;947;948;1;0;0.83
28;216;948;950;2;0;0.83
28;217;950;951;1;0;0.83
28;218;951;959;8;0;0.83
28;219;959;960;1;0;0.83
28;220;960;961;1;0;0.83
28;221;961;962;1;0;0.83
28;222;962;965;3;0;0.83
28;223;965;968;3;0;0.83
28;224;968;971;3;0;0.83
28;225;971;972;1;0;0.83
28;226;972;973;1;0;0.83
28;227;973;974;1;0;0.83
28;228;974;977;3;0;0.83
28;229;977;979;2;0;0.83
28;230;979;980;1;0;0.83
28;231;980;982;2;0;0.83
28;232;982;983;1;0;0.83
28;233;983;995;12;0;0.83
28;234;995;998;3;0;0.83
28;235;998;999;1;0;0.83
28;236;999;1000;1;0;0.83
28;237;1000;1002;2;0;0.83
28;238;1002;1004;2;0;0.83
28;239;1004;1005;1;0;0.83
28;240;1005;1006;1;0;0.83
28;241;1006;1010;4;0;0.83
28;242;1010;1015;5;0;0.83
28;243;1015;1016;1;0;0.83
28;244;1016;1017;1;0;0.83
28;245;1017;1021;4;0;0.83
28;246;1021;1022;1;0;0.83
28;247;1022;1026;4;0;0.83
28;248;1026;1027;1;0;0.83
28;249;1027;1032;5;0;0.83
28;250;1032;1033;1;0;0.83
28;251;1033;1035;2;0;0.83
28;252;1035;1036;1;0;0.83
28;253;1036;1045;9;0;0.83
28;254;1045;1047;2;0;0.83
28;255;1047;1048;1;0;0.83
28;256;1048;1052;4;0;0.83
28;257;1052;1059;7;0;0.83
28;258;1059;1061;2;0;0.83
28;259;1061;1062;1;0;0.83
28;260;1062;1068;6;0;0.83
28;261;1068;1070;2;0;0.83
28;262;1070;1072;2;0;0.83
28;263;1072;1078;6;0;0.83
28;264;1078;1081;3;0;0.83
28;265;1081;1082;1;0;0.83
28;266;1082;1085;3;0;0.83
28;267;1085;1086;1;0;0.83
28;268;1086;1089;3;0;0.83
28;269;1089;1090;1;0;0.83
28;270;1090;1092;2;0;0.83
28;271;1092;1095;3;0;0.83
28;272;1095;1098;3;0;0.83
28;273;1098;1100;2;0;0.83
28;274;1100;1102;2;0;0.83
28;275;1102;1103;1;0;0.83
28;276;1103;1105;2;0;0.83
28;277;1105;1112;7;0;0.83
28;278;1112;1113;1;0;0.83
28;279;1113;1115;2;0;0.83
28;280;1115;1122;7;0;0.83
28;281;1122;1125;3;0;0.83
28;282;1125;1138;13;0;0.83
28;283;1138;1140;2;0;0.83
28;284;1140;1144;4;0;0.83
28;285;1144;1145;1;0;0.83
28;286;1145;1151;6;0;0.83
28;287;1151;1152;1;0;0.83
28;288;1152;1154;2;0;0.83
28;289;1154;1173;19;0;0.83
28;290;1173;1175;2;0;0.83
28;291;1175;1178;3;0;0.83
28;292;1178;1185;7;0;0.83
28;293;1185;1202;17;0;0.83
28;294;1202;1207;5;0;0.83
28;295;1207;1211;4;0;0.83
28;296;1211;1213;2;0;0.83
28;297;1213;1220;7;0;0.83
28;298;1220;1223;3;0;0.83
28;299;1223;1225;2;0;0.83
28;300;1225;1235;10;0;0.83
28;301;1235;1256;21;0;0.83
28;302;1256;1260;4;0;0.83
28;303;1260;1265;5;0;0.83
28;304;1265;1271;6;0;0.83
28;305;1271;1273;2;0;0.83
28;306;1273;1274;1;0;0.83
28;307;1274;1283;9;0;0.83
28;308;1283;1295;12;0;0.83
28;309;1295;1300;5;0;0.83
28;310;1300;1306;6;0;0.83
28;311;1306;1308;2;0;0.83
28;312;1308;1321;13;0;0.83
28;313;1321;1324;3;0;0.83
28;314;1324;1325;1;0;0.83
28;315;1325;1327;2;0;0.83
28;316;1327;1330;3;0;0.83
28;317;1330;1340;10;0;0.83
28;318;1340;1342;2;0;0.83
28;319;1342;1344;2;0;0.83
28;320;1344;1346;2;0;0.83
28;321;1346;1353;7;0;0.83
28;322;1353;1361;8;0;0.83
28;323;1361;1362;1;0;0.83
28;324;1362;1364;2;0;0.83
28;325;1364;1365;1;0;0.83
28;326;1365;1366;1;0;0.83
28;327;1366;1367;1;0;0.83
28;328;1367;1378;11;0;0.83
28;329;1378;1381;3;0;0.83
28;330;1381;1385;4;0;0.83
28;331;1385;1388;3;0;0.83
28;332;1388;1394;6;0;0.83
28;333;1394;1396;2;0;0.83
28;334;1396;1411;15;0;0.83
28;335;1411;1426;15;0;0.83
28;336;1426;1441;15;0;0.83
28;337;1441;1456;15;0;0.83
28;338;1456;1471;15;0;0.83
28;339;1471;1486;15;0;0.83
28;340;1486;1501;15;0;0.83
28;341;1501;1516;15;0;0.83
28;342;1516;1531;15;0;0.83
28;343;1531;1546;15;0;0.83
28;344;1546;1561;15;0;0.83
28;345;1561;1576;15;0;0.83
28;346;1576;1591;15;0;0.83
28;347;1591;1606;15;0;0.83
28;348;1606;1621;15;0;0.83
28;349;1621;1636;15;0;0.83
28;350;1636;1651;15;0;0.83
28;351;1651;1666;15;0;0.83
28;352;1666;1680;14;0;0.83
29;0;240;330;90;0;2.0
29;1;330;333;3;0;2.0
29;2;333;334;1;0;2.0
29;3;334;336;2;0;2.0
29;4;336;337;1;0;2.0
29;5;337;338;1;0;2.0
29;6;338;339;1;0;2.0
29;7;339;341;2;0;2.0
29;8;341;342;1;0;2.0
29;9;342;349;7;0;2.0
29;10;349;351;2;0;2.0
29;11;351;352;1;0;2.0
29;12;352;354;2;0;2.0
29;13;354;355;1;0;2.0
29;14;355;359;4;0;2.0
29;15;359;360;1;0;2.0
29;16;360;361;1;0;2.0
29;17;361;362;1;0;2.0
29;18;362;364;2;0;2.0
29;19;364;366;2;0;2.0
29;20;366;369;3;0;2.0
29;21;369;371;2;0;2.0
29;22;371;372;1;0;2.0
29;23;372;377;5;0;2.0
29;24;377;378;1;0;2.0
29;25;378;384;6;0;2.0
29;26;384;386;2;0;2.0
29;27;386;389;3;0;2.0
29;28;389;392;3;0;2.0
29;29;392;394;2;0;2.0
29;30;394;395;1;0;2.0
29;31;395;397;2;0;2.0
29;32;397;398;1;0;2.0
29;33;398;400;2;0;2.0
29;34;400;401;1;0;2.0
29;35;401;407;6;0;2.0
29;36;407;408;1;0;2.0
29;37;408;409;1;0;2.0
29;38;409;412;3;0;2.0
29;39;412;417;5;0;2.0
29;40;417;419;2;0;2.0
29;41;419;420;1;0;2.0
29;42;420;421;1;0;2.0
29;43;421;422;1;0;2.0
29;44;422;424;2;0;2.0
29;45;424;426;2;0;2.0
29;46;426;429;3;0;2.0
29;47;429;432;3;0;2.0
29;48;432;435;3;0;2.0
29;49;435;439;4;0;2.0
29;50;439;446;7;0;2.0
29;51;446;447;1;0;2.0
29;52;447;449;2;0;2.0
29;53;449;450;1;0;2.0
29;54;450;451;1;0;2.0
29;55;451;454;3;0;2.0
29;56;454;455;1;0;2.0
29;57;455;456;1;0;2.0
29;58;456;457;1;0;2.0
29;59;457;461;4;0;2.0
29;60;461;465;4;0;2.0
29;61;465;467;2;0;2.0
29;62;467;469;2;0;2.0
29;63;469;472;3;0;2.0
29;64;472;474;2;0;2.0
29;65;474;475;1;0;2.0
29;66;475;477;2;0;2.0
29;67;477;482;5;0;2.0
29;68;482;484;2;0;2.0
29;69;484;485;1;0;2.0
29;70;485;487;2;0;2.0
29;71;487;496;9;0;2.0
29;72;496;499;3;0;2.0
29;73;499;502;3;0;2.0
29;74;502;503;1;0;2.0
29;75;503;505;2;0;2.0
29;76;505;506;1;0;2.0
29;77;506;509;3;0;2.0
29;78;509;515;6;0;2.0
29;79;515;516;1;0;2.0
29;80;516;517;1;0;2.0
29;81;517;522;5;0;2.0
29;82;522;527;5;0;2.0
29;83;527;532;5;0;2.0
29;84;532;536;4;0;2.0
29;85;536;539;3;0;2.0
29;86;539;544;5;0;2.0
29;87;544;545;1;0;2.0
29;88;545;548;3;0;2.0
29;89;548;549;1;0;2.0
29;90;549;551;2;0;2.0
29;91;551;554;3;0;2.0
29;92;554;557;3;0;2.0
29;93;557;575;18;0;2.0
29;94;575;578;3;0;2.0
29;95;578;587;9;0;2.0
29;96;587;589;2;0;2.0
29;97;589;592;3;0;2.0
29;98;592;593;1;0;2.0
29;99;593;594;1;0;2.0
29;100;594;595;1;0;2.0
29;101;595;596;1;0;2.0
29;102;596;600;4;0;2.0
29;103;600;617;17;0;2.0
29;104;617;620;3;0;2.0
29;105;620;627;7;0;2.0
29;106;627;629;2;0;2.0
29;107;629;631;2;0;2.0
29;108;631;637;6;0;2.0
29;109;637;656;19;0;2.0
29;110;656;659;3;0;2.0
29;111;659;661;2;0;2.0
29;112;661;662;1;0;2.0
29;113;662;663;1;0;2.0
29;114;663;674;11;0;2.0
29;115;674;677;3;0;2.0
29;116;677;683;6;0;2.0
29;117;683;695;12;0;2.0
29;118;695;697;2;0;2.0
29;119;697;699;2;0;2.0
29;120;699;704;5;0;2.0
29;121;704;707;3;0;2.0
29;122;707;716;9;0;2.0
29;123;716;720;4;0;2.0
29;124;720;722;2;0;2.0
29;125;722;724;2;0;2.0
29;126;724;728;4;0;2.0
29;127;728;729;1;0;2.0
29;128;729;732;3;0;2.0
29;129;732;737;5;0;2.0
29;130;737;740;3;0;2.0
29;131;740;750;10;0;2.0
29;132;750;751;1;0;2.0
29;133;751;762;11;0;2.0
29;134;762;764;2;0;2.0
29;135;764;767;3;0;2.0
29;136;767;769;2;0;2.0
29;137;769;772;3;0;2.0
29;138;772;776;4;0;2.0
29;139;776;779;3;0;2.0
29;140;779;780;1;0;2.0
29;141;780;786;6;0;2.0
29;142;786;792;6;0;2.0
29;143;792;795;3;0;2.0
29;144;795;797;2;0;2.0
29;145;797;798;1;0;2.0
29;146;798;800;2;0;2.0
29;147;800;802;2;0;2.0
29;148;802;805;3;0;2.0
29;149;805;809;4;0;2.0
29;150;809;816;7;0;2.0
29;151;816;820;4;0;2.0
29;152;820;821;1;0;2.0
29;153;821;822;1;0;2.0
29;154;822;824;2;0;2.0
29;155;824;825;1;0;2.0
29;156;825;826;1;0;2.0
29;157;826;827;1;0;2.0
29;158;827;832;5;0;2.0
29;159;832;834;2;0;2.0
29;160;834;835;1;0;2.0
29;161;835;836;1;0;2.0
29;162;836;838;2;0;2.0
29;163;838;840;2;0;2.0
29;164;840;841;1;0;2.0
29;165;841;842;1;0;2.0
29;166;842;852;10;0;2.0
29;167;852;853;1;0;2.0
29;168;853;856;3;0;2.0
29;169;856;857;1;0;2.0
29;170;857;858;1;0;2.0
29;171;858;859;1;0;2.0
29;172;859;860;1;0;2.0
29;173;860;864;4;0;2.0
29;174;864;867;3;0;2.0
29;175;867;868;1;0;2.0
29;176;868;870;2;0;2.0
29;177;870;872;2;0;2.0
29;178;872;873;1;0;2.0
29;179;873;874;1;0;2.0
29;180;874;876;2;0;2.0
29;181;876;878;2;0;2.0
29;182;878;879;1;0;2.0
29;183;879;883;4;0;2.0
29;184;883;884;1;0;2.0
29;185;884;886;2;0;2.0
29;186;886;887;1;0;2.0
29;187;887;889;2;0;2.0
29;188;889;890;1;0;2.0
29;189;890;891;1;0;2.0
29;190;891;892;1;0;2.0
29;191;892;896;4;0;2.0
29;192;896;899;3;0;2.0
29;193;899;901;2;0;2.0
29;194;901;905;4;0;2.0
29;195;905;907;2;0;2.0
29;196;907;911;4;0;2.0
29;197;911;912;1;0;2.0
29;198;912;913;1;0;2.0
29;199;913;914;1;0;2.0
29;200;914;916;2;0;2.0
29;201;916;917;1;0;2.0
29;202;917;921;4;0;2.0
29;203;921;922;1;0;2.0
29;204;922;925;3;0;2.0
29;205;925;927;2;0;2.0
29;206;927;929;2;0;2.0
29;207;929;930;1;0;2.0
29;208;930;931;1;0;2.0
29;209;931;936;5;0;2.0
29;210;936;940;4;0;2.0
29;211;940;941;1;0;2.0
29;212;941;942;1;0;2.0
29;213;942;944;2;0;2.0
29;214;944;947;3;0;2.0
29;215;947;948;1;0;2.0
29;216;948;950;2;0;2.0
29;217;950;951;1;0;2.0
29;218;951;959;8;0;2.0
29;219;959;960;1;0;2.0
29;220;960;961;1;0;2.0
29;221;961;962;1;0;2.0
29;222;962;965;3;0;2.0
29;223;965;968;3;0;2.0
29;224;968;971;3;0;2.0
29;225;971;972;1;0;2.0
29;226;972;973;1;0;2.0
29;227;973;974;1;0;2.0
29;228;974;977;3;0;2.0
29;229;977;979;2;0;2.0
29;230;979;980;1;0;2.0
29;231;980;982;2;0;2.0
29;232;982;983;1;0;2.0
29;233;983;995;12;0;2.0
29;234;995;998;3;0;2.0
29;235;998;999;1;0;2.0
29;236;999;1000;1;0;2.0
29;237;1000;1002;2;0;2.0
29;238;1002;1004;2;0;2.0
29;239;1004;1005;1;0;2.0
29;240;1005;1006;1;0;2.0
29;241;1006;1010;4;0;2.0
29;242;1010;1015;5;0;2.0
29;243;1015;1016;1;0;2.0
29;244;1016;1017;1;0;2.0
29;245;1017;1021;4;0;2.0
29;246;1021;1022;1;0;2.0
29;247;1022;1026;4;0;2.0
29;248;1026;1027;1;0;2.0
29;249;1027;1032;5;0;2.0
29;250;1032;1033;1;0;2.0
29;251;1033;1035;2;0;2.0
29;252;1035;1036;1;0;2.0
29;253;1036;1045;9;0;2.0
29;254;1045;1047;2;0;2.0
29;255;1047;1048;1;0;2.0
29;256;1048;1052;4;0;2.0
29;257;1052;1059;7;0;2.0
29;258;1059;1061;2;0;2.0
29;259;1061;1062;1;0;2.0
29;260;1062;1068;6;0;2.0
29;261;1068;1070;2;0;2.0
29;262;1070;1072;2;0;2.0
29;263;1072;1078;6;0;2.0
29;264;1078;1081;3;0;2.0
29;265;1081;1082;1;0;2.0
29;266;1082;1085;3;0;2.0
29;267;1085;1086;1;0;2.0
29;268;1086;1089;3;0;2.0
29;269;1089;1090;1;0;2.0
29;270;1090;1092;2;0;2.0
29;271;1092;1095;3;0;2.0
29;272;1095;1098;3;0;2.0
29;273;1098;1100;2;0;2.0
29;274;1100;1102;2;0;2.0
29;275;1102;1103;1;0;2.0
29;276;1103;1105;2;0;2.0
29;277;1105;1112;7;0;2.0
29;278;1112;1113;1;0;2.0
29;279;1113;1115;2;0;2.0
29;280;1115;1122;7;0;2.0
29;281;1122;1125;3;0;2.0
29;282;1125;1138;13;0;2.0
29;283;1138;1140;2;0;2.0
29;284;1140;1144;4;0;2.0
29;285;1144;1145;1;0;2.0
29;286;1145;1151;6;0;2.0
29;287;1151;1152;1;0;2.0
29;288;1152;1154;2;0;2.0
29;289;1154;1173;19;0;2.0
29;290;1173;1175;2;0;2.0
29;291;1175;1178;3;0;2.0
29;292;1178;1185;7;0;2.0
29;293;1185;1202;17;0;2.0
29;294;1202;1207;5;0;2.0
29;295;1207;1211;4;0;2.0
29;296;1211;1213;2;0;2.0
29;297;1213;1220;7;0;2.0
29;298;1220;1223;3;0;2.0
29;299;1223;1225;2;0;2.0
29;300;1225;1235;10;0;2.0
29;301;1235;1256;21;0;2.0
29;302;1256;1260;4;0;2.0
29;303;1260;1265;5;0;2.0
29;304;1265;1271;6;0;2.0
29;305;1271;1273;2;0;2.0
29;306;1273;1274;1;0;2.0
29;307;1274;1283;9;0;2.0
29;308;1283;1295;12;0;2.0
29;309;1295;1300;5;0;2.0
29;310;1300;1306;6;0;2.0
29;311;1306;1308;2;0;2.0
29;312;1308;1321;13;0;2.0
29;313;1321;1324;3;0;2.0
29;314;1324;1325;1;0;2.0
29;315;1325;1327;2;0;2.0
29;316;1327;1330;3;0;2.0
29;317;1330;1340;10;0;2.0
29;318;1340;1342;2;0;2.0
29;319;1342;1344;2;0;2.0
29;320;1344;1346;2;0;2.0
29;321;1346;1353;7;0;2.0
29;322;1353;1361;8;0;2.0
29;323;1361;1362;1;0;2.0
29;324;1362;1364;2;0;2.0
29;325;1364;1365;1;0;2.0
29;326;1365;1366;1;0;2.0
29;327;1366;1367;1;0;2.0
29;328;1367;1378;11;0;2.0
29;329;1378;1381;3;0;2.0
29;330;1381;1385;4;0;2.0
29;331;1385;1388;3;0;2.0
29;332;1388;1394;6;0;2.0
29;333;1394;1396;2;0;2.0
29;334;1396;1411;15;0;2.0
29;335;1411;1426;15;0;2.0
29;336;1426;1441;15;0;2.0
29;337;1441;1456;15;0;2.0
29;338;1456;1471;15;0;2.0
29;339;1471;1486;15;0;2.0
29;340;1486;1501;15;0;2.0
29;341;1501;1516;15;0;2.0
29;342;1516;1531;15;0;2.0
29;343;1531;1546;15;0;2.0
29;344;1546;1561;15;0;2.0
29;345;1561;1576;15;0;2.0
29;346;1576;1591;15;0;2.0
29;347;1591;1606;15;0;2.0
29;348;1606;1621;15;0;2.0
29;349;1621;1636;15;0;2.0
29;350;1636;1651;15;0;2.0
29;351;1651;1666;15;0;2.0
29;352;1666;1680;14;0;2.0
30;0;240;330;90;0;2.0
30;1;330;333;3;0;2.0
30;2;333;334;1;0;2.0
30;3;334;336;2;0;2.0
30;4;336;337;1;0;2.0
30;5;337;338;1;0;2.0
30;6;338;339;1;0;2.0
30;7;339;341;2;0;2.0
30;8;341;342;1;0;2.0
30;9;342;349;7;0;2.0
30;10;349;351;2;0;2.0
30;11;351;352;1;0;2.0
30;12;352;354;2;0;2.0
30;13;354;355;1;0;2.0
30;14;355;359;4;0;2.0
30;15;359;360;1;0;2.0
30;16;360;361;1;0;2.0
30;17;361;362;1;0;2.0
30;18;362;364;2;0;2.0
30;19;364;366;2;0;2.0
30;20;366;369;3;0;2.0
30;21;369;371;2;0;2.0
30;22;371;372;1;0;2.0
30;23;372;377;5;0;2.0
30;24;377;378;1;0;2.0
30;25;378;384;6;0;2.0
30;26;384;386;2;0;2.0
30;27;386;389;3;0;2.0
30;28;389;392;3;0;2.0
30;29;392;394;2;0;2.0
30;30;394;395;1;0;2.0
30;31;395;397;2;0;2.0
30;32;397;398;1;0;2.0
30;33;398;400;2;0;2.0
30;34;400;401;1;0;2.0
30;35;401;407;6;0;2.0
30;36;407;408;1;0;2.0
30;37;408;409;1;0;2.0
30;38;409;412;3;0;2.0
30;39;412;417;5;0;2.0
30;40;417;419;2;0;2.0
30;41;419;420;1;0;2.0
30;42;420;421;1;0;2.0
30;43;421;422;1;0;2.0
30;44;422;424;2;0;2.0
30;45;424;426;2;0;2.0
30;46;426;429;3;0;2.0
30;47;429;432;3;0;2.0
30;48;432;435;3;0;2.0
30;49;435;439;4;0;2.0
30;50;439;446;7;0;2.0
30;51;446;447;1;0;2.0
30;52;447;449;2;0;2.0
30;53;449;450;1;0;2.0
30;54;450;451;1;0;2.0
30;55;451;454;3;0;2.0
30;56;454;455;1;0;2.0
30;57;455;456;1;0;2.0
30;58;456;457;1;0;2.0
30;59;457;461;4;0;2.0
30;60;461;465;4;0;2.0
30;61;465;467;2;0;2.0
30;62;467;469;2;0;2.0
30;63;469;472;3;0;2.0
30;64;472;474;2;0;2.0
30;65;474;475;1;0;2.0
30;66;475;477;2;0;2.0
30;67;477;482;5;0;2.0
30;68;482;484;2;0;2.0
30;69;484;485;1;0;2.0
30;70;485;487;2;0;2.0
30;71;487;496;9;0;2.0
30;72;496;499;3;0;2.0
30;73;499;502;3;0;2.0
30;74;502;503;1;0;2.0
30;75;503;505;2;0;2.0
30;76;505;506;1;0;2.0
30;77;506;509;3;0;2.0
30;78;509;515;6;0;2.0
30;79;515;516;1;0;2.0
30;80;516;517;1;0;2.0
30;81;517;522;5;0;2.0
30;82;522;527;5;0;2.0
30;83;527;532;5;0;2.0
30;84;532;536;4;0;2.0
30;85;536;539;3;0;2.0
30;86;539;544;5;0;2.0
30;87;544;545;1;0;2.0
30;88;545;548;3;0;2.0
30;89;548;549;1;0;2.0
30;90;549;551;2;0;2.0
30;91;551;554;3;0;2.0
30;92;554;557;3;0;2.0
30;93;557;575;18;0;2.0
30;94;575;578;3;0;2.0
30;95;578;587;9;0;2.0
30;96;587;589;2;0;2.0
30;97;589;592;3;0;2.0
30;98;592;593;1;0;2.0
30;99;593;594;1;0;2.0
30;100;594;595;1;0;2.0
30;101;595;596;1;0;2.0
30;102;596;600;4;0;2.0
30;103;600;617;17;0;2.0
30;104;617;620;3;0;2.0
30;105;620;627;7;0;2.0
30;106;627;629;2;0;2.0
30;107;629;631;2;0;2.0
30;108;631;637;6;0;2.0
30;109;637;656;19;0;2.0
30;110;656;659;3;0;2.0
30;111;659;661;2;0;2.0
30;112;661;662;1;0;2.0
30;113;662;663;1;0;2.0
30;114;663;674;11;0;2.0
30;115;674;677;3;0;2.0
30;116;677;683;6;0;2.0
30;117;683;695;12;0;2.0
30;118;695;697;2;0;2.0
30;119;697;699;2;0;2.0
30;120;699;704;5;0;2.0
30;121;704;707;3;0;2.0
30;122;707;716;9;0;2.0
30;123;716;720;4;0;2.0
30;124;720;722;2;0;2.0
30;125;722;724;2;0;2.0
30;126;724;728;4;0;2.0
30;127;728;729;1;0;2.0
30;128;729;732;3;0;2.0
30;129;732;737;5;0;2.0
30;130;737;740;3;0;2.0
30;131;740;750;10;0;2.0
30;132;750;751;1;0;2.0
30;133;751;762;11;0;2.0
30;134;762;764;2;0;2.0
30;135;764;767;3;0;2.0
30;136;767;769;2;0;2.0
30;137;769;772;3;0;2.0
30;138;772;776;4;0;2.0
30;139;776;779;3;0;2.0
30;140;779;780;1;0;2.0
30;141;780;786;6;0;2.0
30;142;786;792;6;0;2.0
30;143;792;795;3;0;2.0
30;144;795;797;2;0;2.0
30;145;797;798;1;0;2.0
30;146;798;800;2;0;2.0
30;147;800;802;2;0;2.0
30;148;802;805;3;0;2.0
30;149;805;809;4;0;2.0
30;150;809;816;7;0;2.0
30;151;816;820;4;0;2.0
30;152;820;821;1;0;2.0
30;153;821;822;1;0;2.0
30;154;822;824;2;0;2.0
30;155;824;825;1;0;2.0
30;156;825;826;1;0;2.0
30;157;826;827;1;0;2.0
30;158;827;832;5;0;2.0
30;159;832;834;2;0;2.0
30;160;834;835;1;0;2.0
30;161;835;836;1;0;2.0
30;162;836;838;2;0;2.0
30;163;838;840;2;0;2.0
30;164;840;841;1;0;2.0
30;165;841;842;1;0;2.0
30;166;842;852;10;0;2.0
30;167;852;853;1;0;2.0
30;168;853;856;3;0;2.0
30;169;856;857;1;0;2.0
30;170;857;858;1;0;2.0
30;171;858;859;1;0;2.0
30;172;859;860;1;0;2.0
30;173;860;864;4;0;2.0
30;174;864;867;3;0;2.0
30;175;867;868;1;0;2.0
30;176;868;870;2;0;2.0
30;177;870;872;2;0;2.0
30;178;872;873;1;0;2.0
30;179;873;874;1;0;2.0
30;180;874;876;2;0;2.0
30;181;876;878;2;0;2.0
30;182;878;879;1;0;2.0
30;183;879;883;4;0;2.0
30;184;883;884;1;0;2.0
30;185;884;886;2;0;2.0
30;186;886;887;1;0;2.0
30;187;887;889;2;0;2.0
30;188;889;890;1;0;2.0
30;189;890;891;1;0;2.0
30;190;891;892;1;0;2.0
30;191;892;896;4;0;2.0
30;192;896;899;3;0;2.0
30;193;899;901;2;0;2.0
30;194;901;905;4;0;2.0
30;195;905;907;2;0;2.0
30;196;907;911;4;0;2.0
30;197;911;912;1;0;2.0
30;198;912;913;1;0;2.0
30;199;913;914;1;0;2.0
30;200;914;916;2;0;2.0
30;201;916;917;1;0;2.0
30;202;917;921;4;0;2.0
30;203;921;922;1;0;2.0
30;204;922;925;3;0;2.0
30;205;925;927;2;0;2.0
30;206;927;929;2;0;2.0
30;207;929;930;1;0;2.0
30;208;930;931;1;0;2.0
30;209;931;936;5;0;2.0
30;210;936;940;4;0;2.0
30;211;940;941;1;0;2.0
30;212;941;942;1;0;2.0
30;213;942;944;2;0;2.0
30;214;944;947;3;0;2.0
30;215;947;948;1;0;2.0
30;216;948;950;2;0;2.0
30;217;950;951;1;0;2.0
30;218;951;959;8;0;2.0
30;219;959;960;1;0;2.0
30;220;960;961;1;0;2.0
30;221;961;962;1;0;2.0
30;222;962;965;3;0;2.0
30;223;965;968;3;0;2.0
30;224;968;971;3;0;2.0
30;225;971;972;1;0;2.0
30;226;972;973;1;0;2.0
30;227;973;974;1;0;2.0
30;228;974;977;3;0;2.0
30;229;977;979;2;0;2.0
30;230;979;980;1;0;2.0
30;231;980;982;2;0;2.0
30;232;982;983;1;0;2.0
30;233;983;995;12;0;2.0
30;234;995;998;3;0;2.0
30;235;998;999;1;0;2.0
30;236;999;1000;1;0;2.0
30;237;1000;1002;2;0;2.0
30;238;1002;1004;2;0;2.0
30;239;1004;1005;1;0;2.0
30;240;1005;1006;1;0;2.0
30;241;1006;1010;4;0;2.0
30;242;1010;1015;5;0;2.0
30;243;1015;1016;1;0;2.0
30;244;1016;1017;1;0;2.0
30;245;1017;1021;4;0;2.0
30;246;1021;1022;1;0;2.0
30;247;1022;1026;4;0;2.0
30;248;1026;1027;1;0;2.0
30;249;1027;1032;5;0;2.0
30;250;1032;1033;1;0;2.0
30;251;1033;1035;2;0;2.0
30;252;1035;1036;1;0;2.0
30;253;1036;1045;9;0;2.0
30;254;1045;1047;2;0;2.0
30;255;1047;1048;1;0;2.0
30;256;1048;1052;4;0;2.0
30;257;1052;1059;7;0;2.0
30;258;1059;1061;2;0;2.0
30;259;1061;1062;1;0;2.0
30;260;1062;1068;6;0;2.0
30;261;1068;1070;2;0;2.0
30;262;1070;1072;2;0;2.0
30;263;1072;1078;6;0;2.0
30;264;1078;1081;3;0;2.0
30;265;1081;1082;1;0;2.0
30;266;1082;1085;3;0;2.0
30;267;1085;1086;1;0;2.0
30;268;1086;1089;3;0;2.0
30;269;1089;1090;1;0;2.0
30;270;1090;1092;2;0;2.0
30;271;1092;1095;3;0;2.0
30;272;1095;1098;3;0;2.0
30;273;1098;1100;2;0;2.0
30;274;1100;1102;2;0;2.0
30;275;1102;1103;1;0;2.0
30;276;1103;1105;2;0;2.0
30;277;1105;1112;7;0;2.0
30;278;1112;1113;1;0;2.0
30;279;1113;1115;2;0;2.0
30;280;1115;1122;7;0;2.0
30;281;1122;1125;3;0;2.0
30;282;1125;1138;13;0;2.0
30;283;1138;1140;2;0;2.0
30;284;1140;1144;4;0;2.0
30;285;1144;1145;1;0;2.0
30;286;1145;1151;6;0;2.0
30;287;1151;1152;1;0;2.0
30;288;1152;1154;2;0;2.0
30;289;1154;1173;19;0;2.0
30;290;1173;1175;2;0;2.0
30;291;1175;1178;3;0;2.0
30;292;1178;1185;7;0;2.0
30;293;1185;1202;17;0;2.0
30;294;1202;1207;5;0;2.0
30;295;1207;1211;4;0;2.0
30;296;1211;1213;2;0;2.0
30;297;1213;1220;7;0;2.0
30;298;1220;1223;3;0;2.0
30;299;1223;1225;2;0;2.0
30;300;1225;1235;10;0;2.0
30;301;1235;1256;21;0;2.0
30;302;1256;1260;4;0;2.0
30;303;1260;1265;5;0;2.0
30;304;1265;1271;6;0;2.0
30;305;1271;1273;2;0;2.0
30;306;1273;1274;1;0;2.0
30;307;1274;1283;9;0;2.0
30;308;1283;1295;12;0;2.0
30;309;1295;1300;5;0;2.0
30;310;1300;1306;6;0;2.0
30;311;1306;1308;2;0;2.0
30;312;1308;1321;13;0;2.0
30;313;1321;1324;3;0;2.0
30;314;1324;1325;1;0;2.0
30;315;1325;1327;2;0;2.0
30;316;1327;1330;3;0;2.0
30;317;1330;1340;10;0;2.0
30;318;1340;1342;2;0;2.0
30;319;1342;1344;2;0;2.0
30;320;1344;1346;2;0;2.0
30;321;1346;1353;7;0;2.0
30;322;1353;1361;8;0;2.0
30;323;1361;1362;1;0;2.0
30;324;1362;1364;2;0;2.0
30;325;1364;1365;1;0;2.0
30;326;1365;1366;1;0;2.0
30;327;1366;1367;1;0;2.0
30;328;1367;1378;11;0;2.0
30;329;1378;1381;3;0;2.0
30;330;1381;1385;4;0;2.0
30;331;1385;1388;3;0;2.0
30;332;1388;1394;6;0;2.0
30;333;1394;1396;2;0;2.0
30;334;1396;1411;15;0;2.0
30;335;1411;1426;15;0;2.0
30;336;1426;1441;15;0;2.0
30;337;1441;1456;15;0;2.0
30;338;1456;1471;15;0;2.0
30;339;1471;1486;15;0;2.0
30;340;1486;1501;15;0;2.0
30;341;1501;1516;15;0;2.0
30;342;1516;1531;15;0;2.0
30;343;1531;1546;15;0;2.0
30;344;1546;1561;15;0;2.0
30;345;1561;1576;15;0;2.0
30;346;1576;1591;15;0;2.0
30;347;1591;1606;15;0;2.0
30;348;1606;1621;15;0;2.0
30;349;1621;1636;15;0;2.0
30;350;1636;1651;15;0;2.0
30;351;1651;1666;15;0;2.0
30;352;1666;1680;14;0;2.0
