Index Nabijacky;Index Udalosti;Cas Zaciatku;Cas Konca;CasTrvania;Miesto;Rychlost nabijania
0;0;249;328;79;112;2.0
0;1;328;333;5;112;2.0
0;2;333;337;4;112;2.0
0;3;337;341;4;112;2.0
0;4;341;343;2;112;2.0
0;5;343;352;9;112;2.0
0;6;352;357;5;112;2.0
0;7;357;358;1;112;2.0
0;8;358;361;3;112;2.0
0;9;361;363;2;112;2.0
0;10;363;371;8;112;2.0
0;11;371;373;2;112;2.0
0;12;373;376;3;112;2.0
0;13;376;378;2;112;2.0
0;14;378;388;10;112;2.0
0;15;388;392;4;112;2.0
0;16;392;393;1;112;2.0
0;17;393;396;3;112;2.0
0;18;396;407;11;112;2.0
0;19;407;411;4;112;2.0
0;20;411;413;2;112;2.0
0;21;413;420;7;112;2.0
0;22;420;423;3;112;2.0
0;23;423;424;1;112;2.0
0;24;424;428;4;112;2.0
0;25;428;431;3;112;2.0
0;26;431;433;2;112;2.0
0;27;433;446;13;112;2.0
0;28;446;448;2;112;2.0
0;29;448;452;4;112;2.0
0;30;452;453;1;112;2.0
0;31;453;455;2;112;2.0
0;32;455;456;1;112;2.0
0;33;456;465;9;112;2.0
0;34;465;466;1;112;2.0
0;35;466;467;1;112;2.0
0;36;467;475;8;112;2.0
0;37;475;482;7;112;2.0
0;38;482;488;6;112;2.0
0;39;488;498;10;112;2.0
0;40;498;501;3;112;2.0
0;41;501;505;4;112;2.0
0;42;505;506;1;112;2.0
0;43;506;515;9;112;2.0
0;44;515;518;3;112;2.0
0;45;518;528;10;112;2.0
0;46;528;531;3;112;2.0
0;47;531;545;14;112;2.0
0;48;545;551;6;112;2.0
0;49;551;553;2;112;2.0
0;50;553;586;33;112;2.0
0;51;586;591;5;112;2.0
0;52;591;593;2;112;2.0
0;53;593;595;2;112;2.0
0;54;595;620;25;112;2.0
0;55;620;633;13;112;2.0
0;56;633;636;3;112;2.0
0;57;636;653;17;112;2.0
0;58;653;661;8;112;2.0
0;59;661;685;24;112;2.0
0;60;685;706;21;112;2.0
0;61;706;713;7;112;2.0
0;62;713;720;7;112;2.0
0;63;720;726;6;112;2.0
0;64;726;740;14;112;2.0
0;65;740;743;3;112;2.0
0;66;743;753;10;112;2.0
0;67;753;766;13;112;2.0
0;68;766;780;14;112;2.0
0;69;780;796;16;112;2.0
0;70;796;801;5;112;2.0
0;71;801;818;17;112;2.0
0;72;818;826;8;112;2.0
0;73;826;835;9;112;2.0
0;74;835;836;1;112;2.0
0;75;836;838;2;112;2.0
0;76;838;851;13;112;2.0
0;77;851;866;15;112;2.0
0;78;866;868;2;112;2.0
0;79;868;871;3;112;2.0
0;80;871;881;10;112;2.0
0;81;881;883;2;112;2.0
0;82;883;886;3;112;2.0
0;83;886;890;4;112;2.0
0;84;890;891;1;112;2.0
0;85;891;903;12;112;2.0
0;86;903;905;2;112;2.0
0;87;905;906;1;112;2.0
0;88;906;911;5;112;2.0
0;89;911;916;5;112;2.0
0;90;916;921;5;112;2.0
0;91;921;925;4;112;2.0
0;92;925;928;3;112;2.0
0;93;928;933;5;112;2.0
0;94;933;940;7;112;2.0
0;95;940;943;3;112;2.0
0;96;943;946;3;112;2.0
0;97;946;960;14;112;2.0
0;98;960;961;1;112;2.0
0;99;961;963;2;112;2.0
0;100;963;971;8;112;2.0
0;101;971;976;5;112;2.0
0;102;976;980;4;112;2.0
0;103;980;981;1;112;2.0
0;104;981;984;3;112;2.0
0;105;984;995;11;112;2.0
0;106;995;1001;6;112;2.0
0;107;1001;1003;2;112;2.0
0;108;1003;1006;3;112;2.0
0;109;1006;1018;12;112;2.0
0;110;1018;1023;5;112;2.0
0;111;1023;1031;8;112;2.0
0;112;1031;1036;5;112;2.0
0;113;1036;1045;9;112;2.0
0;114;1045;1051;6;112;2.0
0;115;1051;1063;12;112;2.0
0;116;1063;1066;3;112;2.0
0;117;1066;1071;5;112;2.0
0;118;1071;1073;2;112;2.0
0;119;1073;1085;12;112;2.0
0;120;1085;1090;5;112;2.0
0;121;1090;1091;1;112;2.0
0;122;1091;1097;6;112;2.0
0;123;1097;1100;3;112;2.0
0;124;1100;1103;3;112;2.0
0;125;1103;1104;1;112;2.0
0;126;1104;1126;22;112;2.0
0;127;1126;1147;21;112;2.0
0;128;1147;1150;3;112;2.0
0;129;1150;1173;23;112;2.0
0;130;1173;1180;7;112;2.0
0;131;1180;1210;30;112;2.0
0;132;1210;1220;10;112;2.0
0;133;1220;1223;3;112;2.0
0;134;1223;1227;4;112;2.0
0;135;1227;1267;40;112;2.0
0;136;1267;1270;3;112;2.0
0;137;1270;1283;13;112;2.0
0;138;1283;1285;2;112;2.0
0;139;1285;1320;35;112;2.0
0;140;1320;1322;2;112;2.0
0;141;1322;1334;12;112;2.0
0;142;1334;1348;14;112;2.0
0;143;1348;1384;36;112;2.0
0;144;1384;1387;3;112;2.0
0;145;1387;1388;1;112;2.0
0;146;1388;1398;10;112;2.0
0;147;1398;1413;15;112;2.0
0;148;1413;1428;15;112;2.0
0;149;1428;1443;15;112;2.0
0;150;1443;1458;15;112;2.0
0;151;1458;1473;15;112;2.0
0;152;1473;1488;15;112;2.0
0;153;1488;1503;15;112;2.0
0;154;1503;1518;15;112;2.0
0;155;1518;1533;15;112;2.0
0;156;1533;1548;15;112;2.0
0;157;1548;1563;15;112;2.0
0;158;1563;1578;15;112;2.0
0;159;1578;1593;15;112;2.0
0;160;1593;1608;15;112;2.0
0;161;1608;1623;15;112;2.0
0;162;1623;1638;15;112;2.0
0;163;1638;1653;15;112;2.0
0;164;1653;1668;15;112;2.0
0;165;1668;1680;12;112;2.0
1;0;245;335;90;93;2.0
1;1;335;336;1;93;2.0
1;2;336;340;4;93;2.0
1;3;340;350;10;93;2.0
1;4;350;355;5;93;2.0
1;5;355;356;1;93;2.0
1;6;356;360;4;93;2.0
1;7;360;365;5;93;2.0
1;8;365;366;1;93;2.0
1;9;366;375;9;93;2.0
1;10;375;379;4;93;2.0
1;11;379;385;6;93;2.0
1;12;385;386;1;93;2.0
1;13;386;389;3;93;2.0
1;14;389;395;6;93;2.0
1;15;395;400;5;93;2.0
1;16;400;410;10;93;2.0
1;17;410;416;6;93;2.0
1;18;416;420;4;93;2.0
1;19;420;422;2;93;2.0
1;20;422;426;4;93;2.0
1;21;426;427;1;93;2.0
1;22;427;430;3;93;2.0
1;23;430;436;6;93;2.0
1;24;436;445;9;93;2.0
1;25;445;446;1;93;2.0
1;26;446;455;9;93;2.0
1;27;455;457;2;93;2.0
1;28;457;458;1;93;2.0
1;29;458;465;7;93;2.0
1;30;465;467;2;93;2.0
1;31;467;470;3;93;2.0
1;32;470;477;7;93;2.0
1;33;477;481;4;93;2.0
1;34;481;485;4;93;2.0
1;35;485;500;15;93;2.0
1;36;500;506;6;93;2.0
1;37;506;508;2;93;2.0
1;38;508;517;9;93;2.0
1;39;517;519;2;93;2.0
1;40;519;530;11;93;2.0
1;41;530;535;5;93;2.0
1;42;535;546;11;93;2.0
1;43;546;547;1;93;2.0
1;44;547;553;6;93;2.0
1;45;553;585;32;93;2.0
1;46;585;594;9;93;2.0
1;47;594;597;3;93;2.0
1;48;597;601;4;93;2.0
1;49;601;623;22;93;2.0
1;50;623;626;3;93;2.0
1;51;626;634;8;93;2.0
1;52;634;635;1;93;2.0
1;53;635;660;25;93;2.0
1;54;660;664;4;93;2.0
1;55;664;686;22;93;2.0
1;56;686;705;19;93;2.0
1;57;705;721;16;93;2.0
1;58;721;722;1;93;2.0
1;59;722;729;7;93;2.0
1;60;729;743;14;93;2.0
1;61;743;750;7;93;2.0
1;62;750;754;4;93;2.0
1;63;754;759;5;93;2.0
1;64;759;765;6;93;2.0
1;65;765;782;17;93;2.0
1;66;782;799;17;93;2.0
1;67;799;800;1;93;2.0
1;68;800;825;25;93;2.0
1;69;825;826;1;93;2.0
1;70;826;829;3;93;2.0
1;71;829;837;8;93;2.0
1;72;837;841;4;93;2.0
1;73;841;850;9;93;2.0
1;74;850;854;4;93;2.0
1;75;854;869;15;93;2.0
1;76;869;870;1;93;2.0
1;77;870;875;5;93;2.0
1;78;875;876;1;93;2.0
1;79;876;884;8;93;2.0
1;80;884;885;1;93;2.0
1;81;885;891;6;93;2.0
1;82;891;892;1;93;2.0
1;83;892;904;12;93;2.0
1;84;904;905;1;93;2.0
1;85;905;907;2;93;2.0
1;86;907;909;2;93;2.0
1;87;909;914;5;93;2.0
1;88;914;920;6;93;2.0
1;89;920;928;8;93;2.0
1;90;928;934;6;93;2.0
1;91;934;935;1;93;2.0
1;92;935;939;4;93;2.0
1;93;939;942;3;93;2.0
1;94;942;945;3;93;2.0
1;95;945;949;4;93;2.0
1;96;949;951;2;93;2.0
1;97;951;960;9;93;2.0
1;98;960;962;2;93;2.0
1;99;962;964;2;93;2.0
1;100;964;969;5;93;2.0
1;101;969;974;5;93;2.0
1;102;974;980;6;93;2.0
1;103;980;982;2;93;2.0
1;104;982;985;3;93;2.0
1;105;985;997;12;93;2.0
1;106;997;999;2;93;2.0
1;107;999;1000;1;93;2.0
1;108;1000;1011;11;93;2.0
1;109;1011;1024;13;93;2.0
1;110;1024;1025;1;93;2.0
1;111;1025;1029;4;93;2.0
1;112;1029;1030;1;93;2.0
1;113;1030;1034;4;93;2.0
1;114;1034;1047;13;93;2.0
1;115;1047;1050;3;93;2.0
1;116;1050;1059;9;93;2.0
1;117;1059;1069;10;93;2.0
1;118;1069;1070;1;93;2.0
1;119;1070;1071;1;93;2.0
1;120;1071;1080;9;93;2.0
1;121;1080;1087;7;93;2.0
1;122;1087;1090;3;93;2.0
1;123;1090;1093;3;93;2.0
1;124;1093;1098;5;93;2.0
1;125;1098;1102;4;93;2.0
1;126;1102;1105;3;93;2.0
1;127;1105;1119;14;93;2.0
1;128;1119;1149;30;93;2.0
1;129;1149;1155;6;93;2.0
1;130;1155;1175;20;93;2.0
1;131;1175;1181;6;93;2.0
1;132;1181;1209;28;93;2.0
1;133;1209;1223;14;93;2.0
1;134;1223;1225;2;93;2.0
1;135;1225;1228;3;93;2.0
1;136;1228;1269;41;93;2.0
1;137;1269;1275;6;93;2.0
1;138;1275;1285;10;93;2.0
1;139;1285;1286;1;93;2.0
1;140;1286;1319;33;93;2.0
1;141;1319;1325;6;93;2.0
1;142;1325;1341;16;93;2.0
1;143;1341;1349;8;93;2.0
1;144;1349;1383;34;93;2.0
1;145;1383;1390;7;93;2.0
1;146;1390;1395;5;93;2.0
1;147;1395;1399;4;93;2.0
1;148;1399;1414;15;93;2.0
1;149;1414;1429;15;93;2.0
1;150;1429;1444;15;93;2.0
1;151;1444;1459;15;93;2.0
1;152;1459;1474;15;93;2.0
1;153;1474;1489;15;93;2.0
1;154;1489;1504;15;93;2.0
1;155;1504;1519;15;93;2.0
1;156;1519;1534;15;93;2.0
1;157;1534;1549;15;93;2.0
1;158;1549;1564;15;93;2.0
1;159;1564;1579;15;93;2.0
1;160;1579;1594;15;93;2.0
1;161;1594;1609;15;93;2.0
1;162;1609;1624;15;93;2.0
1;163;1624;1639;15;93;2.0
1;164;1639;1654;15;93;2.0
1;165;1654;1669;15;93;2.0
1;166;1669;1680;11;93;2.0
2;0;246;335;89;92;2.0
2;1;335;336;1;92;2.0
2;2;336;339;3;92;2.0
2;3;339;340;1;92;2.0
2;4;340;350;10;92;2.0
2;5;350;354;4;92;2.0
2;6;354;355;1;92;2.0
2;7;355;359;4;92;2.0
2;8;359;360;1;92;2.0
2;9;360;365;5;92;2.0
2;10;365;375;10;92;2.0
2;11;375;379;4;92;2.0
2;12;379;385;6;92;2.0
2;13;385;388;3;92;2.0
2;14;388;394;6;92;2.0
2;15;394;395;1;92;2.0
2;16;395;400;5;92;2.0
2;17;400;409;9;92;2.0
2;18;409;410;1;92;2.0
2;19;410;415;5;92;2.0
2;20;415;420;5;92;2.0
2;21;420;421;1;92;2.0
2;22;421;425;4;92;2.0
2;23;425;426;1;92;2.0
2;24;426;430;4;92;2.0
2;25;430;436;6;92;2.0
2;26;436;445;9;92;2.0
2;27;445;454;9;92;2.0
2;28;454;455;1;92;2.0
2;29;455;456;1;92;2.0
2;30;456;457;1;92;2.0
2;31;457;458;1;92;2.0
2;32;458;465;7;92;2.0
2;33;465;466;1;92;2.0
2;34;466;469;3;92;2.0
2;35;469;476;7;92;2.0
2;36;476;480;4;92;2.0
2;37;480;484;4;92;2.0
2;38;484;500;16;92;2.0
2;39;500;505;5;92;2.0
2;40;505;506;1;92;2.0
2;41;506;507;1;92;2.0
2;42;507;516;9;92;2.0
2;43;516;518;2;92;2.0
2;44;518;530;12;92;2.0
2;45;530;535;5;92;2.0
2;46;535;545;10;92;2.0
2;47;545;546;1;92;2.0
2;48;546;552;6;92;2.0
2;49;552;585;33;92;2.0
2;50;585;593;8;92;2.0
2;51;593;596;3;92;2.0
2;52;596;601;5;92;2.0
2;53;601;623;22;92;2.0
2;54;623;625;2;92;2.0
2;55;625;633;8;92;2.0
2;56;633;635;2;92;2.0
2;57;635;660;25;92;2.0
2;58;660;663;3;92;2.0
2;59;663;685;22;92;2.0
2;60;685;705;20;92;2.0
2;61;705;721;16;92;2.0
2;62;721;728;7;92;2.0
2;63;728;743;15;92;2.0
2;64;743;750;7;92;2.0
2;65;750;753;3;92;2.0
2;66;753;758;5;92;2.0
2;67;758;765;7;92;2.0
2;68;765;781;16;92;2.0
2;69;781;798;17;92;2.0
2;70;798;800;2;92;2.0
2;71;800;825;25;92;2.0
2;72;825;826;1;92;2.0
2;73;826;828;2;92;2.0
2;74;828;836;8;92;2.0
2;75;836;840;4;92;2.0
2;76;840;850;10;92;2.0
2;77;850;853;3;92;2.0
2;78;853;868;15;92;2.0
2;79;868;870;2;92;2.0
2;80;870;875;5;92;2.0
2;81;875;883;8;92;2.0
2;82;883;885;2;92;2.0
2;83;885;891;6;92;2.0
2;84;891;903;12;92;2.0
2;85;903;905;2;92;2.0
2;86;905;906;1;92;2.0
2;87;906;908;2;92;2.0
2;88;908;913;5;92;2.0
2;89;913;920;7;92;2.0
2;90;920;928;8;92;2.0
2;91;928;933;5;92;2.0
2;92;933;935;2;92;2.0
2;93;935;938;3;92;2.0
2;94;938;941;3;92;2.0
2;95;941;945;4;92;2.0
2;96;945;948;3;92;2.0
2;97;948;951;3;92;2.0
2;98;951;960;9;92;2.0
2;99;960;961;1;92;2.0
2;100;961;963;2;92;2.0
2;101;963;968;5;92;2.0
2;102;968;973;5;92;2.0
2;103;973;980;7;92;2.0
2;104;980;981;1;92;2.0
2;105;981;984;3;92;2.0
2;106;984;996;12;92;2.0
2;107;996;998;2;92;2.0
2;108;998;1000;2;92;2.0
2;109;1000;1011;11;92;2.0
2;110;1011;1023;12;92;2.0
2;111;1023;1025;2;92;2.0
2;112;1025;1028;3;92;2.0
2;113;1028;1030;2;92;2.0
2;114;1030;1033;3;92;2.0
2;115;1033;1046;13;92;2.0
2;116;1046;1050;4;92;2.0
2;117;1050;1058;8;92;2.0
2;118;1058;1068;10;92;2.0
2;119;1068;1070;2;92;2.0
2;120;1070;1071;1;92;2.0
2;121;1071;1080;9;92;2.0
2;122;1080;1086;6;92;2.0
2;123;1086;1090;4;92;2.0
2;124;1090;1093;3;92;2.0
2;125;1093;1097;4;92;2.0
2;126;1097;1101;4;92;2.0
2;127;1101;1104;3;92;2.0
2;128;1104;1118;14;92;2.0
2;129;1118;1149;31;92;2.0
2;130;1149;1155;6;92;2.0
2;131;1155;1174;19;92;2.0
2;132;1174;1180;6;92;2.0
2;133;1180;1209;29;92;2.0
2;134;1209;1223;14;92;2.0
2;135;1223;1224;1;92;2.0
2;136;1224;1227;3;92;2.0
2;137;1227;1269;42;92;2.0
2;138;1269;1275;6;92;2.0
2;139;1275;1284;9;92;2.0
2;140;1284;1285;1;92;2.0
2;141;1285;1319;34;92;2.0
2;142;1319;1324;5;92;2.0
2;143;1324;1341;17;92;2.0
2;144;1341;1348;7;92;2.0
2;145;1348;1383;35;92;2.0
2;146;1383;1389;6;92;2.0
2;147;1389;1395;6;92;2.0
2;148;1395;1398;3;92;2.0
2;149;1398;1413;15;92;2.0
2;150;1413;1428;15;92;2.0
2;151;1428;1443;15;92;2.0
2;152;1443;1458;15;92;2.0
2;153;1458;1473;15;92;2.0
2;154;1473;1488;15;92;2.0
2;155;1488;1503;15;92;2.0
2;156;1503;1518;15;92;2.0
2;157;1518;1533;15;92;2.0
2;158;1533;1548;15;92;2.0
2;159;1548;1563;15;92;2.0
2;160;1563;1578;15;92;2.0
2;161;1578;1593;15;92;2.0
2;162;1593;1608;15;92;2.0
2;163;1608;1623;15;92;2.0
2;164;1623;1638;15;92;2.0
2;165;1638;1653;15;92;2.0
2;166;1653;1668;15;92;2.0
2;167;1668;1680;12;92;2.0
3;0;248;335;87;77;2.0
3;1;335;336;1;77;2.0
3;2;336;338;2;77;2.0
3;3;338;343;5;77;2.0
3;4;343;350;7;77;2.0
3;5;350;351;1;77;2.0
3;6;351;356;5;77;2.0
3;7;356;358;2;77;2.0
3;8;358;363;5;77;2.0
3;9;363;365;2;77;2.0
3;10;365;368;3;77;2.0
3;11;368;378;10;77;2.0
3;12;378;385;7;77;2.0
3;13;385;388;3;77;2.0
3;14;388;391;3;77;2.0
3;15;391;398;7;77;2.0
3;16;398;400;2;77;2.0
3;17;400;406;6;77;2.0
3;18;406;413;7;77;2.0
3;19;413;418;5;77;2.0
3;20;418;420;2;77;2.0
3;21;420;421;1;77;2.0
3;22;421;423;2;77;2.0
3;23;423;428;5;77;2.0
3;24;428;433;5;77;2.0
3;25;433;435;2;77;2.0
3;26;435;448;13;77;2.0
3;27;448;451;3;77;2.0
3;28;451;455;4;77;2.0
3;29;455;456;1;77;2.0
3;30;456;458;2;77;2.0
3;31;458;460;2;77;2.0
3;32;460;466;6;77;2.0
3;33;466;468;2;77;2.0
3;34;468;476;8;77;2.0
3;35;476;481;5;77;2.0
3;36;481;483;2;77;2.0
3;37;483;503;20;77;2.0
3;38;503;505;2;77;2.0
3;39;505;507;2;77;2.0
3;40;507;516;9;77;2.0
3;41;516;518;2;77;2.0
3;42;518;533;15;77;2.0
3;43;533;535;2;77;2.0
3;44;535;546;11;77;2.0
3;45;546;548;2;77;2.0
3;46;548;552;4;77;2.0
3;47;552;588;36;77;2.0
3;48;588;590;2;77;2.0
3;49;590;596;6;77;2.0
3;50;596;600;4;77;2.0
3;51;600;625;25;77;2.0
3;52;625;628;3;77;2.0
3;53;628;633;5;77;2.0
3;54;633;638;5;77;2.0
3;55;638;660;22;77;2.0
3;56;660;685;25;77;2.0
3;57;685;708;23;77;2.0
3;58;708;720;12;77;2.0
3;59;720;721;1;77;2.0
3;60;721;725;4;77;2.0
3;61;725;745;20;77;2.0
3;62;745;750;5;77;2.0
3;63;750;753;3;77;2.0
3;64;753;761;8;77;2.0
3;65;761;768;7;77;2.0
3;66;768;781;13;77;2.0
3;67;781;795;14;77;2.0
3;68;795;803;8;77;2.0
3;69;803;825;22;77;2.0
3;70;825;828;3;77;2.0
3;71;828;831;3;77;2.0
3;72;831;836;5;77;2.0
3;73;836;837;1;77;2.0
3;74;837;850;13;77;2.0
3;75;850;853;3;77;2.0
3;76;853;865;12;77;2.0
3;77;865;873;8;77;2.0
3;78;873;875;2;77;2.0
3;79;875;878;3;77;2.0
3;80;878;880;2;77;2.0
3;81;880;886;6;77;2.0
3;82;886;888;2;77;2.0
3;83;888;890;2;77;2.0
3;84;890;891;1;77;2.0
3;85;891;903;12;77;2.0
3;86;903;906;3;77;2.0
3;87;906;908;2;77;2.0
3;88;908;910;2;77;2.0
3;89;910;911;1;77;2.0
3;90;911;923;12;77;2.0
3;91;923;930;7;77;2.0
3;92;930;933;3;77;2.0
3;93;933;935;2;77;2.0
3;94;935;941;6;77;2.0
3;95;941;945;4;77;2.0
3;96;945;948;3;77;2.0
3;97;948;950;2;77;2.0
3;98;950;961;11;77;2.0
3;99;961;963;2;77;2.0
3;100;963;970;7;77;2.0
3;101;970;971;1;77;2.0
3;102;971;981;10;77;2.0
3;103;981;983;2;77;2.0
3;104;983;984;1;77;2.0
3;105;984;996;12;77;2.0
3;106;996;1001;5;77;2.0
3;107;1001;1003;2;77;2.0
3;108;1003;1010;7;77;2.0
3;109;1010;1023;13;77;2.0
3;110;1023;1025;2;77;2.0
3;111;1025;1030;5;77;2.0
3;112;1030;1031;1;77;2.0
3;113;1031;1033;2;77;2.0
3;114;1033;1046;13;77;2.0
3;115;1046;1053;7;77;2.0
3;116;1053;1061;8;77;2.0
3;117;1061;1065;4;77;2.0
3;118;1065;1070;5;77;2.0
3;119;1070;1073;3;77;2.0
3;120;1073;1080;7;77;2.0
3;121;1080;1086;6;77;2.0
3;122;1086;1093;7;77;2.0
3;123;1093;1095;2;77;2.0
3;124;1095;1097;2;77;2.0
3;125;1097;1101;4;77;2.0
3;126;1101;1104;3;77;2.0
3;127;1104;1121;17;77;2.0
3;128;1121;1152;31;77;2.0
3;129;1152;1154;2;77;2.0
3;130;1154;1174;20;77;2.0
3;131;1174;1180;6;77;2.0
3;132;1180;1212;32;77;2.0
3;133;1212;1224;12;77;2.0
3;134;1224;1225;1;77;2.0
3;135;1225;1227;2;77;2.0
3;136;1227;1272;45;77;2.0
3;137;1272;1274;2;77;2.0
3;138;1274;1284;10;77;2.0
3;139;1284;1285;1;77;2.0
3;140;1285;1321;36;77;2.0
3;141;1321;1322;1;77;2.0
3;142;1322;1341;19;77;2.0
3;143;1341;1348;7;77;2.0
3;144;1348;1386;38;77;2.0
3;145;1386;1389;3;77;2.0
3;146;1389;1394;5;77;2.0
3;147;1394;1398;4;77;2.0
3;148;1398;1413;15;77;2.0
3;149;1413;1428;15;77;2.0
3;150;1428;1443;15;77;2.0
3;151;1443;1458;15;77;2.0
3;152;1458;1473;15;77;2.0
3;153;1473;1488;15;77;2.0
3;154;1488;1503;15;77;2.0
3;155;1503;1518;15;77;2.0
3;156;1518;1533;15;77;2.0
3;157;1533;1548;15;77;2.0
3;158;1548;1563;15;77;2.0
3;159;1563;1578;15;77;2.0
3;160;1578;1593;15;77;2.0
3;161;1593;1608;15;77;2.0
3;162;1608;1623;15;77;2.0
3;163;1623;1638;15;77;2.0
3;164;1638;1653;15;77;2.0
3;165;1653;1668;15;77;2.0
3;166;1668;1680;12;77;2.0
4;0;245;333;88;119;2.0
4;1;333;336;3;119;2.0
4;2;336;337;1;119;2.0
4;3;337;340;3;119;2.0
4;4;340;348;8;119;2.0
4;5;348;352;4;119;2.0
4;6;352;357;5;119;2.0
4;7;357;360;3;119;2.0
4;8;360;363;3;119;2.0
4;9;363;367;4;119;2.0
4;10;367;375;8;119;2.0
4;11;375;377;2;119;2.0
4;12;377;383;6;119;2.0
4;13;383;386;3;119;2.0
4;14;386;387;1;119;2.0
4;15;387;392;5;119;2.0
4;16;392;395;3;119;2.0
4;17;395;398;3;119;2.0
4;18;398;407;9;119;2.0
4;19;407;410;3;119;2.0
4;20;410;417;7;119;2.0
4;21;417;418;1;119;2.0
4;22;418;419;1;119;2.0
4;23;419;424;5;119;2.0
4;24;424;427;3;119;2.0
4;25;427;430;3;119;2.0
4;26;430;434;4;119;2.0
4;27;434;445;11;119;2.0
4;28;445;447;2;119;2.0
4;29;447;452;5;119;2.0
4;30;452;453;1;119;2.0
4;31;453;454;1;119;2.0
4;32;454;455;1;119;2.0
4;33;455;458;3;119;2.0
4;34;458;459;1;119;2.0
4;35;459;464;5;119;2.0
4;36;464;465;1;119;2.0
4;37;465;467;2;119;2.0
4;38;467;474;7;119;2.0
4;39;474;482;8;119;2.0
4;40;482;500;18;119;2.0
4;41;500;503;3;119;2.0
4;42;503;504;1;119;2.0
4;43;504;505;1;119;2.0
4;44;505;514;9;119;2.0
4;45;514;516;2;119;2.0
4;46;516;530;14;119;2.0
4;47;530;533;3;119;2.0
4;48;533;544;11;119;2.0
4;49;544;547;3;119;2.0
4;50;547;550;3;119;2.0
4;51;550;585;35;119;2.0
4;52;585;591;6;119;2.0
4;53;591;594;3;119;2.0
4;54;594;599;5;119;2.0
4;55;599;623;24;119;2.0
4;56;623;627;4;119;2.0
4;57;627;631;4;119;2.0
4;58;631;635;4;119;2.0
4;59;635;658;23;119;2.0
4;60;658;661;3;119;2.0
4;61;661;683;22;119;2.0
4;62;683;705;22;119;2.0
4;63;705;719;14;119;2.0
4;64;719;726;7;119;2.0
4;65;726;743;17;119;2.0
4;66;743;748;5;119;2.0
4;67;748;751;3;119;2.0
4;68;751;760;9;119;2.0
4;69;760;765;5;119;2.0
4;70;765;779;14;119;2.0
4;71;779;796;17;119;2.0
4;72;796;800;4;119;2.0
4;73;800;823;23;119;2.0
4;74;823;824;1;119;2.0
4;75;824;825;1;119;2.0
4;76;825;830;5;119;2.0
4;77;830;834;4;119;2.0
4;78;834;838;4;119;2.0
4;79;838;850;12;119;2.0
4;80;850;851;1;119;2.0
4;81;851;866;15;119;2.0
4;82;866;870;4;119;2.0
4;83;870;873;3;119;2.0
4;84;873;877;4;119;2.0
4;85;877;881;4;119;2.0
4;86;881;885;4;119;2.0
4;87;885;889;4;119;2.0
4;88;889;901;12;119;2.0
4;89;901;904;3;119;2.0
4;90;904;905;1;119;2.0
4;91;905;910;5;119;2.0
4;92;910;911;1;119;2.0
4;93;911;920;9;119;2.0
4;94;920;928;8;119;2.0
4;95;928;931;3;119;2.0
4;96;931;933;2;119;2.0
4;97;933;939;6;119;2.0
4;98;939;940;1;119;2.0
4;99;940;945;5;119;2.0
4;100;945;946;1;119;2.0
4;101;946;949;3;119;2.0
4;102;949;959;10;119;2.0
4;103;959;960;1;119;2.0
4;104;960;961;1;119;2.0
4;105;961;970;9;119;2.0
4;106;970;971;1;119;2.0
4;107;971;979;8;119;2.0
4;108;979;980;1;119;2.0
4;109;980;982;2;119;2.0
4;110;982;994;12;119;2.0
4;111;994;1000;6;119;2.0
4;112;1000;1009;9;119;2.0
4;113;1009;1021;12;119;2.0
4;114;1021;1023;2;119;2.0
4;115;1023;1030;7;119;2.0
4;116;1030;1031;1;119;2.0
4;117;1031;1044;13;119;2.0
4;118;1044;1050;6;119;2.0
4;119;1050;1060;10;119;2.0
4;120;1060;1066;6;119;2.0
4;121;1066;1069;3;119;2.0
4;122;1069;1070;1;119;2.0
4;123;1070;1078;8;119;2.0
4;124;1078;1084;6;119;2.0
4;125;1084;1090;6;119;2.0
4;126;1090;1093;3;119;2.0
4;127;1093;1095;2;119;2.0
4;128;1095;1099;4;119;2.0
4;129;1099;1102;3;119;2.0
4;130;1102;1120;18;119;2.0
4;131;1120;1149;29;119;2.0
4;132;1149;1153;4;119;2.0
4;133;1153;1172;19;119;2.0
4;134;1172;1178;6;119;2.0
4;135;1178;1209;31;119;2.0
4;136;1209;1222;13;119;2.0
4;137;1222;1223;1;119;2.0
4;138;1223;1225;2;119;2.0
4;139;1225;1269;44;119;2.0
4;140;1269;1273;4;119;2.0
4;141;1273;1282;9;119;2.0
4;142;1282;1283;1;119;2.0
4;143;1283;1319;36;119;2.0
4;144;1319;1322;3;119;2.0
4;145;1322;1339;17;119;2.0
4;146;1339;1346;7;119;2.0
4;147;1346;1383;37;119;2.0
4;148;1383;1387;4;119;2.0
4;149;1387;1393;6;119;2.0
4;150;1393;1396;3;119;2.0
4;151;1396;1411;15;119;2.0
4;152;1411;1426;15;119;2.0
4;153;1426;1441;15;119;2.0
4;154;1441;1456;15;119;2.0
4;155;1456;1471;15;119;2.0
4;156;1471;1486;15;119;2.0
4;157;1486;1501;15;119;2.0
4;158;1501;1516;15;119;2.0
4;159;1516;1531;15;119;2.0
4;160;1531;1546;15;119;2.0
4;161;1546;1561;15;119;2.0
4;162;1561;1576;15;119;2.0
4;163;1576;1591;15;119;2.0
4;164;1591;1606;15;119;2.0
4;165;1606;1621;15;119;2.0
4;166;1621;1636;15;119;2.0
4;167;1636;1651;15;119;2.0
4;168;1651;1666;15;119;2.0
4;169;1666;1680;14;119;2.0
5;0;243;334;91;96;2.0
5;1;334;335;1;96;2.0
5;2;335;338;3;96;2.0
5;3;338;339;1;96;2.0
5;4;339;350;11;96;2.0
5;5;350;354;4;96;2.0
5;6;354;357;3;96;2.0
5;7;357;358;1;96;2.0
5;8;358;359;1;96;2.0
5;9;359;365;6;96;2.0
5;10;365;367;2;96;2.0
5;11;367;373;6;96;2.0
5;12;373;379;6;96;2.0
5;13;379;385;6;96;2.0
5;14;385;387;2;96;2.0
5;15;387;393;6;96;2.0
5;16;393;394;1;96;2.0
5;17;394;400;6;96;2.0
5;18;400;408;8;96;2.0
5;19;408;409;1;96;2.0
5;20;409;417;8;96;2.0
5;21;417;420;3;96;2.0
5;22;420;421;1;96;2.0
5;23;421;426;5;96;2.0
5;24;426;427;1;96;2.0
5;25;427;428;1;96;2.0
5;26;428;436;8;96;2.0
5;27;436;443;7;96;2.0
5;28;443;447;4;96;2.0
5;29;447;453;6;96;2.0
5;30;453;454;1;96;2.0
5;31;454;455;1;96;2.0
5;32;455;456;1;96;2.0
5;33;456;459;3;96;2.0
5;34;459;463;4;96;2.0
5;35;463;466;3;96;2.0
5;36;466;469;3;96;2.0
5;37;469;476;7;96;2.0
5;38;476;482;6;96;2.0
5;39;482;484;2;96;2.0
5;40;484;498;14;96;2.0
5;41;498;504;6;96;2.0
5;42;504;506;2;96;2.0
5;43;506;507;1;96;2.0
5;44;507;516;9;96;2.0
5;45;516;517;1;96;2.0
5;46;517;528;11;96;2.0
5;47;528;535;7;96;2.0
5;48;535;546;11;96;2.0
5;49;546;547;1;96;2.0
5;50;547;552;5;96;2.0
5;51;552;583;31;96;2.0
5;52;583;593;10;96;2.0
5;53;593;596;3;96;2.0
5;54;596;601;5;96;2.0
5;55;601;621;20;96;2.0
5;56;621;627;6;96;2.0
5;57;627;632;5;96;2.0
5;58;632;633;1;96;2.0
5;59;633;660;27;96;2.0
5;60;660;663;3;96;2.0
5;61;663;684;21;96;2.0
5;62;684;703;19;96;2.0
5;63;703;721;18;96;2.0
5;64;721;728;7;96;2.0
5;65;728;741;13;96;2.0
5;66;741;750;9;96;2.0
5;67;750;752;2;96;2.0
5;68;752;760;8;96;2.0
5;69;760;763;3;96;2.0
5;70;763;781;18;96;2.0
5;71;781;798;17;96;2.0
5;72;798;823;25;96;2.0
5;73;823;825;2;96;2.0
5;74;825;826;1;96;2.0
5;75;826;830;4;96;2.0
5;76;830;835;5;96;2.0
5;77;835;836;1;96;2.0
5;78;836;840;4;96;2.0
5;79;840;848;8;96;2.0
5;80;848;853;5;96;2.0
5;81;853;868;15;96;2.0
5;82;868;875;7;96;2.0
5;83;875;877;2;96;2.0
5;84;877;883;6;96;2.0
5;85;883;885;2;96;2.0
5;86;885;891;6;96;2.0
5;87;891;902;11;96;2.0
5;88;902;903;1;96;2.0
5;89;903;906;3;96;2.0
5;90;906;910;4;96;2.0
5;91;910;913;3;96;2.0
5;92;913;918;5;96;2.0
5;93;918;926;8;96;2.0
5;94;926;932;6;96;2.0
5;95;932;935;3;96;2.0
5;96;935;940;5;96;2.0
5;97;940;941;1;96;2.0
5;98;941;943;2;96;2.0
5;99;943;948;5;96;2.0
5;100;948;951;3;96;2.0
5;101;951;958;7;96;2.0
5;102;958;961;3;96;2.0
5;103;961;962;1;96;2.0
5;104;962;970;8;96;2.0
5;105;970;973;3;96;2.0
5;106;973;978;5;96;2.0
5;107;978;981;3;96;2.0
5;108;981;983;2;96;2.0
5;109;983;996;13;96;2.0
5;110;996;998;2;96;2.0
5;111;998;1000;2;96;2.0
5;112;1000;1011;11;96;2.0
5;113;1011;1022;11;96;2.0
5;114;1022;1025;3;96;2.0
5;115;1025;1028;3;96;2.0
5;116;1028;1030;2;96;2.0
5;117;1030;1033;3;96;2.0
5;118;1033;1046;13;96;2.0
5;119;1046;1048;2;96;2.0
5;120;1048;1060;12;96;2.0
5;121;1060;1068;8;96;2.0
5;122;1068;1071;3;96;2.0
5;123;1071;1080;9;96;2.0
5;124;1080;1086;6;96;2.0
5;125;1086;1088;2;96;2.0
5;126;1088;1091;3;96;2.0
5;127;1091;1096;5;96;2.0
5;128;1096;1101;5;96;2.0
5;129;1101;1103;2;96;2.0
5;130;1103;1104;1;96;2.0
5;131;1104;1120;16;96;2.0
5;132;1120;1147;27;96;2.0
5;133;1147;1155;8;96;2.0
5;134;1155;1174;19;96;2.0
5;135;1174;1179;5;96;2.0
5;136;1179;1207;28;96;2.0
5;137;1207;1221;14;96;2.0
5;138;1221;1224;3;96;2.0
5;139;1224;1226;2;96;2.0
5;140;1226;1267;41;96;2.0
5;141;1267;1275;8;96;2.0
5;142;1275;1284;9;96;2.0
5;143;1284;1317;33;96;2.0
5;144;1317;1324;7;96;2.0
5;145;1324;1341;17;96;2.0
5;146;1341;1347;6;96;2.0
5;147;1347;1381;34;96;2.0
5;148;1381;1389;8;96;2.0
5;149;1389;1395;6;96;2.0
5;150;1395;1397;2;96;2.0
5;151;1397;1412;15;96;2.0
5;152;1412;1427;15;96;2.0
5;153;1427;1442;15;96;2.0
5;154;1442;1457;15;96;2.0
5;155;1457;1472;15;96;2.0
5;156;1472;1487;15;96;2.0
5;157;1487;1502;15;96;2.0
5;158;1502;1517;15;96;2.0
5;159;1517;1532;15;96;2.0
5;160;1532;1547;15;96;2.0
5;161;1547;1562;15;96;2.0
5;162;1562;1577;15;96;2.0
5;163;1577;1592;15;96;2.0
5;164;1592;1607;15;96;2.0
5;165;1607;1622;15;96;2.0
5;166;1622;1637;15;96;2.0
5;167;1637;1652;15;96;2.0
5;168;1652;1667;15;96;2.0
5;169;1667;1680;13;96;2.0
6;0;252;334;82;160;2.0
6;1;334;337;3;160;2.0
6;2;337;341;4;160;2.0
6;3;341;348;7;160;2.0
6;4;348;349;1;160;2.0
6;5;349;352;3;160;2.0
6;6;352;354;2;160;2.0
6;7;354;363;9;160;2.0
6;8;363;367;4;160;2.0
6;9;367;368;1;160;2.0
6;10;368;373;5;160;2.0
6;11;373;381;8;160;2.0
6;12;381;383;2;160;2.0
6;13;383;387;4;160;2.0
6;14;387;389;2;160;2.0
6;15;389;393;4;160;2.0
6;16;393;394;1;160;2.0
6;17;394;402;8;160;2.0
6;18;402;403;1;160;2.0
6;19;403;404;1;160;2.0
6;20;404;418;14;160;2.0
6;21;418;421;3;160;2.0
6;22;421;422;1;160;2.0
6;23;422;423;1;160;2.0
6;24;423;425;2;160;2.0
6;25;425;433;8;160;2.0
6;26;433;438;5;160;2.0
6;27;438;449;11;160;2.0
6;28;449;453;4;160;2.0
6;29;453;457;4;160;2.0
6;30;457;460;3;160;2.0
6;31;460;463;3;160;2.0
6;32;463;464;1;160;2.0
6;33;464;465;1;160;2.0
6;34;465;470;5;160;2.0
6;35;470;473;3;160;2.0
6;36;473;479;6;160;2.0
6;37;479;480;1;160;2.0
6;38;480;488;8;160;2.0
6;39;488;508;20;160;2.0
6;40;508;511;3;160;2.0
6;41;511;520;9;160;2.0
6;42;520;524;4;160;2.0
6;43;524;537;13;160;2.0
6;44;537;538;1;160;2.0
6;45;538;550;12;160;2.0
6;46;550;553;3;160;2.0
6;47;553;556;3;160;2.0
6;48;556;588;32;160;2.0
6;49;588;593;5;160;2.0
6;50;593;600;7;160;2.0
6;51;600;603;3;160;2.0
6;52;603;628;25;160;2.0
6;53;628;633;5;160;2.0
6;54;633;639;6;160;2.0
6;55;639;643;4;160;2.0
6;56;643;658;15;160;2.0
6;57;658;662;4;160;2.0
6;58;662;691;29;160;2.0
6;59;691;713;22;160;2.0
6;60;713;723;10;160;2.0
6;61;723;725;2;160;2.0
6;62;725;748;23;160;2.0
6;63;748;752;4;160;2.0
6;64;752;759;7;160;2.0
6;65;759;766;7;160;2.0
6;66;766;773;7;160;2.0
6;67;773;785;12;160;2.0
6;68;785;793;8;160;2.0
6;69;793;808;15;160;2.0
6;70;808;827;19;160;2.0
6;71;827;828;1;160;2.0
6;72;828;833;5;160;2.0
6;73;833;835;2;160;2.0
6;74;835;836;1;160;2.0
6;75;836;840;4;160;2.0
6;76;840;842;2;160;2.0
6;77;842;848;6;160;2.0
6;78;848;858;10;160;2.0
6;79;858;863;5;160;2.0
6;80;863;877;14;160;2.0
6;81;877;878;1;160;2.0
6;82;878;883;5;160;2.0
6;83;883;891;8;160;2.0
6;84;891;893;2;160;2.0
6;85;893;895;2;160;2.0
6;86;895;908;13;160;2.0
6;87;908;909;1;160;2.0
6;88;909;910;1;160;2.0
6;89;910;913;3;160;2.0
6;90;913;916;3;160;2.0
6;91;916;928;12;160;2.0
6;92;928;933;5;160;2.0
6;93;933;937;4;160;2.0
6;94;937;939;2;160;2.0
6;95;939;943;4;160;2.0
6;96;943;945;2;160;2.0
6;97;945;946;1;160;2.0
6;98;946;953;7;160;2.0
6;99;953;965;12;160;2.0
6;100;965;968;3;160;2.0
6;101;968;969;1;160;2.0
6;102;969;976;7;160;2.0
6;103;976;985;9;160;2.0
6;104;985;988;3;160;2.0
6;105;988;990;2;160;2.0
6;106;990;1000;10;160;2.0
6;107;1000;1006;6;160;2.0
6;108;1006;1008;2;160;2.0
6;109;1008;1013;5;160;2.0
6;110;1013;1027;14;160;2.0
6;111;1027;1028;1;160;2.0
6;112;1028;1029;1;160;2.0
6;113;1029;1036;7;160;2.0
6;114;1036;1038;2;160;2.0
6;115;1038;1050;12;160;2.0
6;116;1050;1058;8;160;2.0
6;117;1058;1063;5;160;2.0
6;118;1063;1066;3;160;2.0
6;119;1066;1073;7;160;2.0
6;120;1073;1078;5;160;2.0
6;121;1078;1082;4;160;2.0
6;122;1082;1090;8;160;2.0
6;123;1090;1098;8;160;2.0
6;124;1098;1103;5;160;2.0
6;125;1103;1105;2;160;2.0
6;126;1105;1108;3;160;2.0
6;127;1108;1110;2;160;2.0
6;128;1110;1126;16;160;2.0
6;129;1126;1157;31;160;2.0
6;130;1157;1178;21;160;2.0
6;131;1178;1186;8;160;2.0
6;132;1186;1217;31;160;2.0
6;133;1217;1228;11;160;2.0
6;134;1228;1233;5;160;2.0
6;135;1233;1277;44;160;2.0
6;136;1277;1288;11;160;2.0
6;137;1288;1291;3;160;2.0
6;138;1291;1319;28;160;2.0
6;139;1319;1327;8;160;2.0
6;140;1327;1343;16;160;2.0
6;141;1343;1354;11;160;2.0
6;142;1354;1391;37;160;2.0
6;143;1391;1393;2;160;2.0
6;144;1393;1397;4;160;2.0
6;145;1397;1404;7;160;2.0
6;146;1404;1419;15;160;2.0
6;147;1419;1434;15;160;2.0
6;148;1434;1449;15;160;2.0
6;149;1449;1464;15;160;2.0
6;150;1464;1479;15;160;2.0
6;151;1479;1494;15;160;2.0
6;152;1494;1509;15;160;2.0
6;153;1509;1524;15;160;2.0
6;154;1524;1539;15;160;2.0
6;155;1539;1554;15;160;2.0
6;156;1554;1569;15;160;2.0
6;157;1569;1584;15;160;2.0
6;158;1584;1599;15;160;2.0
6;159;1599;1614;15;160;2.0
6;160;1614;1629;15;160;2.0
6;161;1629;1644;15;160;2.0
6;162;1644;1659;15;160;2.0
6;163;1659;1680;21;160;2.0
7;0;250;333;83;1;2.0
7;1;333;339;6;1;2.0
7;2;339;346;7;1;2.0
7;3;346;348;2;1;2.0
7;4;348;353;5;1;2.0
7;5;353;363;10;1;2.0
7;6;363;364;1;1;2.0
7;7;364;366;2;1;2.0
7;8;366;374;8;1;2.0
7;9;374;378;4;1;2.0
7;10;378;381;3;1;2.0
7;11;381;383;2;1;2.0
7;12;383;388;5;1;2.0
7;13;388;392;4;1;2.0
7;14;392;394;2;1;2.0
7;15;394;398;4;1;2.0
7;16;398;401;3;1;2.0
7;17;401;403;2;1;2.0
7;18;403;416;13;1;2.0
7;19;416;418;2;1;2.0
7;20;418;420;2;1;2.0
7;21;420;423;3;1;2.0
7;22;423;424;1;1;2.0
7;23;424;434;10;1;2.0
7;24;434;435;1;1;2.0
7;25;435;436;1;1;2.0
7;26;436;448;12;1;2.0
7;27;448;451;3;1;2.0
7;28;451;453;2;1;2.0
7;29;453;454;1;1;2.0
7;30;454;458;4;1;2.0
7;31;458;461;3;1;2.0
7;32;461;463;2;1;2.0
7;33;463;466;3;1;2.0
7;34;466;468;2;1;2.0
7;35;468;471;3;1;2.0
7;36;471;478;7;1;2.0
7;37;478;489;11;1;2.0
7;38;489;505;16;1;2.0
7;39;505;506;1;1;2.0
7;40;506;509;3;1;2.0
7;41;509;518;9;1;2.0
7;42;518;522;4;1;2.0
7;43;522;533;11;1;2.0
7;44;533;536;3;1;2.0
7;45;536;548;12;1;2.0
7;46;548;554;6;1;2.0
7;47;554;587;33;1;2.0
7;48;587;591;4;1;2.0
7;49;591;598;7;1;2.0
7;50;598;600;2;1;2.0
7;51;600;626;26;1;2.0
7;52;626;634;8;1;2.0
7;53;634;637;3;1;2.0
7;54;637;641;4;1;2.0
7;55;641;657;16;1;2.0
7;56;657;658;1;1;2.0
7;57;658;689;31;1;2.0
7;58;689;711;22;1;2.0
7;59;711;720;9;1;2.0
7;60;720;722;2;1;2.0
7;61;722;723;1;1;2.0
7;62;723;746;23;1;2.0
7;63;746;748;2;1;2.0
7;64;748;757;9;1;2.0
7;65;757;767;10;1;2.0
7;66;767;771;4;1;2.0
7;67;771;783;12;1;2.0
7;68;783;792;9;1;2.0
7;69;792;806;14;1;2.0
7;70;806;823;17;1;2.0
7;71;823;825;2;1;2.0
7;72;825;831;6;1;2.0
7;73;831;834;3;1;2.0
7;74;834;837;3;1;2.0
7;75;837;838;1;1;2.0
7;76;838;840;2;1;2.0
7;77;840;847;7;1;2.0
7;78;847;856;9;1;2.0
7;79;856;862;6;1;2.0
7;80;862;873;11;1;2.0
7;81;873;876;3;1;2.0
7;82;876;877;1;1;2.0
7;83;877;884;7;1;2.0
7;84;884;890;6;1;2.0
7;85;890;891;1;1;2.0
7;86;891;892;1;1;2.0
7;87;892;893;1;1;2.0
7;88;893;907;14;1;2.0
7;89;907;908;1;1;2.0
7;90;908;911;3;1;2.0
7;91;911;917;6;1;2.0
7;92;917;926;9;1;2.0
7;93;926;931;5;1;2.0
7;94;931;933;2;1;2.0
7;95;933;937;4;1;2.0
7;96;937;942;5;1;2.0
7;97;942;943;1;1;2.0
7;98;943;947;4;1;2.0
7;99;947;950;3;1;2.0
7;100;950;951;1;1;2.0
7;101;951;963;12;1;2.0
7;102;963;966;3;1;2.0
7;103;966;967;1;1;2.0
7;104;967;977;10;1;2.0
7;105;977;983;6;1;2.0
7;106;983;986;3;1;2.0
7;107;986;988;2;1;2.0
7;108;988;998;10;1;2.0
7;109;998;1006;8;1;2.0
7;110;1006;1007;1;1;2.0
7;111;1007;1010;3;1;2.0
7;112;1010;1023;13;1;2.0
7;113;1023;1027;4;1;2.0
7;114;1027;1036;9;1;2.0
7;115;1036;1037;1;1;2.0
7;116;1037;1048;11;1;2.0
7;117;1048;1056;8;1;2.0
7;118;1056;1062;6;1;2.0
7;119;1062;1067;5;1;2.0
7;120;1067;1070;3;1;2.0
7;121;1070;1076;6;1;2.0
7;122;1076;1078;2;1;2.0
7;123;1078;1088;10;1;2.0
7;124;1088;1096;8;1;2.0
7;125;1096;1101;5;1;2.0
7;126;1101;1103;2;1;2.0
7;127;1103;1106;3;1;2.0
7;128;1106;1108;2;1;2.0
7;129;1108;1127;19;1;2.0
7;130;1127;1154;27;1;2.0
7;131;1154;1155;1;1;2.0
7;132;1155;1176;21;1;2.0
7;133;1176;1184;8;1;2.0
7;134;1184;1215;31;1;2.0
7;135;1215;1226;11;1;2.0
7;136;1226;1231;5;1;2.0
7;137;1231;1274;43;1;2.0
7;138;1274;1275;1;1;2.0
7;139;1275;1286;11;1;2.0
7;140;1286;1289;3;1;2.0
7;141;1289;1318;29;1;2.0
7;142;1318;1325;7;1;2.0
7;143;1325;1339;14;1;2.0
7;144;1339;1352;13;1;2.0
7;145;1352;1389;37;1;2.0
7;146;1389;1391;2;1;2.0
7;147;1391;1394;3;1;2.0
7;148;1394;1402;8;1;2.0
7;149;1402;1417;15;1;2.0
7;150;1417;1432;15;1;2.0
7;151;1432;1447;15;1;2.0
7;152;1447;1462;15;1;2.0
7;153;1462;1477;15;1;2.0
7;154;1477;1492;15;1;2.0
7;155;1492;1507;15;1;2.0
7;156;1507;1522;15;1;2.0
7;157;1522;1537;15;1;2.0
7;158;1537;1552;15;1;2.0
7;159;1552;1567;15;1;2.0
7;160;1567;1582;15;1;2.0
7;161;1582;1597;15;1;2.0
7;162;1597;1612;15;1;2.0
7;163;1612;1627;15;1;2.0
7;164;1627;1642;15;1;2.0
7;165;1642;1657;15;1;2.0
7;166;1657;1680;23;1;2.0
8;0;250;332;82;43;2.0
8;1;332;337;5;43;2.0
8;2;337;339;2;43;2.0
8;3;339;344;5;43;2.0
8;4;344;352;8;43;2.0
8;5;352;359;7;43;2.0
8;6;359;364;5;43;2.0
8;7;364;367;3;43;2.0
8;8;367;372;5;43;2.0
8;9;372;374;2;43;2.0
8;10;374;377;3;43;2.0
8;11;377;387;10;43;2.0
8;12;387;389;2;43;2.0
8;13;389;394;5;43;2.0
8;14;394;397;3;43;2.0
8;15;397;399;2;43;2.0
8;16;399;402;3;43;2.0
8;17;402;409;7;43;2.0
8;18;409;414;5;43;2.0
8;19;414;422;8;43;2.0
8;20;422;427;5;43;2.0
8;21;427;429;2;43;2.0
8;22;429;431;2;43;2.0
8;23;431;437;6;43;2.0
8;24;437;444;7;43;2.0
8;25;444;454;10;43;2.0
8;26;454;457;3;43;2.0
8;27;457;459;2;43;2.0
8;28;459;464;5;43;2.0
8;29;464;467;3;43;2.0
8;30;467;469;2;43;2.0
8;31;469;474;5;43;2.0
8;32;474;477;3;43;2.0
8;33;477;489;12;43;2.0
8;34;489;492;3;43;2.0
8;35;492;499;7;43;2.0
8;36;499;506;7;43;2.0
8;37;506;508;2;43;2.0
8;38;508;517;9;43;2.0
8;39;517;519;2;43;2.0
8;40;519;529;10;43;2.0
8;41;529;537;8;43;2.0
8;42;537;547;10;43;2.0
8;43;547;553;6;43;2.0
8;44;553;557;4;43;2.0
8;45;557;584;27;43;2.0
8;46;584;594;10;43;2.0
8;47;594;597;3;43;2.0
8;48;597;598;1;43;2.0
8;49;598;619;21;43;2.0
8;50;619;634;15;43;2.0
8;51;634;637;3;43;2.0
8;52;637;662;25;43;2.0
8;53;662;668;6;43;2.0
8;54;668;686;18;43;2.0
8;55;686;704;18;43;2.0
8;56;704;714;10;43;2.0
8;57;714;722;8;43;2.0
8;58;722;733;11;43;2.0
8;59;733;739;6;43;2.0
8;60;739;752;13;43;2.0
8;61;752;754;2;43;2.0
8;62;754;764;10;43;2.0
8;63;764;770;6;43;2.0
8;64;770;782;12;43;2.0
8;65;782;799;17;43;2.0
8;66;799;803;4;43;2.0
8;67;803;819;16;43;2.0
8;68;819;824;5;43;2.0
8;69;824;827;3;43;2.0
8;70;827;837;10;43;2.0
8;71;837;840;3;43;2.0
8;72;840;845;5;43;2.0
8;73;845;849;4;43;2.0
8;74;849;858;9;43;2.0
8;75;858;869;11;43;2.0
8;76;869;873;4;43;2.0
8;77;873;877;4;43;2.0
8;78;877;884;7;43;2.0
8;79;884;887;3;43;2.0
8;80;887;888;1;43;2.0
8;81;888;892;4;43;2.0
8;82;892;895;3;43;2.0
8;83;895;904;9;43;2.0
8;84;904;907;3;43;2.0
8;85;907;918;11;43;2.0
8;86;918;919;1;43;2.0
8;87;919;920;1;43;2.0
8;88;920;924;4;43;2.0
8;89;924;934;10;43;2.0
8;90;934;937;3;43;2.0
8;91;937;942;5;43;2.0
8;92;942;944;2;43;2.0
8;93;944;950;6;43;2.0
8;94;950;953;3;43;2.0
8;95;953;959;6;43;2.0
8;96;959;962;3;43;2.0
8;97;962;964;2;43;2.0
8;98;964;978;14;43;2.0
8;99;978;979;1;43;2.0
8;100;979;980;1;43;2.0
8;101;980;982;2;43;2.0
8;102;982;985;3;43;2.0
8;103;985;997;12;43;2.0
8;104;997;999;2;43;2.0
8;105;999;1004;5;43;2.0
8;106;1004;1010;6;43;2.0
8;107;1010;1024;14;43;2.0
8;108;1024;1027;3;43;2.0
8;109;1027;1029;2;43;2.0
8;110;1029;1038;9;43;2.0
8;111;1038;1040;2;43;2.0
8;112;1040;1047;7;43;2.0
8;113;1047;1049;2;43;2.0
8;114;1049;1064;15;43;2.0
8;115;1064;1069;5;43;2.0
8;116;1069;1070;1;43;2.0
8;117;1070;1073;3;43;2.0
8;118;1073;1082;9;43;2.0
8;119;1082;1087;5;43;2.0
8;120;1087;1089;2;43;2.0
8;121;1089;1098;9;43;2.0
8;122;1098;1102;4;43;2.0
8;123;1102;1105;3;43;2.0
8;124;1105;1130;25;43;2.0
8;125;1130;1148;18;43;2.0
8;126;1148;1175;27;43;2.0
8;127;1175;1181;6;43;2.0
8;128;1181;1208;27;43;2.0
8;129;1208;1219;11;43;2.0
8;130;1219;1225;6;43;2.0
8;131;1225;1228;3;43;2.0
8;132;1228;1268;40;43;2.0
8;133;1268;1285;17;43;2.0
8;134;1285;1286;1;43;2.0
8;135;1286;1318;32;43;2.0
8;136;1318;1329;11;43;2.0
8;137;1329;1343;14;43;2.0
8;138;1343;1349;6;43;2.0
8;139;1349;1382;33;43;2.0
8;140;1382;1388;6;43;2.0
8;141;1388;1390;2;43;2.0
8;142;1390;1399;9;43;2.0
8;143;1399;1414;15;43;2.0
8;144;1414;1429;15;43;2.0
8;145;1429;1444;15;43;2.0
8;146;1444;1459;15;43;2.0
8;147;1459;1474;15;43;2.0
8;148;1474;1489;15;43;2.0
8;149;1489;1504;15;43;2.0
8;150;1504;1519;15;43;2.0
8;151;1519;1534;15;43;2.0
8;152;1534;1549;15;43;2.0
8;153;1549;1564;15;43;2.0
8;154;1564;1579;15;43;2.0
8;155;1579;1594;15;43;2.0
8;156;1594;1609;15;43;2.0
8;157;1609;1624;15;43;2.0
8;158;1624;1639;15;43;2.0
8;159;1639;1654;15;43;2.0
8;160;1654;1669;15;43;2.0
8;161;1669;1680;11;43;2.0
9;0;250;331;81;4;2.0
9;1;331;333;2;4;2.0
9;2;333;337;4;4;2.0
9;3;337;344;7;4;2.0
9;4;344;346;2;4;2.0
9;5;346;348;2;4;2.0
9;6;348;353;5;4;2.0
9;7;353;361;8;4;2.0
9;8;361;364;3;4;2.0
9;9;364;374;10;4;2.0
9;10;374;376;2;4;2.0
9;11;376;379;3;4;2.0
9;12;379;381;2;4;2.0
9;13;381;388;7;4;2.0
9;14;388;390;2;4;2.0
9;15;390;394;4;4;2.0
9;16;394;396;2;4;2.0
9;17;396;399;3;4;2.0
9;18;399;403;4;4;2.0
9;19;403;414;11;4;2.0
9;20;414;416;2;4;2.0
9;21;416;420;4;4;2.0
9;22;420;422;2;4;2.0
9;23;422;424;2;4;2.0
9;24;424;433;9;4;2.0
9;25;433;434;1;4;2.0
9;26;434;448;14;4;2.0
9;27;448;449;1;4;2.0
9;28;449;451;2;4;2.0
9;29;451;454;3;4;2.0
9;30;454;457;3;4;2.0
9;31;457;459;2;4;2.0
9;32;459;463;4;4;2.0
9;33;463;466;3;4;2.0
9;34;466;467;1;4;2.0
9;35;467;469;2;4;2.0
9;36;469;477;8;4;2.0
9;37;477;478;1;4;2.0
9;38;478;489;11;4;2.0
9;39;489;503;14;4;2.0
9;40;503;504;1;4;2.0
9;41;504;507;3;4;2.0
9;42;507;508;1;4;2.0
9;43;508;517;9;4;2.0
9;44;517;520;3;4;2.0
9;45;520;531;11;4;2.0
9;46;531;534;3;4;2.0
9;47;534;547;13;4;2.0
9;48;547;553;6;4;2.0
9;49;553;554;1;4;2.0
9;50;554;587;33;4;2.0
9;51;587;589;2;4;2.0
9;52;589;597;8;4;2.0
9;53;597;598;1;4;2.0
9;54;598;624;26;4;2.0
9;55;624;634;10;4;2.0
9;56;634;635;1;4;2.0
9;57;635;639;4;4;2.0
9;58;639;656;17;4;2.0
9;59;656;657;1;4;2.0
9;60;657;687;30;4;2.0
9;61;687;709;22;4;2.0
9;62;709;718;9;4;2.0
9;63;718;722;4;4;2.0
9;64;722;744;22;4;2.0
9;65;744;746;2;4;2.0
9;66;746;755;9;4;2.0
9;67;755;767;12;4;2.0
9;68;767;769;2;4;2.0
9;69;769;782;13;4;2.0
9;70;782;792;10;4;2.0
9;71;792;804;12;4;2.0
9;72;804;821;17;4;2.0
9;73;821;823;2;4;2.0
9;74;823;829;6;4;2.0
9;75;829;834;5;4;2.0
9;76;834;837;3;4;2.0
9;77;837;838;1;4;2.0
9;78;838;847;9;4;2.0
9;79;847;854;7;4;2.0
9;80;854;862;8;4;2.0
9;81;862;871;9;4;2.0
9;82;871;874;3;4;2.0
9;83;874;877;3;4;2.0
9;84;877;884;7;4;2.0
9;85;884;888;4;4;2.0
9;86;888;889;1;4;2.0
9;87;889;892;3;4;2.0
9;88;892;905;13;4;2.0
9;89;905;907;2;4;2.0
9;90;907;909;2;4;2.0
9;91;909;917;8;4;2.0
9;92;917;924;7;4;2.0
9;93;924;929;5;4;2.0
9;94;929;931;2;4;2.0
9;95;931;935;4;4;2.0
9;96;935;942;7;4;2.0
9;97;942;947;5;4;2.0
9;98;947;948;1;4;2.0
9;99;948;949;1;4;2.0
9;100;949;962;13;4;2.0
9;101;962;964;2;4;2.0
9;102;964;965;1;4;2.0
9;103;965;967;2;4;2.0
9;104;967;977;10;4;2.0
9;105;977;982;5;4;2.0
9;106;982;984;2;4;2.0
9;107;984;986;2;4;2.0
9;108;986;997;11;4;2.0
9;109;997;1004;7;4;2.0
9;110;1004;1007;3;4;2.0
9;111;1007;1008;1;4;2.0
9;112;1008;1021;13;4;2.0
9;113;1021;1025;4;4;2.0
9;114;1025;1027;2;4;2.0
9;115;1027;1034;7;4;2.0
9;116;1034;1037;3;4;2.0
9;117;1037;1047;10;4;2.0
9;118;1047;1054;7;4;2.0
9;119;1054;1062;8;4;2.0
9;120;1062;1067;5;4;2.0
9;121;1067;1068;1;4;2.0
9;122;1068;1074;6;4;2.0
9;123;1074;1076;2;4;2.0
9;124;1076;1087;11;4;2.0
9;125;1087;1094;7;4;2.0
9;126;1094;1099;5;4;2.0
9;127;1099;1102;3;4;2.0
9;128;1102;1105;3;4;2.0
9;129;1105;1106;1;4;2.0
9;130;1106;1127;21;4;2.0
9;131;1127;1152;25;4;2.0
9;132;1152;1153;1;4;2.0
9;133;1153;1175;22;4;2.0
9;134;1175;1182;7;4;2.0
9;135;1182;1213;31;4;2.0
9;136;1213;1224;11;4;2.0
9;137;1224;1225;1;4;2.0
9;138;1225;1229;4;4;2.0
9;139;1229;1272;43;4;2.0
9;140;1272;1273;1;4;2.0
9;141;1273;1285;12;4;2.0
9;142;1285;1287;2;4;2.0
9;143;1287;1318;31;4;2.0
9;144;1318;1323;5;4;2.0
9;145;1323;1337;14;4;2.0
9;146;1337;1350;13;4;2.0
9;147;1350;1387;37;4;2.0
9;148;1387;1390;3;4;2.0
9;149;1390;1392;2;4;2.0
9;150;1392;1400;8;4;2.0
9;151;1400;1415;15;4;2.0
9;152;1415;1430;15;4;2.0
9;153;1430;1445;15;4;2.0
9;154;1445;1460;15;4;2.0
9;155;1460;1475;15;4;2.0
9;156;1475;1490;15;4;2.0
9;157;1490;1505;15;4;2.0
9;158;1505;1520;15;4;2.0
9;159;1520;1535;15;4;2.0
9;160;1535;1550;15;4;2.0
9;161;1550;1565;15;4;2.0
9;162;1565;1580;15;4;2.0
9;163;1580;1595;15;4;2.0
9;164;1595;1610;15;4;2.0
9;165;1610;1625;15;4;2.0
9;166;1625;1640;15;4;2.0
9;167;1640;1655;15;4;2.0
9;168;1655;1670;15;4;2.0
9;169;1670;1680;10;4;2.0
10;0;252;332;80;11;2.0
10;1;332;337;5;11;2.0
10;2;337;338;1;11;2.0
10;3;338;344;6;11;2.0
10;4;344;352;8;11;2.0
10;5;352;358;6;11;2.0
10;6;358;359;1;11;2.0
10;7;359;364;5;11;2.0
10;8;364;367;3;11;2.0
10;9;367;368;1;11;2.0
10;10;368;373;5;11;2.0
10;11;373;378;5;11;2.0
10;12;378;387;9;11;2.0
10;13;387;390;3;11;2.0
10;14;390;393;3;11;2.0
10;15;393;398;5;11;2.0
10;16;398;399;1;11;2.0
10;17;399;402;3;11;2.0
10;18;402;408;6;11;2.0
10;19;408;414;6;11;2.0
10;20;414;422;8;11;2.0
10;21;422;423;1;11;2.0
10;22;423;428;5;11;2.0
10;23;428;431;3;11;2.0
10;24;431;435;4;11;2.0
10;25;435;438;3;11;2.0
10;26;438;443;5;11;2.0
10;27;443;453;10;11;2.0
10;28;453;454;1;11;2.0
10;29;454;457;3;11;2.0
10;30;457;458;1;11;2.0
10;31;458;459;1;11;2.0
10;32;459;463;4;11;2.0
10;33;463;468;5;11;2.0
10;34;468;470;2;11;2.0
10;35;470;474;4;11;2.0
10;36;474;478;4;11;2.0
10;37;478;489;11;11;2.0
10;38;489;493;4;11;2.0
10;39;493;498;5;11;2.0
10;40;498;505;7;11;2.0
10;41;505;507;2;11;2.0
10;42;507;509;2;11;2.0
10;43;509;518;9;11;2.0
10;44;518;520;2;11;2.0
10;45;520;528;8;11;2.0
10;46;528;537;9;11;2.0
10;47;537;548;11;11;2.0
10;48;548;554;6;11;2.0
10;49;554;558;4;11;2.0
10;50;558;583;25;11;2.0
10;51;583;598;15;11;2.0
10;52;598;600;2;11;2.0
10;53;600;619;19;11;2.0
10;54;619;633;14;11;2.0
10;55;633;635;2;11;2.0
10;56;635;638;3;11;2.0
10;57;638;662;24;11;2.0
10;58;662;668;6;11;2.0
10;59;668;687;19;11;2.0
10;60;687;703;16;11;2.0
10;61;703;720;17;11;2.0
10;62;720;723;3;11;2.0
10;63;723;733;10;11;2.0
10;64;733;739;6;11;2.0
10;65;739;752;13;11;2.0
10;66;752;755;3;11;2.0
10;67;755;763;8;11;2.0
10;68;763;771;8;11;2.0
10;69;771;783;12;11;2.0
10;70;783;798;15;11;2.0
10;71;798;803;5;11;2.0
10;72;803;823;20;11;2.0
10;73;823;825;2;11;2.0
10;74;825;827;2;11;2.0
10;75;827;838;11;11;2.0
10;76;838;841;3;11;2.0
10;77;841;845;4;11;2.0
10;78;845;848;3;11;2.0
10;79;848;858;10;11;2.0
10;80;858;868;10;11;2.0
10;81;868;873;5;11;2.0
10;82;873;877;4;11;2.0
10;83;877;883;6;11;2.0
10;84;883;888;5;11;2.0
10;85;888;890;2;11;2.0
10;86;890;893;3;11;2.0
10;87;893;896;3;11;2.0
10;88;896;903;7;11;2.0
10;89;903;905;2;11;2.0
10;90;905;908;3;11;2.0
10;91;908;918;10;11;2.0
10;92;918;921;3;11;2.0
10;93;921;924;3;11;2.0
10;94;924;935;11;11;2.0
10;95;935;937;2;11;2.0
10;96;937;943;6;11;2.0
10;97;943;950;7;11;2.0
10;98;950;951;1;11;2.0
10;99;951;953;2;11;2.0
10;100;953;958;5;11;2.0
10;101;958;963;5;11;2.0
10;102;963;965;2;11;2.0
10;103;965;978;13;11;2.0
10;104;978;981;3;11;2.0
10;105;981;983;2;11;2.0
10;106;983;986;3;11;2.0
10;107;986;998;12;11;2.0
10;108;998;1010;12;11;2.0
10;109;1010;1011;1;11;2.0
10;110;1011;1025;14;11;2.0
10;111;1025;1027;2;11;2.0
10;112;1027;1028;1;11;2.0
10;113;1028;1038;10;11;2.0
10;114;1038;1041;3;11;2.0
10;115;1041;1048;7;11;2.0
10;116;1048;1068;20;11;2.0
10;117;1068;1070;2;11;2.0
10;118;1070;1071;1;11;2.0
10;119;1071;1073;2;11;2.0
10;120;1073;1082;9;11;2.0
10;121;1082;1088;6;11;2.0
10;122;1088;1089;1;11;2.0
10;123;1089;1099;10;11;2.0
10;124;1099;1103;4;11;2.0
10;125;1103;1106;3;11;2.0
10;126;1106;1131;25;11;2.0
10;127;1131;1147;16;11;2.0
10;128;1147;1154;7;11;2.0
10;129;1154;1176;22;11;2.0
10;130;1176;1182;6;11;2.0
10;131;1182;1207;25;11;2.0
10;132;1207;1219;12;11;2.0
10;133;1219;1226;7;11;2.0
10;134;1226;1229;3;11;2.0
10;135;1229;1267;38;11;2.0
10;136;1267;1274;7;11;2.0
10;137;1274;1286;12;11;2.0
10;138;1286;1287;1;11;2.0
10;139;1287;1317;30;11;2.0
10;140;1317;1329;12;11;2.0
10;141;1329;1343;14;11;2.0
10;142;1343;1350;7;11;2.0
10;143;1350;1381;31;11;2.0
10;144;1381;1391;10;11;2.0
10;145;1391;1394;3;11;2.0
10;146;1394;1400;6;11;2.0
10;147;1400;1415;15;11;2.0
10;148;1415;1430;15;11;2.0
10;149;1430;1445;15;11;2.0
10;150;1445;1460;15;11;2.0
10;151;1460;1475;15;11;2.0
10;152;1475;1490;15;11;2.0
10;153;1490;1505;15;11;2.0
10;154;1505;1520;15;11;2.0
10;155;1520;1535;15;11;2.0
10;156;1535;1550;15;11;2.0
10;157;1550;1565;15;11;2.0
10;158;1565;1580;15;11;2.0
10;159;1580;1595;15;11;2.0
10;160;1595;1610;15;11;2.0
10;161;1610;1625;15;11;2.0
10;162;1625;1640;15;11;2.0
10;163;1640;1655;15;11;2.0
10;164;1655;1680;25;11;2.0
11;0;250;341;91;87;2.0
11;1;341;343;2;87;2.0
11;2;343;344;1;87;2.0
11;3;344;346;2;87;2.0
11;4;346;358;12;87;2.0
11;5;358;359;1;87;2.0
11;6;359;361;2;87;2.0
11;7;361;364;3;87;2.0
11;8;364;366;2;87;2.0
11;9;366;371;5;87;2.0
11;10;371;373;2;87;2.0
11;11;373;381;8;87;2.0
11;12;381;386;5;87;2.0
11;13;386;391;5;87;2.0
11;14;391;393;2;87;2.0
11;15;393;394;1;87;2.0
11;16;394;399;5;87;2.0
11;17;399;401;2;87;2.0
11;18;401;408;7;87;2.0
11;19;408;414;6;87;2.0
11;20;414;416;2;87;2.0
11;21;416;421;5;87;2.0
11;22;421;428;7;87;2.0
11;23;428;429;1;87;2.0
11;24;429;431;2;87;2.0
11;25;431;436;5;87;2.0
11;26;436;443;7;87;2.0
11;27;443;451;8;87;2.0
11;28;451;459;8;87;2.0
11;29;459;461;2;87;2.0
11;30;461;463;2;87;2.0
11;31;463;464;1;87;2.0
11;32;464;471;7;87;2.0
11;33;471;474;3;87;2.0
11;34;474;484;10;87;2.0
11;35;484;486;2;87;2.0
11;36;486;489;3;87;2.0
11;37;489;506;17;87;2.0
11;38;506;511;5;87;2.0
11;39;511;513;2;87;2.0
11;40;513;515;2;87;2.0
11;41;515;524;9;87;2.0
11;42;524;536;12;87;2.0
11;43;536;543;7;87;2.0
11;44;543;551;8;87;2.0
11;45;551;554;3;87;2.0
11;46;554;560;6;87;2.0
11;47;560;591;31;87;2.0
11;48;591;598;7;87;2.0
11;49;598;604;6;87;2.0
11;50;604;608;4;87;2.0
11;51;608;628;20;87;2.0
11;52;628;631;3;87;2.0
11;53;631;639;8;87;2.0
11;54;639;641;2;87;2.0
11;55;641;668;27;87;2.0
11;56;668;691;23;87;2.0
11;57;691;711;20;87;2.0
11;58;711;728;17;87;2.0
11;59;728;729;1;87;2.0
11;60;729;733;4;87;2.0
11;61;733;748;15;87;2.0
11;62;748;758;10;87;2.0
11;63;758;759;1;87;2.0
11;64;759;764;5;87;2.0
11;65;764;771;7;87;2.0
11;66;771;789;18;87;2.0
11;67;789;803;14;87;2.0
11;68;803;806;3;87;2.0
11;69;806;831;25;87;2.0
11;70;831;833;2;87;2.0
11;71;833;834;1;87;2.0
11;72;834;842;8;87;2.0
11;73;842;844;2;87;2.0
11;74;844;845;1;87;2.0
11;75;845;856;11;87;2.0
11;76;856;858;2;87;2.0
11;77;858;873;15;87;2.0
11;78;873;876;3;87;2.0
11;79;876;881;5;87;2.0
11;80;881;883;2;87;2.0
11;81;883;888;5;87;2.0
11;82;888;889;1;87;2.0
11;83;889;891;2;87;2.0
11;84;891;898;7;87;2.0
11;85;898;899;1;87;2.0
11;86;899;909;10;87;2.0
11;87;909;911;2;87;2.0
11;88;911;914;3;87;2.0
11;89;914;918;4;87;2.0
11;90;918;926;8;87;2.0
11;91;926;933;7;87;2.0
11;92;933;939;6;87;2.0
11;93;939;943;4;87;2.0
11;94;943;944;1;87;2.0
11;95;944;949;5;87;2.0
11;96;949;951;2;87;2.0
11;97;951;953;2;87;2.0
11;98;953;958;5;87;2.0
11;99;958;966;8;87;2.0
11;100;966;969;3;87;2.0
11;101;969;974;5;87;2.0
11;102;974;978;4;87;2.0
11;103;978;986;8;87;2.0
11;104;986;989;3;87;2.0
11;105;989;990;1;87;2.0
11;106;990;1004;14;87;2.0
11;107;1004;1006;2;87;2.0
11;108;1006;1018;12;87;2.0
11;109;1018;1029;11;87;2.0
11;110;1029;1033;4;87;2.0
11;111;1033;1034;1;87;2.0
11;112;1034;1036;2;87;2.0
11;113;1036;1038;2;87;2.0
11;114;1038;1054;16;87;2.0
11;115;1054;1056;2;87;2.0
11;116;1056;1064;8;87;2.0
11;117;1064;1073;9;87;2.0
11;118;1073;1076;3;87;2.0
11;119;1076;1078;2;87;2.0
11;120;1078;1088;10;87;2.0
11;121;1088;1094;6;87;2.0
11;122;1094;1096;2;87;2.0
11;123;1096;1098;2;87;2.0
11;124;1098;1103;5;87;2.0
11;125;1103;1109;6;87;2.0
11;126;1109;1110;1;87;2.0
11;127;1110;1112;2;87;2.0
11;128;1112;1124;12;87;2.0
11;129;1124;1155;31;87;2.0
11;130;1155;1162;7;87;2.0
11;131;1162;1182;20;87;2.0
11;132;1182;1186;4;87;2.0
11;133;1186;1215;29;87;2.0
11;134;1215;1228;13;87;2.0
11;135;1228;1232;4;87;2.0
11;136;1232;1233;1;87;2.0
11;137;1233;1275;42;87;2.0
11;138;1275;1282;7;87;2.0
11;139;1282;1291;9;87;2.0
11;140;1291;1292;1;87;2.0
11;141;1292;1325;33;87;2.0
11;142;1325;1329;4;87;2.0
11;143;1329;1349;20;87;2.0
11;144;1349;1354;5;87;2.0
11;145;1354;1389;35;87;2.0
11;146;1389;1397;8;87;2.0
11;147;1397;1402;5;87;2.0
11;148;1402;1404;2;87;2.0
11;149;1404;1419;15;87;2.0
11;150;1419;1434;15;87;2.0
11;151;1434;1449;15;87;2.0
11;152;1449;1464;15;87;2.0
11;153;1464;1479;15;87;2.0
11;154;1479;1494;15;87;2.0
11;155;1494;1509;15;87;2.0
11;156;1509;1524;15;87;2.0
11;157;1524;1539;15;87;2.0
11;158;1539;1554;15;87;2.0
11;159;1554;1569;15;87;2.0
11;160;1569;1584;15;87;2.0
11;161;1584;1599;15;87;2.0
11;162;1599;1614;15;87;2.0
11;163;1614;1629;15;87;2.0
11;164;1629;1644;15;87;2.0
11;165;1644;1659;15;87;2.0
11;166;1659;1680;21;87;2.0
12;0;246;336;90;72;2.0
12;1;336;337;1;72;2.0
12;2;337;340;3;72;2.0
12;3;340;342;2;72;2.0
12;4;342;351;9;72;2.0
12;5;351;354;3;72;2.0
12;6;354;355;1;72;2.0
12;7;355;360;5;72;2.0
12;8;360;362;2;72;2.0
12;9;362;364;2;72;2.0
12;10;364;366;2;72;2.0
12;11;366;377;11;72;2.0
12;12;377;380;3;72;2.0
12;13;380;384;4;72;2.0
12;14;384;386;2;72;2.0
12;15;386;389;3;72;2.0
12;16;389;395;6;72;2.0
12;17;395;397;2;72;2.0
12;18;397;401;4;72;2.0
12;19;401;410;9;72;2.0
12;20;410;412;2;72;2.0
12;21;412;414;2;72;2.0
12;22;414;421;7;72;2.0
12;23;421;423;2;72;2.0
12;24;423;424;1;72;2.0
12;25;424;427;3;72;2.0
12;26;427;432;5;72;2.0
12;27;432;437;5;72;2.0
12;28;437;444;7;72;2.0
12;29;444;447;3;72;2.0
12;30;447;455;8;72;2.0
12;31;455;456;1;72;2.0
12;32;456;457;1;72;2.0
12;33;457;458;1;72;2.0
12;34;458;459;1;72;2.0
12;35;459;467;8;72;2.0
12;36;467;468;1;72;2.0
12;37;468;470;2;72;2.0
12;38;470;478;8;72;2.0
12;39;478;479;1;72;2.0
12;40;479;485;6;72;2.0
12;41;485;502;17;72;2.0
12;42;502;506;4;72;2.0
12;43;506;507;1;72;2.0
12;44;507;509;2;72;2.0
12;45;509;518;9;72;2.0
12;46;518;519;1;72;2.0
12;47;519;532;13;72;2.0
12;48;532;536;4;72;2.0
12;49;536;544;8;72;2.0
12;50;544;548;4;72;2.0
12;51;548;554;6;72;2.0
12;52;554;587;33;72;2.0
12;53;587;594;7;72;2.0
12;54;594;598;4;72;2.0
12;55;598;602;4;72;2.0
12;56;602;624;22;72;2.0
12;57;624;634;10;72;2.0
12;58;634;637;3;72;2.0
12;59;637;661;24;72;2.0
12;60;661;664;3;72;2.0
12;61;664;686;22;72;2.0
12;62;686;707;21;72;2.0
12;63;707;722;15;72;2.0
12;64;722;723;1;72;2.0
12;65;723;729;6;72;2.0
12;66;729;744;15;72;2.0
12;67;744;751;7;72;2.0
12;68;751;754;3;72;2.0
12;69;754;757;3;72;2.0
12;70;757;767;10;72;2.0
12;71;767;783;16;72;2.0
12;72;783;799;16;72;2.0
12;73;799;802;3;72;2.0
12;74;802;826;24;72;2.0
12;75;826;827;1;72;2.0
12;76;827;837;10;72;2.0
12;77;837;838;1;72;2.0
12;78;838;841;3;72;2.0
12;79;841;852;11;72;2.0
12;80;852;854;2;72;2.0
12;81;854;869;15;72;2.0
12;82;869;872;3;72;2.0
12;83;872;874;2;72;2.0
12;84;874;876;2;72;2.0
12;85;876;882;6;72;2.0
12;86;882;884;2;72;2.0
12;87;884;887;3;72;2.0
12;88;887;892;5;72;2.0
12;89;892;893;1;72;2.0
12;90;893;904;11;72;2.0
12;91;904;907;3;72;2.0
12;92;907;908;1;72;2.0
12;93;908;914;6;72;2.0
12;94;914;922;8;72;2.0
12;95;922;929;7;72;2.0
12;96;929;934;5;72;2.0
12;97;934;936;2;72;2.0
12;98;936;937;1;72;2.0
12;99;937;943;6;72;2.0
12;100;943;947;4;72;2.0
12;101;947;949;2;72;2.0
12;102;949;952;3;72;2.0
12;103;952;962;10;72;2.0
12;104;962;963;1;72;2.0
12;105;963;964;1;72;2.0
12;106;964;967;3;72;2.0
12;107;967;974;7;72;2.0
12;108;974;982;8;72;2.0
12;109;982;983;1;72;2.0
12;110;983;985;2;72;2.0
12;111;985;997;12;72;2.0
12;112;997;998;1;72;2.0
12;113;998;1002;4;72;2.0
12;114;1002;1012;10;72;2.0
12;115;1012;1024;12;72;2.0
12;116;1024;1026;2;72;2.0
12;117;1026;1027;1;72;2.0
12;118;1027;1032;5;72;2.0
12;119;1032;1034;2;72;2.0
12;120;1034;1048;14;72;2.0
12;121;1048;1052;4;72;2.0
12;122;1052;1057;5;72;2.0
12;123;1057;1069;12;72;2.0
12;124;1069;1072;3;72;2.0
12;125;1072;1081;9;72;2.0
12;126;1081;1088;7;72;2.0
12;127;1088;1092;4;72;2.0
12;128;1092;1094;2;72;2.0
12;129;1094;1098;4;72;2.0
12;130;1098;1103;5;72;2.0
12;131;1103;1105;2;72;2.0
12;132;1105;1106;1;72;2.0
12;133;1106;1117;11;72;2.0
12;134;1117;1151;34;72;2.0
12;135;1151;1156;5;72;2.0
12;136;1156;1176;20;72;2.0
12;137;1176;1181;5;72;2.0
12;138;1181;1211;30;72;2.0
12;139;1211;1224;13;72;2.0
12;140;1224;1226;2;72;2.0
12;141;1226;1228;2;72;2.0
12;142;1228;1271;43;72;2.0
12;143;1271;1276;5;72;2.0
12;144;1276;1286;10;72;2.0
12;145;1286;1321;35;72;2.0
12;146;1321;1325;4;72;2.0
12;147;1325;1342;17;72;2.0
12;148;1342;1349;7;72;2.0
12;149;1349;1385;36;72;2.0
12;150;1385;1391;6;72;2.0
12;151;1391;1396;5;72;2.0
12;152;1396;1399;3;72;2.0
12;153;1399;1414;15;72;2.0
12;154;1414;1429;15;72;2.0
12;155;1429;1444;15;72;2.0
12;156;1444;1459;15;72;2.0
12;157;1459;1474;15;72;2.0
12;158;1474;1489;15;72;2.0
12;159;1489;1504;15;72;2.0
12;160;1504;1519;15;72;2.0
12;161;1519;1534;15;72;2.0
12;162;1534;1549;15;72;2.0
12;163;1549;1564;15;72;2.0
12;164;1564;1579;15;72;2.0
12;165;1579;1594;15;72;2.0
12;166;1594;1609;15;72;2.0
12;167;1609;1624;15;72;2.0
12;168;1624;1639;15;72;2.0
12;169;1639;1654;15;72;2.0
12;170;1654;1669;15;72;2.0
12;171;1669;1680;11;72;2.0
13;0;249;330;81;58;2.0
13;1;330;333;3;58;2.0
13;2;333;338;5;58;2.0
13;3;338;345;7;58;2.0
13;4;345;348;3;58;2.0
13;5;348;350;2;58;2.0
13;6;350;363;13;58;2.0
13;7;363;365;2;58;2.0
13;8;365;373;8;58;2.0
13;9;373;377;4;58;2.0
13;10;377;380;3;58;2.0
13;11;380;383;3;58;2.0
13;12;383;385;2;58;2.0
13;13;385;391;6;58;2.0
13;14;391;393;2;58;2.0
13;15;393;398;5;58;2.0
13;16;398;400;2;58;2.0
13;17;400;415;15;58;2.0
13;18;415;417;2;58;2.0
13;19;417;418;1;58;2.0
13;20;418;423;5;58;2.0
13;21;423;433;10;58;2.0
13;22;433;434;1;58;2.0
13;23;434;435;1;58;2.0
13;24;435;445;10;58;2.0
13;25;445;450;5;58;2.0
13;26;450;453;3;58;2.0
13;27;453;458;5;58;2.0
13;28;458;460;2;58;2.0
13;29;460;465;5;58;2.0
13;30;465;468;3;58;2.0
13;31;468;470;2;58;2.0
13;32;470;475;5;58;2.0
13;33;475;478;3;58;2.0
13;34;478;488;10;58;2.0
13;35;488;504;16;58;2.0
13;36;504;505;1;58;2.0
13;37;505;508;3;58;2.0
13;38;508;509;1;58;2.0
13;39;509;518;9;58;2.0
13;40;518;521;3;58;2.0
13;41;521;533;12;58;2.0
13;42;533;535;2;58;2.0
13;43;535;548;13;58;2.0
13;44;548;553;5;58;2.0
13;45;553;554;1;58;2.0
13;46;554;584;30;58;2.0
13;47;584;590;6;58;2.0
13;48;590;598;8;58;2.0
13;49;598;599;1;58;2.0
13;50;599;625;26;58;2.0
13;51;625;633;8;58;2.0
13;52;633;636;3;58;2.0
13;53;636;640;4;58;2.0
13;54;640;654;14;58;2.0
13;55;654;658;4;58;2.0
13;56;658;688;30;58;2.0
13;57;688;710;22;58;2.0
13;58;710;719;9;58;2.0
13;59;719;723;4;58;2.0
13;60;723;745;22;58;2.0
13;61;745;748;3;58;2.0
13;62;748;756;8;58;2.0
13;63;756;766;10;58;2.0
13;64;766;770;4;58;2.0
13;65;770;783;13;58;2.0
13;66;783;789;6;58;2.0
13;67;789;805;16;58;2.0
13;68;805;823;18;58;2.0
13;69;823;824;1;58;2.0
13;70;824;830;6;58;2.0
13;71;830;831;1;58;2.0
13;72;831;836;5;58;2.0
13;73;836;838;2;58;2.0
13;74;838;839;1;58;2.0
13;75;839;844;5;58;2.0
13;76;844;855;11;58;2.0
13;77;855;859;4;58;2.0
13;78;859;873;14;58;2.0
13;79;873;874;1;58;2.0
13;80;874;875;1;58;2.0
13;81;875;883;8;58;2.0
13;82;883;889;6;58;2.0
13;83;889;890;1;58;2.0
13;84;890;891;1;58;2.0
13;85;891;893;2;58;2.0
13;86;893;904;11;58;2.0
13;87;904;906;2;58;2.0
13;88;906;908;2;58;2.0
13;89;908;910;2;58;2.0
13;90;910;916;6;58;2.0
13;91;916;925;9;58;2.0
13;92;925;930;5;58;2.0
13;93;930;933;3;58;2.0
13;94;933;936;3;58;2.0
13;95;936;939;3;58;2.0
13;96;939;943;4;58;2.0
13;97;943;946;3;58;2.0
13;98;946;949;3;58;2.0
13;99;949;950;1;58;2.0
13;100;950;963;13;58;2.0
13;101;963;964;1;58;2.0
13;102;964;965;1;58;2.0
13;103;965;966;1;58;2.0
13;104;966;976;10;58;2.0
13;105;976;983;7;58;2.0
13;106;983;985;2;58;2.0
13;107;985;987;2;58;2.0
13;108;987;998;11;58;2.0
13;109;998;1005;7;58;2.0
13;110;1005;1006;1;58;2.0
13;111;1006;1009;3;58;2.0
13;112;1009;1023;14;58;2.0
13;113;1023;1024;1;58;2.0
13;114;1024;1026;2;58;2.0
13;115;1026;1035;9;58;2.0
13;116;1035;1036;1;58;2.0
13;117;1036;1048;12;58;2.0
13;118;1048;1055;7;58;2.0
13;119;1055;1059;4;58;2.0
13;120;1059;1066;7;58;2.0
13;121;1066;1069;3;58;2.0
13;122;1069;1075;6;58;2.0
13;123;1075;1078;3;58;2.0
13;124;1078;1088;10;58;2.0
13;125;1088;1095;7;58;2.0
13;126;1095;1100;5;58;2.0
13;127;1100;1103;3;58;2.0
13;128;1103;1106;3;58;2.0
13;129;1106;1107;1;58;2.0
13;130;1107;1126;19;58;2.0
13;131;1126;1153;27;58;2.0
13;132;1153;1154;1;58;2.0
13;133;1154;1176;22;58;2.0
13;134;1176;1183;7;58;2.0
13;135;1183;1214;31;58;2.0
13;136;1214;1225;11;58;2.0
13;137;1225;1226;1;58;2.0
13;138;1226;1230;4;58;2.0
13;139;1230;1273;43;58;2.0
13;140;1273;1274;1;58;2.0
13;141;1274;1286;12;58;2.0
13;142;1286;1288;2;58;2.0
13;143;1288;1315;27;58;2.0
13;144;1315;1324;9;58;2.0
13;145;1324;1339;15;58;2.0
13;146;1339;1351;12;58;2.0
13;147;1351;1388;37;58;2.0
13;148;1388;1391;3;58;2.0
13;149;1391;1393;2;58;2.0
13;150;1393;1401;8;58;2.0
13;151;1401;1416;15;58;2.0
13;152;1416;1431;15;58;2.0
13;153;1431;1446;15;58;2.0
13;154;1446;1461;15;58;2.0
13;155;1461;1476;15;58;2.0
13;156;1476;1491;15;58;2.0
13;157;1491;1506;15;58;2.0
13;158;1506;1521;15;58;2.0
13;159;1521;1536;15;58;2.0
13;160;1536;1551;15;58;2.0
13;161;1551;1566;15;58;2.0
13;162;1566;1581;15;58;2.0
13;163;1581;1596;15;58;2.0
13;164;1596;1611;15;58;2.0
13;165;1611;1626;15;58;2.0
13;166;1626;1641;15;58;2.0
13;167;1641;1656;15;58;2.0
13;168;1656;1680;24;58;2.0
14;0;257;324;67;115;2.0
14;1;324;336;12;115;2.0
14;2;336;344;8;115;2.0
14;3;344;350;6;115;2.0
14;4;350;359;9;115;2.0
14;5;359;365;6;115;2.0
14;6;365;370;5;115;2.0
14;7;370;374;4;115;2.0
14;8;374;379;5;115;2.0
14;9;379;380;1;115;2.0
14;10;380;384;4;115;2.0
14;11;384;394;10;115;2.0
14;12;394;396;2;115;2.0
14;13;396;400;4;115;2.0
14;14;400;405;5;115;2.0
14;15;405;409;4;115;2.0
14;16;409;414;5;115;2.0
14;17;414;420;6;115;2.0
14;18;420;429;9;115;2.0
14;19;429;430;1;115;2.0
14;20;430;437;7;115;2.0
14;21;437;439;2;115;2.0
14;22;439;440;1;115;2.0
14;23;440;441;1;115;2.0
14;24;441;449;8;115;2.0
14;25;449;458;9;115;2.0
14;26;458;460;2;115;2.0
14;27;460;464;4;115;2.0
14;28;464;465;1;115;2.0
14;29;465;472;7;115;2.0
14;30;472;474;2;115;2.0
14;31;474;480;6;115;2.0
14;32;480;484;4;115;2.0
14;33;484;495;11;115;2.0
14;34;495;511;16;115;2.0
14;35;511;513;2;115;2.0
14;36;513;514;1;115;2.0
14;37;514;515;1;115;2.0
14;38;515;524;9;115;2.0
14;39;524;526;2;115;2.0
14;40;526;544;18;115;2.0
14;41;544;554;10;115;2.0
14;42;554;560;6;115;2.0
14;43;560;569;9;115;2.0
14;44;569;604;35;115;2.0
14;45;604;606;2;115;2.0
14;46;606;619;13;115;2.0
14;47;619;623;4;115;2.0
14;48;623;640;17;115;2.0
14;49;640;641;1;115;2.0
14;50;641;669;28;115;2.0
14;51;669;674;5;115;2.0
14;52;674;689;15;115;2.0
14;53;689;693;4;115;2.0
14;54;693;726;33;115;2.0
14;55;726;729;3;115;2.0
14;56;729;739;10;115;2.0
14;57;739;743;4;115;2.0
14;58;743;749;6;115;2.0
14;59;749;759;10;115;2.0
14;60;759;761;2;115;2.0
14;61;761;773;12;115;2.0
14;62;773;784;11;115;2.0
14;63;784;789;5;115;2.0
14;64;789;809;20;115;2.0
14;65;809;831;22;115;2.0
14;66;831;834;3;115;2.0
14;67;834;843;9;115;2.0
14;68;843;844;1;115;2.0
14;69;844;851;7;115;2.0
14;70;851;854;3;115;2.0
14;71;854;864;10;115;2.0
14;72;864;869;5;115;2.0
14;73;869;879;10;115;2.0
14;74;879;884;5;115;2.0
14;75;884;889;5;115;2.0
14;76;889;890;1;115;2.0
14;77;890;894;4;115;2.0
14;78;894;896;2;115;2.0
14;79;896;898;2;115;2.0
14;80;898;899;1;115;2.0
14;81;899;904;5;115;2.0
14;82;904;911;7;115;2.0
14;83;911;914;3;115;2.0
14;84;914;923;9;115;2.0
14;85;923;924;1;115;2.0
14;86;924;928;4;115;2.0
14;87;928;929;1;115;2.0
14;88;929;941;12;115;2.0
14;89;941;944;3;115;2.0
14;90;944;949;5;115;2.0
14;91;949;953;4;115;2.0
14;92;953;956;3;115;2.0
14;93;956;959;3;115;2.0
14;94;959;964;5;115;2.0
14;95;964;969;5;115;2.0
14;96;969;971;2;115;2.0
14;97;971;983;12;115;2.0
14;98;983;984;1;115;2.0
14;99;984;989;5;115;2.0
14;100;989;992;3;115;2.0
14;101;992;1004;12;115;2.0
14;102;1004;1013;9;115;2.0
14;103;1013;1014;1;115;2.0
14;104;1014;1016;2;115;2.0
14;105;1016;1031;15;115;2.0
14;106;1031;1034;3;115;2.0
14;107;1034;1043;9;115;2.0
14;108;1043;1044;1;115;2.0
14;109;1044;1054;10;115;2.0
14;110;1054;1073;19;115;2.0
14;111;1073;1074;1;115;2.0
14;112;1074;1076;2;115;2.0
14;113;1076;1079;3;115;2.0
14;114;1079;1089;10;115;2.0
14;115;1089;1093;4;115;2.0
14;116;1093;1094;1;115;2.0
14;117;1094;1105;11;115;2.0
14;118;1105;1109;4;115;2.0
14;119;1109;1112;3;115;2.0
14;120;1112;1133;21;115;2.0
14;121;1133;1160;27;115;2.0
14;122;1160;1182;22;115;2.0
14;123;1182;1188;6;115;2.0
14;124;1188;1193;5;115;2.0
14;125;1193;1223;30;115;2.0
14;126;1223;1232;9;115;2.0
14;127;1232;1235;3;115;2.0
14;128;1235;1253;18;115;2.0
14;129;1253;1280;27;115;2.0
14;130;1280;1292;12;115;2.0
14;131;1292;1293;1;115;2.0
14;132;1293;1303;10;115;2.0
14;133;1303;1335;32;115;2.0
14;134;1335;1350;15;115;2.0
14;135;1350;1356;6;115;2.0
14;136;1356;1367;11;115;2.0
14;137;1367;1397;30;115;2.0
14;138;1397;1400;3;115;2.0
14;139;1400;1406;6;115;2.0
14;140;1406;1421;15;115;2.0
14;141;1421;1436;15;115;2.0
14;142;1436;1451;15;115;2.0
14;143;1451;1466;15;115;2.0
14;144;1466;1481;15;115;2.0
14;145;1481;1496;15;115;2.0
14;146;1496;1511;15;115;2.0
14;147;1511;1526;15;115;2.0
14;148;1526;1541;15;115;2.0
14;149;1541;1556;15;115;2.0
14;150;1556;1571;15;115;2.0
14;151;1571;1586;15;115;2.0
14;152;1586;1601;15;115;2.0
14;153;1601;1616;15;115;2.0
14;154;1616;1631;15;115;2.0
14;155;1631;1646;15;115;2.0
14;156;1646;1661;15;115;2.0
14;157;1661;1680;19;115;2.0
15;0;260;341;81;159;2.0
15;1;341;344;3;159;2.0
15;2;344;349;5;159;2.0
15;3;349;351;2;159;2.0
15;4;351;356;5;159;2.0
15;5;356;358;2;159;2.0
15;6;358;364;6;159;2.0
15;7;364;369;5;159;2.0
15;8;369;371;2;159;2.0
15;9;371;375;4;159;2.0
15;10;375;385;10;159;2.0
15;11;385;386;1;159;2.0
15;12;386;391;5;159;2.0
15;13;391;398;7;159;2.0
15;14;398;404;6;159;2.0
15;15;404;405;1;159;2.0
15;16;405;406;1;159;2.0
15;17;406;415;9;159;2.0
15;18;415;419;4;159;2.0
15;19;419;421;2;159;2.0
15;20;421;426;5;159;2.0
15;21;426;430;4;159;2.0
15;22;430;435;5;159;2.0
15;23;435;436;1;159;2.0
15;24;436;441;5;159;2.0
15;25;441;445;4;159;2.0
15;26;445;456;11;159;2.0
15;27;456;461;5;159;2.0
15;28;461;464;3;159;2.0
15;29;464;465;1;159;2.0
15;30;465;466;1;159;2.0
15;31;466;475;9;159;2.0
15;32;475;476;1;159;2.0
15;33;476;477;1;159;2.0
15;34;477;479;2;159;2.0
15;35;479;485;6;159;2.0
15;36;485;494;9;159;2.0
15;37;494;500;6;159;2.0
15;38;500;511;11;159;2.0
15;39;511;515;4;159;2.0
15;40;515;516;1;159;2.0
15;41;516;525;9;159;2.0
15;42;525;528;3;159;2.0
15;43;528;541;13;159;2.0
15;44;541;555;14;159;2.0
15;45;555;561;6;159;2.0
15;46;561;565;4;159;2.0
15;47;565;580;15;159;2.0
15;48;580;596;16;159;2.0
15;49;596;603;7;159;2.0
15;50;603;605;2;159;2.0
15;51;605;631;26;159;2.0
15;52;631;643;12;159;2.0
15;53;643;645;2;159;2.0
15;54;645;646;1;159;2.0
15;55;646;666;20;159;2.0
15;56;666;673;7;159;2.0
15;57;673;695;22;159;2.0
15;58;695;700;5;159;2.0
15;59;700;716;16;159;2.0
15;60;716;730;14;159;2.0
15;61;730;738;8;159;2.0
15;62;738;751;13;159;2.0
15;63;751;756;5;159;2.0
15;64;756;763;7;159;2.0
15;65;763;776;13;159;2.0
15;66;776;778;2;159;2.0
15;67;778;790;12;159;2.0
15;68;790;805;15;159;2.0
15;69;805;808;3;159;2.0
15;70;808;811;3;159;2.0
15;71;811;831;20;159;2.0
15;72;831;836;5;159;2.0
15;73;836;845;9;159;2.0
15;74;845;846;1;159;2.0
15;75;846;848;2;159;2.0
15;76;848;850;2;159;2.0
15;77;850;861;11;159;2.0
15;78;861;863;2;159;2.0
15;79;863;870;7;159;2.0
15;80;870;878;8;159;2.0
15;81;878;881;3;159;2.0
15;82;881;893;12;159;2.0
15;83;893;895;2;159;2.0
15;84;895;896;1;159;2.0
15;85;896;900;4;159;2.0
15;86;900;903;3;159;2.0
15;87;903;913;10;159;2.0
15;88;913;915;2;159;2.0
15;89;915;916;1;159;2.0
15;90;916;923;7;159;2.0
15;91;923;928;5;159;2.0
15;92;928;930;2;159;2.0
15;93;930;931;1;159;2.0
15;94;931;936;5;159;2.0
15;95;936;941;5;159;2.0
15;96;941;943;2;159;2.0
15;97;943;950;7;159;2.0
15;98;950;956;6;159;2.0
15;99;956;958;2;159;2.0
15;100;958;970;12;159;2.0
15;101;970;971;1;159;2.0
15;102;971;973;2;159;2.0
15;103;973;983;10;159;2.0
15;104;983;988;5;159;2.0
15;105;988;990;2;159;2.0
15;106;990;991;1;159;2.0
15;107;991;994;3;159;2.0
15;108;994;1005;11;159;2.0
15;109;1005;1011;6;159;2.0
15;110;1011;1018;7;159;2.0
15;111;1018;1031;13;159;2.0
15;112;1031;1033;2;159;2.0
15;113;1033;1041;8;159;2.0
15;114;1041;1043;2;159;2.0
15;115;1043;1048;5;159;2.0
15;116;1048;1050;2;159;2.0
15;117;1050;1055;5;159;2.0
15;118;1055;1061;6;159;2.0
15;119;1061;1078;17;159;2.0
15;120;1078;1081;3;159;2.0
15;121;1081;1086;5;159;2.0
15;122;1086;1095;9;159;2.0
15;123;1095;1101;6;159;2.0
15;124;1101;1107;6;159;2.0
15;125;1107;1110;3;159;2.0
15;126;1110;1113;3;159;2.0
15;127;1113;1114;1;159;2.0
15;128;1114;1134;20;159;2.0
15;129;1134;1138;4;159;2.0
15;130;1138;1160;22;159;2.0
15;131;1160;1183;23;159;2.0
15;132;1183;1190;7;159;2.0
15;133;1190;1220;30;159;2.0
15;134;1220;1231;11;159;2.0
15;135;1231;1233;2;159;2.0
15;136;1233;1237;4;159;2.0
15;137;1237;1254;17;159;2.0
15;138;1254;1280;26;159;2.0
15;139;1280;1293;13;159;2.0
15;140;1293;1295;2;159;2.0
15;141;1295;1330;35;159;2.0
15;142;1330;1334;4;159;2.0
15;143;1334;1347;13;159;2.0
15;144;1347;1358;11;159;2.0
15;145;1358;1374;16;159;2.0
15;146;1374;1394;20;159;2.0
15;147;1394;1398;4;159;2.0
15;148;1398;1408;10;159;2.0
15;149;1408;1423;15;159;2.0
15;150;1423;1438;15;159;2.0
15;151;1438;1453;15;159;2.0
15;152;1453;1468;15;159;2.0
15;153;1468;1483;15;159;2.0
15;154;1483;1498;15;159;2.0
15;155;1498;1513;15;159;2.0
15;156;1513;1528;15;159;2.0
15;157;1528;1543;15;159;2.0
15;158;1543;1558;15;159;2.0
15;159;1558;1573;15;159;2.0
15;160;1573;1588;15;159;2.0
15;161;1588;1603;15;159;2.0
15;162;1603;1618;15;159;2.0
15;163;1618;1633;15;159;2.0
15;164;1633;1648;15;159;2.0
15;165;1648;1680;32;159;2.0
16;0;247;325;78;14;2.0
16;1;325;335;10;14;2.0
16;2;335;342;7;14;2.0
16;3;342;350;8;14;2.0
16;4;350;355;5;14;2.0
16;5;355;357;2;14;2.0
16;6;357;362;5;14;2.0
16;7;362;364;2;14;2.0
16;8;364;365;1;14;2.0
16;9;365;370;5;14;2.0
16;10;370;374;4;14;2.0
16;11;374;376;2;14;2.0
16;12;376;385;9;14;2.0
16;13;385;388;3;14;2.0
16;14;388;390;2;14;2.0
16;15;390;394;4;14;2.0
16;16;394;397;3;14;2.0
16;17;397;400;3;14;2.0
16;18;400;405;5;14;2.0
16;19;405;412;7;14;2.0
16;20;412;420;8;14;2.0
16;21;420;421;1;14;2.0
16;22;421;424;3;14;2.0
16;23;424;425;1;14;2.0
16;24;425;429;4;14;2.0
16;25;429;433;4;14;2.0
16;26;433;434;1;14;2.0
16;27;434;440;6;14;2.0
16;28;440;447;7;14;2.0
16;29;447;450;3;14;2.0
16;30;450;454;4;14;2.0
16;31;454;455;1;14;2.0
16;32;455;456;1;14;2.0
16;33;456;457;1;14;2.0
16;34;457;460;3;14;2.0
16;35;460;466;6;14;2.0
16;36;466;472;6;14;2.0
16;37;472;476;4;14;2.0
16;38;476;487;11;14;2.0
16;39;487;489;2;14;2.0
16;40;489;495;6;14;2.0
16;41;495;503;8;14;2.0
16;42;503;505;2;14;2.0
16;43;505;507;2;14;2.0
16;44;507;516;9;14;2.0
16;45;516;518;2;14;2.0
16;46;518;525;7;14;2.0
16;47;525;535;10;14;2.0
16;48;535;546;11;14;2.0
16;49;546;552;6;14;2.0
16;50;552;554;2;14;2.0
16;51;554;580;26;14;2.0
16;52;580;596;16;14;2.0
16;53;596;598;2;14;2.0
16;54;598;612;14;14;2.0
16;55;612;630;18;14;2.0
16;56;630;633;3;14;2.0
16;57;633;634;1;14;2.0
16;58;634;660;26;14;2.0
16;59;660;666;6;14;2.0
16;60;666;685;19;14;2.0
16;61;685;700;15;14;2.0
16;62;700;718;18;14;2.0
16;63;718;721;3;14;2.0
16;64;721;731;10;14;2.0
16;65;731;732;1;14;2.0
16;66;732;750;18;14;2.0
16;67;750;753;3;14;2.0
16;68;753;760;7;14;2.0
16;69;760;767;7;14;2.0
16;70;767;781;14;14;2.0
16;71;781;795;14;14;2.0
16;72;795;801;6;14;2.0
16;73;801;820;19;14;2.0
16;74;820;823;3;14;2.0
16;75;823;825;2;14;2.0
16;76;825;836;11;14;2.0
16;77;836;837;1;14;2.0
16;78;837;843;6;14;2.0
16;79;843;845;2;14;2.0
16;80;845;856;11;14;2.0
16;81;856;865;9;14;2.0
16;82;865;871;6;14;2.0
16;83;871;875;4;14;2.0
16;84;875;880;5;14;2.0
16;85;880;884;4;14;2.0
16;86;884;886;2;14;2.0
16;87;886;888;2;14;2.0
16;88;888;891;3;14;2.0
16;89;891;892;1;14;2.0
16;90;892;900;8;14;2.0
16;91;900;903;3;14;2.0
16;92;903;906;3;14;2.0
16;93;906;915;9;14;2.0
16;94;915;916;1;14;2.0
16;95;916;917;1;14;2.0
16;96;917;933;16;14;2.0
16;97;933;935;2;14;2.0
16;98;935;940;5;14;2.0
16;99;940;941;1;14;2.0
16;100;941;947;6;14;2.0
16;101;947;948;1;14;2.0
16;102;948;951;3;14;2.0
16;103;951;955;4;14;2.0
16;104;955;961;6;14;2.0
16;105;961;963;2;14;2.0
16;106;963;975;12;14;2.0
16;107;975;976;1;14;2.0
16;108;976;977;1;14;2.0
16;109;977;981;4;14;2.0
16;110;981;984;3;14;2.0
16;111;984;995;11;14;2.0
16;112;995;996;1;14;2.0
16;113;996;1007;11;14;2.0
16;114;1007;1008;1;14;2.0
16;115;1008;1023;15;14;2.0
16;116;1023;1025;2;14;2.0
16;117;1025;1036;11;14;2.0
16;118;1036;1037;1;14;2.0
16;119;1037;1045;8;14;2.0
16;120;1045;1046;1;14;2.0
16;121;1046;1065;19;14;2.0
16;122;1065;1067;2;14;2.0
16;123;1067;1068;1;14;2.0
16;124;1068;1071;3;14;2.0
16;125;1071;1080;9;14;2.0
16;126;1080;1082;2;14;2.0
16;127;1082;1085;3;14;2.0
16;128;1085;1086;1;14;2.0
16;129;1086;1097;11;14;2.0
16;130;1097;1101;4;14;2.0
16;131;1101;1104;3;14;2.0
16;132;1104;1127;23;14;2.0
16;133;1127;1144;17;14;2.0
16;134;1144;1152;8;14;2.0
16;135;1152;1174;22;14;2.0
16;136;1174;1180;6;14;2.0
16;137;1180;1204;24;14;2.0
16;138;1204;1212;8;14;2.0
16;139;1212;1224;12;14;2.0
16;140;1224;1227;3;14;2.0
16;141;1227;1264;37;14;2.0
16;142;1264;1272;8;14;2.0
16;143;1272;1284;12;14;2.0
16;144;1284;1285;1;14;2.0
16;145;1285;1314;29;14;2.0
16;146;1314;1327;13;14;2.0
16;147;1327;1341;14;14;2.0
16;148;1341;1348;7;14;2.0
16;149;1348;1378;30;14;2.0
16;150;1378;1389;11;14;2.0
16;151;1389;1392;3;14;2.0
16;152;1392;1398;6;14;2.0
16;153;1398;1413;15;14;2.0
16;154;1413;1428;15;14;2.0
16;155;1428;1443;15;14;2.0
16;156;1443;1458;15;14;2.0
16;157;1458;1473;15;14;2.0
16;158;1473;1488;15;14;2.0
16;159;1488;1503;15;14;2.0
16;160;1503;1518;15;14;2.0
16;161;1518;1533;15;14;2.0
16;162;1533;1548;15;14;2.0
16;163;1548;1563;15;14;2.0
16;164;1563;1578;15;14;2.0
16;165;1578;1593;15;14;2.0
16;166;1593;1608;15;14;2.0
16;167;1608;1623;15;14;2.0
16;168;1623;1638;15;14;2.0
16;169;1638;1653;15;14;2.0
16;170;1653;1668;15;14;2.0
16;171;1668;1680;12;14;2.0
17;0;252;333;81;99;2.0
17;1;333;338;5;99;2.0
17;2;338;341;3;99;2.0
17;3;341;345;4;99;2.0
17;4;345;353;8;99;2.0
17;5;353;360;7;99;2.0
17;6;360;361;1;99;2.0
17;7;361;365;4;99;2.0
17;8;365;368;3;99;2.0
17;9;368;369;1;99;2.0
17;10;369;376;7;99;2.0
17;11;376;378;2;99;2.0
17;12;378;379;1;99;2.0
17;13;379;388;9;99;2.0
17;14;388;391;3;99;2.0
17;15;391;396;5;99;2.0
17;16;396;399;3;99;2.0
17;17;399;400;1;99;2.0
17;18;400;403;3;99;2.0
17;19;403;411;8;99;2.0
17;20;411;415;4;99;2.0
17;21;415;423;8;99;2.0
17;22;423;424;1;99;2.0
17;23;424;429;5;99;2.0
17;24;429;431;2;99;2.0
17;25;431;432;1;99;2.0
17;26;432;435;3;99;2.0
17;27;435;439;4;99;2.0
17;28;439;446;7;99;2.0
17;29;446;455;9;99;2.0
17;30;455;456;1;99;2.0
17;31;456;458;2;99;2.0
17;32;458;459;1;99;2.0
17;33;459;460;1;99;2.0
17;34;460;466;6;99;2.0
17;35;466;469;3;99;2.0
17;36;469;471;2;99;2.0
17;37;471;475;4;99;2.0
17;38;475;479;4;99;2.0
17;39;479;490;11;99;2.0
17;40;490;494;4;99;2.0
17;41;494;501;7;99;2.0
17;42;501;505;4;99;2.0
17;43;505;508;3;99;2.0
17;44;508;510;2;99;2.0
17;45;510;519;9;99;2.0
17;46;519;521;2;99;2.0
17;47;521;531;10;99;2.0
17;48;531;538;7;99;2.0
17;49;538;549;11;99;2.0
17;50;549;555;6;99;2.0
17;51;555;559;4;99;2.0
17;52;559;586;27;99;2.0
17;53;586;599;13;99;2.0
17;54;599;600;1;99;2.0
17;55;600;620;20;99;2.0
17;56;620;636;16;99;2.0
17;57;636;639;3;99;2.0
17;58;639;663;24;99;2.0
17;59;663;669;6;99;2.0
17;60;669;688;19;99;2.0
17;61;688;706;18;99;2.0
17;62;706;720;14;99;2.0
17;63;720;724;4;99;2.0
17;64;724;734;10;99;2.0
17;65;734;740;6;99;2.0
17;66;740;753;13;99;2.0
17;67;753;756;3;99;2.0
17;68;756;766;10;99;2.0
17;69;766;772;6;99;2.0
17;70;772;784;12;99;2.0
17;71;784;801;17;99;2.0
17;72;801;804;3;99;2.0
17;73;804;825;21;99;2.0
17;74;825;826;1;99;2.0
17;75;826;828;2;99;2.0
17;76;828;839;11;99;2.0
17;77;839;842;3;99;2.0
17;78;842;846;4;99;2.0
17;79;846;851;5;99;2.0
17;80;851;859;8;99;2.0
17;81;859;871;12;99;2.0
17;82;871;874;3;99;2.0
17;83;874;878;4;99;2.0
17;84;878;886;8;99;2.0
17;85;886;889;3;99;2.0
17;86;889;890;1;99;2.0
17;87;890;894;4;99;2.0
17;88;894;897;3;99;2.0
17;89;897;906;9;99;2.0
17;90;906;909;3;99;2.0
17;91;909;919;10;99;2.0
17;92;919;921;2;99;2.0
17;93;921;922;1;99;2.0
17;94;922;925;3;99;2.0
17;95;925;936;11;99;2.0
17;96;936;938;2;99;2.0
17;97;938;944;6;99;2.0
17;98;944;946;2;99;2.0
17;99;946;950;4;99;2.0
17;100;950;952;2;99;2.0
17;101;952;954;2;99;2.0
17;102;954;961;7;99;2.0
17;103;961;964;3;99;2.0
17;104;964;966;2;99;2.0
17;105;966;979;13;99;2.0
17;106;979;981;2;99;2.0
17;107;981;982;1;99;2.0
17;108;982;984;2;99;2.0
17;109;984;987;3;99;2.0
17;110;987;999;12;99;2.0
17;111;999;1001;2;99;2.0
17;112;1001;1010;9;99;2.0
17;113;1010;1012;2;99;2.0
17;114;1012;1026;14;99;2.0
17;115;1026;1028;2;99;2.0
17;116;1028;1031;3;99;2.0
17;117;1031;1039;8;99;2.0
17;118;1039;1042;3;99;2.0
17;119;1042;1049;7;99;2.0
17;120;1049;1051;2;99;2.0
17;121;1051;1070;19;99;2.0
17;122;1070;1071;1;99;2.0
17;123;1071;1072;1;99;2.0
17;124;1072;1074;2;99;2.0
17;125;1074;1083;9;99;2.0
17;126;1083;1089;6;99;2.0
17;127;1089;1090;1;99;2.0
17;128;1090;1091;1;99;2.0
17;129;1091;1100;9;99;2.0
17;130;1100;1104;4;99;2.0
17;131;1104;1107;3;99;2.0
17;132;1107;1132;25;99;2.0
17;133;1132;1150;18;99;2.0
17;134;1150;1154;4;99;2.0
17;135;1154;1177;23;99;2.0
17;136;1177;1183;6;99;2.0
17;137;1183;1210;27;99;2.0
17;138;1210;1220;10;99;2.0
17;139;1220;1227;7;99;2.0
17;140;1227;1230;3;99;2.0
17;141;1230;1270;40;99;2.0
17;142;1270;1274;4;99;2.0
17;143;1274;1287;13;99;2.0
17;144;1287;1288;1;99;2.0
17;145;1288;1320;32;99;2.0
17;146;1320;1330;10;99;2.0
17;147;1330;1344;14;99;2.0
17;148;1344;1351;7;99;2.0
17;149;1351;1384;33;99;2.0
17;150;1384;1392;8;99;2.0
17;151;1392;1394;2;99;2.0
17;152;1394;1401;7;99;2.0
17;153;1401;1416;15;99;2.0
17;154;1416;1431;15;99;2.0
17;155;1431;1446;15;99;2.0
17;156;1446;1461;15;99;2.0
17;157;1461;1476;15;99;2.0
17;158;1476;1491;15;99;2.0
17;159;1491;1506;15;99;2.0
17;160;1506;1521;15;99;2.0
17;161;1521;1536;15;99;2.0
17;162;1536;1551;15;99;2.0
17;163;1551;1566;15;99;2.0
17;164;1566;1581;15;99;2.0
17;165;1581;1596;15;99;2.0
17;166;1596;1611;15;99;2.0
17;167;1611;1626;15;99;2.0
17;168;1626;1641;15;99;2.0
17;169;1641;1656;15;99;2.0
17;170;1656;1680;24;99;2.0
18;0;246;335;89;501;2.0
18;1;335;337;2;501;2.0
18;2;337;339;2;501;2.0
18;3;339;342;3;501;2.0
18;4;342;350;8;501;2.0
18;5;350;354;4;501;2.0
18;6;354;357;3;501;2.0
18;7;357;359;2;501;2.0
18;8;359;362;3;501;2.0
18;9;362;365;3;501;2.0
18;10;365;367;2;501;2.0
18;11;367;377;10;501;2.0
18;12;377;378;1;501;2.0
18;13;378;385;7;501;2.0
18;14;385;387;2;501;2.0
18;15;387;388;1;501;2.0
18;16;388;394;6;501;2.0
18;17;394;397;3;501;2.0
18;18;397;400;3;501;2.0
18;19;400;409;9;501;2.0
18;20;409;412;3;501;2.0
18;21;412;417;5;501;2.0
18;22;417;420;3;501;2.0
18;23;420;421;1;501;2.0
18;24;421;426;5;501;2.0
18;25;426;427;1;501;2.0
18;26;427;432;5;501;2.0
18;27;432;435;3;501;2.0
18;28;435;447;12;501;2.0
18;29;447;454;7;501;2.0
18;30;454;455;1;501;2.0
18;31;455;456;1;501;2.0
18;32;456;457;1;501;2.0
18;33;457;459;2;501;2.0
18;34;459;466;7;501;2.0
18;35;466;467;1;501;2.0
18;36;467;469;2;501;2.0
18;37;469;476;7;501;2.0
18;38;476;482;6;501;2.0
18;39;482;484;2;501;2.0
18;40;484;502;18;501;2.0
18;41;502;505;3;501;2.0
18;42;505;507;2;501;2.0
18;43;507;516;9;501;2.0
18;44;516;518;2;501;2.0
18;45;518;532;14;501;2.0
18;46;532;535;3;501;2.0
18;47;535;546;11;501;2.0
18;48;546;547;1;501;2.0
18;49;547;552;5;501;2.0
18;50;552;587;35;501;2.0
18;51;587;593;6;501;2.0
18;52;593;596;3;501;2.0
18;53;596;600;4;501;2.0
18;54;600;624;24;501;2.0
18;55;624;627;3;501;2.0
18;56;627;633;6;501;2.0
18;57;633;637;4;501;2.0
18;58;637;660;23;501;2.0
18;59;660;663;3;501;2.0
18;60;663;685;22;501;2.0
18;61;685;707;22;501;2.0
18;62;707;720;13;501;2.0
18;63;720;721;1;501;2.0
18;64;721;728;7;501;2.0
18;65;728;744;16;501;2.0
18;66;744;750;6;501;2.0
18;67;750;753;3;501;2.0
18;68;753;760;7;501;2.0
18;69;760;767;7;501;2.0
18;70;767;781;14;501;2.0
18;71;781;798;17;501;2.0
18;72;798;802;4;501;2.0
18;73;802;825;23;501;2.0
18;74;825;827;2;501;2.0
18;75;827;830;3;501;2.0
18;76;830;836;6;501;2.0
18;77;836;840;4;501;2.0
18;78;840;852;12;501;2.0
18;79;852;853;1;501;2.0
18;80;853;868;15;501;2.0
18;81;868;872;4;501;2.0
18;82;872;875;3;501;2.0
18;83;875;877;2;501;2.0
18;84;877;883;6;501;2.0
18;85;883;885;2;501;2.0
18;86;885;887;2;501;2.0
18;87;887;890;3;501;2.0
18;88;890;891;1;501;2.0
18;89;891;903;12;501;2.0
18;90;903;906;3;501;2.0
18;91;906;907;1;501;2.0
18;92;907;910;3;501;2.0
18;93;910;913;3;501;2.0
18;94;913;922;9;501;2.0
18;95;922;929;7;501;2.0
18;96;929;933;4;501;2.0
18;97;933;935;2;501;2.0
18;98;935;940;5;501;2.0
18;99;940;941;1;501;2.0
18;100;941;947;6;501;2.0
18;101;947;948;1;501;2.0
18;102;948;950;2;501;2.0
18;103;950;961;11;501;2.0
18;104;961;962;1;501;2.0
18;105;962;963;1;501;2.0
18;106;963;970;7;501;2.0
18;107;970;973;3;501;2.0
18;108;973;981;8;501;2.0
18;109;981;982;1;501;2.0
18;110;982;984;2;501;2.0
18;111;984;996;12;501;2.0
18;112;996;1000;4;501;2.0
18;113;1000;1002;2;501;2.0
18;114;1002;1010;8;501;2.0
18;115;1010;1023;13;501;2.0
18;116;1023;1025;2;501;2.0
18;117;1025;1030;5;501;2.0
18;118;1030;1032;2;501;2.0
18;119;1032;1033;1;501;2.0
18;120;1033;1046;13;501;2.0
18;121;1046;1052;6;501;2.0
18;122;1052;1060;8;501;2.0
18;123;1060;1068;8;501;2.0
18;124;1068;1070;2;501;2.0
18;125;1070;1072;2;501;2.0
18;126;1072;1080;8;501;2.0
18;127;1080;1086;6;501;2.0
18;128;1086;1092;6;501;2.0
18;129;1092;1094;2;501;2.0
18;130;1094;1097;3;501;2.0
18;131;1097;1101;4;501;2.0
18;132;1101;1104;3;501;2.0
18;133;1104;1120;16;501;2.0
18;134;1120;1151;31;501;2.0
18;135;1151;1154;3;501;2.0
18;136;1154;1174;20;501;2.0
18;137;1174;1180;6;501;2.0
18;138;1180;1211;31;501;2.0
18;139;1211;1224;13;501;2.0
18;140;1224;1227;3;501;2.0
18;141;1227;1271;44;501;2.0
18;142;1271;1274;3;501;2.0
18;143;1274;1284;10;501;2.0
18;144;1284;1285;1;501;2.0
18;145;1285;1321;36;501;2.0
18;146;1321;1324;3;501;2.0
18;147;1324;1341;17;501;2.0
18;148;1341;1348;7;501;2.0
18;149;1348;1385;37;501;2.0
18;150;1385;1389;4;501;2.0
18;151;1389;1394;5;501;2.0
18;152;1394;1398;4;501;2.0
18;153;1398;1413;15;501;2.0
18;154;1413;1428;15;501;2.0
18;155;1428;1443;15;501;2.0
18;156;1443;1458;15;501;2.0
18;157;1458;1473;15;501;2.0
18;158;1473;1488;15;501;2.0
18;159;1488;1503;15;501;2.0
18;160;1503;1518;15;501;2.0
18;161;1518;1533;15;501;2.0
18;162;1533;1548;15;501;2.0
18;163;1548;1563;15;501;2.0
18;164;1563;1578;15;501;2.0
18;165;1578;1593;15;501;2.0
18;166;1593;1608;15;501;2.0
18;167;1608;1623;15;501;2.0
18;168;1623;1638;15;501;2.0
18;169;1638;1653;15;501;2.0
18;170;1653;1668;15;501;2.0
18;171;1668;1680;12;501;2.0
19;0;250;341;91;66;2.0
19;1;341;342;1;66;2.0
19;2;342;345;3;66;2.0
19;3;345;347;2;66;2.0
19;4;347;357;10;66;2.0
19;5;357;362;5;66;2.0
19;6;362;365;3;66;2.0
19;7;365;367;2;66;2.0
19;8;367;372;5;66;2.0
19;9;372;380;8;66;2.0
19;10;380;385;5;66;2.0
19;11;385;392;7;66;2.0
19;12;392;394;2;66;2.0
19;13;394;400;6;66;2.0
19;14;400;402;2;66;2.0
19;15;402;407;5;66;2.0
19;16;407;415;8;66;2.0
19;17;415;417;2;66;2.0
19;18;417;422;5;66;2.0
19;19;422;427;5;66;2.0
19;20;427;428;1;66;2.0
19;21;428;432;4;66;2.0
19;22;432;434;2;66;2.0
19;23;434;435;1;66;2.0
19;24;435;442;7;66;2.0
19;25;442;450;8;66;2.0
19;26;450;452;2;66;2.0
19;27;452;460;8;66;2.0
19;28;460;462;2;66;2.0
19;29;462;463;1;66;2.0
19;30;463;464;1;66;2.0
19;31;464;470;6;66;2.0
19;32;470;473;3;66;2.0
19;33;473;477;4;66;2.0
19;34;477;483;6;66;2.0
19;35;483;487;4;66;2.0
19;36;487;492;5;66;2.0
19;37;492;505;13;66;2.0
19;38;505;511;6;66;2.0
19;39;511;512;1;66;2.0
19;40;512;514;2;66;2.0
19;41;514;523;9;66;2.0
19;42;523;524;1;66;2.0
19;43;524;535;11;66;2.0
19;44;535;542;7;66;2.0
19;45;542;552;10;66;2.0
19;46;552;553;1;66;2.0
19;47;553;559;6;66;2.0
19;48;559;590;31;66;2.0
19;49;590;601;11;66;2.0
19;50;601;603;2;66;2.0
19;51;603;607;4;66;2.0
19;52;607;628;21;66;2.0
19;53;628;632;4;66;2.0
19;54;632;639;7;66;2.0
19;55;639;640;1;66;2.0
19;56;640;667;27;66;2.0
19;57;667;671;4;66;2.0
19;58;671;691;20;66;2.0
19;59;691;710;19;66;2.0
19;60;710;727;17;66;2.0
19;61;727;728;1;66;2.0
19;62;728;736;8;66;2.0
19;63;736;748;12;66;2.0
19;64;748;757;9;66;2.0
19;65;757;759;2;66;2.0
19;66;759;765;6;66;2.0
19;67;765;770;5;66;2.0
19;68;770;788;18;66;2.0
19;69;788;805;17;66;2.0
19;70;805;806;1;66;2.0
19;71;806;830;24;66;2.0
19;72;830;832;2;66;2.0
19;73;832;835;3;66;2.0
19;74;835;842;7;66;2.0
19;75;842;843;1;66;2.0
19;76;843;848;5;66;2.0
19;77;848;855;7;66;2.0
19;78;855;861;6;66;2.0
19;79;861;875;14;66;2.0
19;80;875;876;1;66;2.0
19;81;876;882;6;66;2.0
19;82;882;890;8;66;2.0
19;83;890;891;1;66;2.0
19;84;891;897;6;66;2.0
19;85;897;898;1;66;2.0
19;86;898;909;11;66;2.0
19;87;909;910;1;66;2.0
19;88;910;913;3;66;2.0
19;89;913;915;2;66;2.0
19;90;915;921;6;66;2.0
19;91;921;925;4;66;2.0
19;92;925;933;8;66;2.0
19;93;933;939;6;66;2.0
19;94;939;942;3;66;2.0
19;95;942;945;3;66;2.0
19;96;945;948;3;66;2.0
19;97;948;950;2;66;2.0
19;98;950;956;6;66;2.0
19;99;956;957;1;66;2.0
19;100;957;965;8;66;2.0
19;101;965;968;3;66;2.0
19;102;968;969;1;66;2.0
19;103;969;975;6;66;2.0
19;104;975;981;6;66;2.0
19;105;981;985;4;66;2.0
19;106;985;988;3;66;2.0
19;107;988;990;2;66;2.0
19;108;990;1003;13;66;2.0
19;109;1003;1005;2;66;2.0
19;110;1005;1017;12;66;2.0
19;111;1017;1029;12;66;2.0
19;112;1029;1032;3;66;2.0
19;113;1032;1035;3;66;2.0
19;114;1035;1041;6;66;2.0
19;115;1041;1053;12;66;2.0
19;116;1053;1055;2;66;2.0
19;117;1055;1065;10;66;2.0
19;118;1065;1075;10;66;2.0
19;119;1075;1076;1;66;2.0
19;120;1076;1077;1;66;2.0
19;121;1077;1087;10;66;2.0
19;122;1087;1093;6;66;2.0
19;123;1093;1095;2;66;2.0
19;124;1095;1098;3;66;2.0
19;125;1098;1103;5;66;2.0
19;126;1103;1108;5;66;2.0
19;127;1108;1110;2;66;2.0
19;128;1110;1111;1;66;2.0
19;129;1111;1125;14;66;2.0
19;130;1125;1154;29;66;2.0
19;131;1154;1161;7;66;2.0
19;132;1161;1181;20;66;2.0
19;133;1181;1186;5;66;2.0
19;134;1186;1214;28;66;2.0
19;135;1214;1228;14;66;2.0
19;136;1228;1231;3;66;2.0
19;137;1231;1233;2;66;2.0
19;138;1233;1274;41;66;2.0
19;139;1274;1281;7;66;2.0
19;140;1281;1291;10;66;2.0
19;141;1291;1324;33;66;2.0
19;142;1324;1332;8;66;2.0
19;143;1332;1348;16;66;2.0
19;144;1348;1354;6;66;2.0
19;145;1354;1388;34;66;2.0
19;146;1388;1396;8;66;2.0
19;147;1396;1401;5;66;2.0
19;148;1401;1404;3;66;2.0
19;149;1404;1419;15;66;2.0
19;150;1419;1434;15;66;2.0
19;151;1434;1449;15;66;2.0
19;152;1449;1464;15;66;2.0
19;153;1464;1479;15;66;2.0
19;154;1479;1494;15;66;2.0
19;155;1494;1509;15;66;2.0
19;156;1509;1524;15;66;2.0
19;157;1524;1539;15;66;2.0
19;158;1539;1554;15;66;2.0
19;159;1554;1569;15;66;2.0
19;160;1569;1584;15;66;2.0
19;161;1584;1599;15;66;2.0
19;162;1599;1614;15;66;2.0
19;163;1614;1629;15;66;2.0
19;164;1629;1644;15;66;2.0
19;165;1644;1659;15;66;2.0
19;166;1659;1680;21;66;2.0
20;0;252;343;91;63;2.0
20;1;343;344;1;63;2.0
20;2;344;347;3;63;2.0
20;3;347;349;2;63;2.0
20;4;349;359;10;63;2.0
20;5;359;364;5;63;2.0
20;6;364;367;3;63;2.0
20;7;367;369;2;63;2.0
20;8;369;374;5;63;2.0
20;9;374;382;8;63;2.0
20;10;382;387;5;63;2.0
20;11;387;394;7;63;2.0
20;12;394;396;2;63;2.0
20;13;396;402;6;63;2.0
20;14;402;404;2;63;2.0
20;15;404;409;5;63;2.0
20;16;409;417;8;63;2.0
20;17;417;419;2;63;2.0
20;18;419;424;5;63;2.0
20;19;424;429;5;63;2.0
20;20;429;430;1;63;2.0
20;21;430;434;4;63;2.0
20;22;434;436;2;63;2.0
20;23;436;437;1;63;2.0
20;24;437;444;7;63;2.0
20;25;444;452;8;63;2.0
20;26;452;454;2;63;2.0
20;27;454;462;8;63;2.0
20;28;462;464;2;63;2.0
20;29;464;465;1;63;2.0
20;30;465;466;1;63;2.0
20;31;466;472;6;63;2.0
20;32;472;475;3;63;2.0
20;33;475;479;4;63;2.0
20;34;479;485;6;63;2.0
20;35;485;489;4;63;2.0
20;36;489;494;5;63;2.0
20;37;494;507;13;63;2.0
20;38;507;513;6;63;2.0
20;39;513;514;1;63;2.0
20;40;514;516;2;63;2.0
20;41;516;525;9;63;2.0
20;42;525;526;1;63;2.0
20;43;526;537;11;63;2.0
20;44;537;544;7;63;2.0
20;45;544;554;10;63;2.0
20;46;554;555;1;63;2.0
20;47;555;561;6;63;2.0
20;48;561;592;31;63;2.0
20;49;592;603;11;63;2.0
20;50;603;605;2;63;2.0
20;51;605;609;4;63;2.0
20;52;609;630;21;63;2.0
20;53;630;634;4;63;2.0
20;54;634;641;7;63;2.0
20;55;641;642;1;63;2.0
20;56;642;669;27;63;2.0
20;57;669;673;4;63;2.0
20;58;673;693;20;63;2.0
20;59;693;712;19;63;2.0
20;60;712;729;17;63;2.0
20;61;729;730;1;63;2.0
20;62;730;738;8;63;2.0
20;63;738;750;12;63;2.0
20;64;750;759;9;63;2.0
20;65;759;761;2;63;2.0
20;66;761;767;6;63;2.0
20;67;767;772;5;63;2.0
20;68;772;790;18;63;2.0
20;69;790;807;17;63;2.0
20;70;807;808;1;63;2.0
20;71;808;832;24;63;2.0
20;72;832;834;2;63;2.0
20;73;834;837;3;63;2.0
20;74;837;844;7;63;2.0
20;75;844;845;1;63;2.0
20;76;845;850;5;63;2.0
20;77;850;857;7;63;2.0
20;78;857;863;6;63;2.0
20;79;863;877;14;63;2.0
20;80;877;878;1;63;2.0
20;81;878;884;6;63;2.0
20;82;884;892;8;63;2.0
20;83;892;893;1;63;2.0
20;84;893;899;6;63;2.0
20;85;899;900;1;63;2.0
20;86;900;911;11;63;2.0
20;87;911;912;1;63;2.0
20;88;912;915;3;63;2.0
20;89;915;917;2;63;2.0
20;90;917;923;6;63;2.0
20;91;923;927;4;63;2.0
20;92;927;935;8;63;2.0
20;93;935;941;6;63;2.0
20;94;941;944;3;63;2.0
20;95;944;947;3;63;2.0
20;96;947;950;3;63;2.0
20;97;950;952;2;63;2.0
20;98;952;958;6;63;2.0
20;99;958;959;1;63;2.0
20;100;959;967;8;63;2.0
20;101;967;970;3;63;2.0
20;102;970;971;1;63;2.0
20;103;971;977;6;63;2.0
20;104;977;983;6;63;2.0
20;105;983;987;4;63;2.0
20;106;987;990;3;63;2.0
20;107;990;992;2;63;2.0
20;108;992;1005;13;63;2.0
20;109;1005;1007;2;63;2.0
20;110;1007;1019;12;63;2.0
20;111;1019;1031;12;63;2.0
20;112;1031;1034;3;63;2.0
20;113;1034;1037;3;63;2.0
20;114;1037;1043;6;63;2.0
20;115;1043;1055;12;63;2.0
20;116;1055;1057;2;63;2.0
20;117;1057;1067;10;63;2.0
20;118;1067;1077;10;63;2.0
20;119;1077;1078;1;63;2.0
20;120;1078;1079;1;63;2.0
20;121;1079;1089;10;63;2.0
20;122;1089;1095;6;63;2.0
20;123;1095;1097;2;63;2.0
20;124;1097;1100;3;63;2.0
20;125;1100;1105;5;63;2.0
20;126;1105;1110;5;63;2.0
20;127;1110;1112;2;63;2.0
20;128;1112;1113;1;63;2.0
20;129;1113;1127;14;63;2.0
20;130;1127;1156;29;63;2.0
20;131;1156;1163;7;63;2.0
20;132;1163;1183;20;63;2.0
20;133;1183;1188;5;63;2.0
20;134;1188;1216;28;63;2.0
20;135;1216;1230;14;63;2.0
20;136;1230;1233;3;63;2.0
20;137;1233;1235;2;63;2.0
20;138;1235;1276;41;63;2.0
20;139;1276;1283;7;63;2.0
20;140;1283;1293;10;63;2.0
20;141;1293;1326;33;63;2.0
20;142;1326;1334;8;63;2.0
20;143;1334;1350;16;63;2.0
20;144;1350;1356;6;63;2.0
20;145;1356;1390;34;63;2.0
20;146;1390;1398;8;63;2.0
20;147;1398;1403;5;63;2.0
20;148;1403;1406;3;63;2.0
20;149;1406;1421;15;63;2.0
20;150;1421;1436;15;63;2.0
20;151;1436;1451;15;63;2.0
20;152;1451;1466;15;63;2.0
20;153;1466;1481;15;63;2.0
20;154;1481;1496;15;63;2.0
20;155;1496;1511;15;63;2.0
20;156;1511;1526;15;63;2.0
20;157;1526;1541;15;63;2.0
20;158;1541;1556;15;63;2.0
20;159;1556;1571;15;63;2.0
20;160;1571;1586;15;63;2.0
20;161;1586;1601;15;63;2.0
20;162;1601;1616;15;63;2.0
20;163;1616;1631;15;63;2.0
20;164;1631;1646;15;63;2.0
20;165;1646;1661;15;63;2.0
20;166;1661;1680;19;63;2.0
21;0;249;329;80;114;2.0
21;1;329;335;6;114;2.0
21;2;335;338;3;114;2.0
21;3;338;342;4;114;2.0
21;4;342;344;2;114;2.0
21;5;344;353;9;114;2.0
21;6;353;358;5;114;2.0
21;7;358;359;1;114;2.0
21;8;359;362;3;114;2.0
21;9;362;364;2;114;2.0
21;10;364;373;9;114;2.0
21;11;373;374;1;114;2.0
21;12;374;377;3;114;2.0
21;13;377;379;2;114;2.0
21;14;379;389;10;114;2.0
21;15;389;393;4;114;2.0
21;16;393;394;1;114;2.0
21;17;394;397;3;114;2.0
21;18;397;408;11;114;2.0
21;19;408;412;4;114;2.0
21;20;412;414;2;114;2.0
21;21;414;421;7;114;2.0
21;22;421;424;3;114;2.0
21;23;424;425;1;114;2.0
21;24;425;430;5;114;2.0
21;25;430;432;2;114;2.0
21;26;432;434;2;114;2.0
21;27;434;447;13;114;2.0
21;28;447;449;2;114;2.0
21;29;449;453;4;114;2.0
21;30;453;454;1;114;2.0
21;31;454;456;2;114;2.0
21;32;456;457;1;114;2.0
21;33;457;466;9;114;2.0
21;34;466;467;1;114;2.0
21;35;467;468;1;114;2.0
21;36;468;476;8;114;2.0
21;37;476;483;7;114;2.0
21;38;483;489;6;114;2.0
21;39;489;500;11;114;2.0
21;40;500;502;2;114;2.0
21;41;502;506;4;114;2.0
21;42;506;507;1;114;2.0
21;43;507;516;9;114;2.0
21;44;516;519;3;114;2.0
21;45;519;529;10;114;2.0
21;46;529;532;3;114;2.0
21;47;532;546;14;114;2.0
21;48;546;552;6;114;2.0
21;49;552;554;2;114;2.0
21;50;554;587;33;114;2.0
21;51;587;592;5;114;2.0
21;52;592;595;3;114;2.0
21;53;595;596;1;114;2.0
21;54;596;622;26;114;2.0
21;55;622;634;12;114;2.0
21;56;634;637;3;114;2.0
21;57;637;654;17;114;2.0
21;58;654;662;8;114;2.0
21;59;662;686;24;114;2.0
21;60;686;707;21;114;2.0
21;61;707;715;8;114;2.0
21;62;715;721;6;114;2.0
21;63;721;727;6;114;2.0
21;64;727;742;15;114;2.0
21;65;742;744;2;114;2.0
21;66;744;754;10;114;2.0
21;67;754;767;13;114;2.0
21;68;767;781;14;114;2.0
21;69;781;797;16;114;2.0
21;70;797;802;5;114;2.0
21;71;802;819;17;114;2.0
21;72;819;820;1;114;2.0
21;73;820;827;7;114;2.0
21;74;827;836;9;114;2.0
21;75;836;837;1;114;2.0
21;76;837;839;2;114;2.0
21;77;839;852;13;114;2.0
21;78;852;867;15;114;2.0
21;79;867;869;2;114;2.0
21;80;869;872;3;114;2.0
21;81;872;882;10;114;2.0
21;82;882;884;2;114;2.0
21;83;884;885;1;114;2.0
21;84;885;887;2;114;2.0
21;85;887;891;4;114;2.0
21;86;891;892;1;114;2.0
21;87;892;904;12;114;2.0
21;88;904;906;2;114;2.0
21;89;906;907;1;114;2.0
21;90;907;912;5;114;2.0
21;91;912;917;5;114;2.0
21;92;917;922;5;114;2.0
21;93;922;927;5;114;2.0
21;94;927;929;2;114;2.0
21;95;929;934;5;114;2.0
21;96;934;941;7;114;2.0
21;97;941;945;4;114;2.0
21;98;945;947;2;114;2.0
21;99;947;961;14;114;2.0
21;100;961;962;1;114;2.0
21;101;962;964;2;114;2.0
21;102;964;972;8;114;2.0
21;103;972;977;5;114;2.0
21;104;977;981;4;114;2.0
21;105;981;982;1;114;2.0
21;106;982;985;3;114;2.0
21;107;985;996;11;114;2.0
21;108;996;1002;6;114;2.0
21;109;1002;1005;3;114;2.0
21;110;1005;1007;2;114;2.0
21;111;1007;1019;12;114;2.0
21;112;1019;1024;5;114;2.0
21;113;1024;1032;8;114;2.0
21;114;1032;1037;5;114;2.0
21;115;1037;1046;9;114;2.0
21;116;1046;1052;6;114;2.0
21;117;1052;1065;13;114;2.0
21;118;1065;1067;2;114;2.0
21;119;1067;1072;5;114;2.0
21;120;1072;1074;2;114;2.0
21;121;1074;1086;12;114;2.0
21;122;1086;1092;6;114;2.0
21;123;1092;1098;6;114;2.0
21;124;1098;1101;3;114;2.0
21;125;1101;1104;3;114;2.0
21;126;1104;1105;1;114;2.0
21;127;1105;1127;22;114;2.0
21;128;1127;1149;22;114;2.0
21;129;1149;1151;2;114;2.0
21;130;1151;1174;23;114;2.0
21;131;1174;1181;7;114;2.0
21;132;1181;1211;30;114;2.0
21;133;1211;1222;11;114;2.0
21;134;1222;1224;2;114;2.0
21;135;1224;1228;4;114;2.0
21;136;1228;1269;41;114;2.0
21;137;1269;1271;2;114;2.0
21;138;1271;1284;13;114;2.0
21;139;1284;1286;2;114;2.0
21;140;1286;1321;35;114;2.0
21;141;1321;1323;2;114;2.0
21;142;1323;1335;12;114;2.0
21;143;1335;1349;14;114;2.0
21;144;1349;1385;36;114;2.0
21;145;1385;1389;4;114;2.0
21;146;1389;1399;10;114;2.0
21;147;1399;1414;15;114;2.0
21;148;1414;1429;15;114;2.0
21;149;1429;1444;15;114;2.0
21;150;1444;1459;15;114;2.0
21;151;1459;1474;15;114;2.0
21;152;1474;1489;15;114;2.0
21;153;1489;1504;15;114;2.0
21;154;1504;1519;15;114;2.0
21;155;1519;1534;15;114;2.0
21;156;1534;1549;15;114;2.0
21;157;1549;1564;15;114;2.0
21;158;1564;1579;15;114;2.0
21;159;1579;1594;15;114;2.0
21;160;1594;1609;15;114;2.0
21;161;1609;1624;15;114;2.0
21;162;1624;1639;15;114;2.0
21;163;1639;1654;15;114;2.0
21;164;1654;1669;15;114;2.0
21;165;1669;1680;11;114;2.0
22;0;243;332;89;42;2.0
22;1;332;333;1;42;2.0
22;2;333;339;6;42;2.0
22;3;339;348;9;42;2.0
22;4;348;354;6;42;2.0
22;5;354;359;5;42;2.0
22;6;359;361;2;42;2.0
22;7;361;363;2;42;2.0
22;8;363;371;8;42;2.0
22;9;371;374;3;42;2.0
22;10;374;383;9;42;2.0
22;11;383;391;8;42;2.0
22;12;391;394;3;42;2.0
22;13;394;398;4;42;2.0
22;14;398;409;11;42;2.0
22;15;409;417;8;42;2.0
22;16;417;418;1;42;2.0
22;17;418;421;3;42;2.0
22;18;421;426;5;42;2.0
22;19;426;429;3;42;2.0
22;20;429;431;2;42;2.0
22;21;431;444;13;42;2.0
22;22;444;451;7;42;2.0
22;23;451;452;1;42;2.0
22;24;452;453;1;42;2.0
22;25;453;454;1;42;2.0
22;26;454;462;8;42;2.0
22;27;462;463;1;42;2.0
22;28;463;464;1;42;2.0
22;29;464;469;5;42;2.0
22;30;469;472;3;42;2.0
22;31;472;484;12;42;2.0
22;32;484;486;2;42;2.0
22;33;486;499;13;42;2.0
22;34;499;500;1;42;2.0
22;35;500;501;1;42;2.0
22;36;501;503;2;42;2.0
22;37;503;512;9;42;2.0
22;38;512;513;1;42;2.0
22;39;513;529;16;42;2.0
22;40;529;533;4;42;2.0
22;41;533;542;9;42;2.0
22;42;542;548;6;42;2.0
22;43;548;551;3;42;2.0
22;44;551;584;33;42;2.0
22;45;584;592;8;42;2.0
22;46;592;593;1;42;2.0
22;47;593;596;3;42;2.0
22;48;596;619;23;42;2.0
22;49;619;628;9;42;2.0
22;50;628;631;3;42;2.0
22;51;631;634;3;42;2.0
22;52;634;658;24;42;2.0
22;53;658;663;5;42;2.0
22;54;663;680;17;42;2.0
22;55;680;704;24;42;2.0
22;56;704;716;12;42;2.0
22;57;716;717;1;42;2.0
22;58;717;728;11;42;2.0
22;59;728;739;11;42;2.0
22;60;739;748;9;42;2.0
22;61;748;764;16;42;2.0
22;62;764;777;13;42;2.0
22;63;777;798;21;42;2.0
22;64;798;799;1;42;2.0
22;65;799;821;22;42;2.0
22;66;821;823;2;42;2.0
22;67;823;824;1;42;2.0
22;68;824;831;7;42;2.0
22;69;831;832;1;42;2.0
22;70;832;834;2;42;2.0
22;71;834;840;6;42;2.0
22;72;840;849;9;42;2.0
22;73;849;853;4;42;2.0
22;74;853;868;15;42;2.0
22;75;868;869;1;42;2.0
22;76;869;873;4;42;2.0
22;77;873;881;8;42;2.0
22;78;881;883;2;42;2.0
22;79;883;884;1;42;2.0
22;80;884;886;2;42;2.0
22;81;886;887;1;42;2.0
22;82;887;889;2;42;2.0
22;83;889;898;9;42;2.0
22;84;898;902;4;42;2.0
22;85;902;904;2;42;2.0
22;86;904;913;9;42;2.0
22;87;913;914;1;42;2.0
22;88;914;919;5;42;2.0
22;89;919;924;5;42;2.0
22;90;924;928;4;42;2.0
22;91;928;933;5;42;2.0
22;92;933;937;4;42;2.0
22;93;937;944;7;42;2.0
22;94;944;946;2;42;2.0
22;95;946;948;2;42;2.0
22;96;948;957;9;42;2.0
22;97;957;958;1;42;2.0
22;98;958;959;1;42;2.0
22;99;959;973;14;42;2.0
22;100;973;974;1;42;2.0
22;101;974;977;3;42;2.0
22;102;977;979;2;42;2.0
22;103;979;992;13;42;2.0
22;104;992;999;7;42;2.0
22;105;999;1004;5;42;2.0
22;106;1004;1006;2;42;2.0
22;107;1006;1018;12;42;2.0
22;108;1018;1023;5;42;2.0
22;109;1023;1029;6;42;2.0
22;110;1029;1033;4;42;2.0
22;111;1033;1034;1;42;2.0
22;112;1034;1042;8;42;2.0
22;113;1042;1049;7;42;2.0
22;114;1049;1064;15;42;2.0
22;115;1064;1066;2;42;2.0
22;116;1066;1068;2;42;2.0
22;117;1068;1069;1;42;2.0
22;118;1069;1078;9;42;2.0
22;119;1078;1082;4;42;2.0
22;120;1082;1089;7;42;2.0
22;121;1089;1092;3;42;2.0
22;122;1092;1097;5;42;2.0
22;123;1097;1099;2;42;2.0
22;124;1099;1100;1;42;2.0
22;125;1100;1124;24;42;2.0
22;126;1124;1148;24;42;2.0
22;127;1148;1150;2;42;2.0
22;128;1150;1170;20;42;2.0
22;129;1170;1175;5;42;2.0
22;130;1175;1208;33;42;2.0
22;131;1208;1219;11;42;2.0
22;132;1219;1220;1;42;2.0
22;133;1220;1222;2;42;2.0
22;134;1222;1268;46;42;2.0
22;135;1268;1270;2;42;2.0
22;136;1270;1280;10;42;2.0
22;137;1280;1318;38;42;2.0
22;138;1318;1324;6;42;2.0
22;139;1324;1339;15;42;2.0
22;140;1339;1343;4;42;2.0
22;141;1343;1382;39;42;2.0
22;142;1382;1385;3;42;2.0
22;143;1385;1390;5;42;2.0
22;144;1390;1393;3;42;2.0
22;145;1393;1408;15;42;2.0
22;146;1408;1423;15;42;2.0
22;147;1423;1438;15;42;2.0
22;148;1438;1453;15;42;2.0
22;149;1453;1468;15;42;2.0
22;150;1468;1483;15;42;2.0
22;151;1483;1498;15;42;2.0
22;152;1498;1513;15;42;2.0
22;153;1513;1528;15;42;2.0
22;154;1528;1543;15;42;2.0
22;155;1543;1558;15;42;2.0
22;156;1558;1573;15;42;2.0
22;157;1573;1588;15;42;2.0
22;158;1588;1603;15;42;2.0
22;159;1603;1618;15;42;2.0
22;160;1618;1633;15;42;2.0
22;161;1633;1648;15;42;2.0
22;162;1648;1663;15;42;2.0
22;163;1663;1680;17;42;2.0
23;0;245;332;87;25;2.0
23;1;332;338;6;25;2.0
23;2;338;339;1;25;2.0
23;3;339;347;8;25;2.0
23;4;347;353;6;25;2.0
23;5;353;358;5;25;2.0
23;6;358;359;1;25;2.0
23;7;359;361;2;25;2.0
23;8;361;362;1;25;2.0
23;9;362;371;9;25;2.0
23;10;371;374;3;25;2.0
23;11;374;382;8;25;2.0
23;12;382;384;2;25;2.0
23;13;384;391;7;25;2.0
23;14;391;393;2;25;2.0
23;15;393;394;1;25;2.0
23;16;394;397;3;25;2.0
23;17;397;408;11;25;2.0
23;18;408;409;1;25;2.0
23;19;409;416;7;25;2.0
23;20;416;417;1;25;2.0
23;21;417;421;4;25;2.0
23;22;421;425;4;25;2.0
23;23;425;429;4;25;2.0
23;24;429;431;2;25;2.0
23;25;431;444;13;25;2.0
23;26;444;451;7;25;2.0
23;27;451;452;1;25;2.0
23;28;452;453;1;25;2.0
23;29;453;454;1;25;2.0
23;30;454;461;7;25;2.0
23;31;461;463;2;25;2.0
23;32;463;464;1;25;2.0
23;33;464;468;4;25;2.0
23;34;468;471;3;25;2.0
23;35;471;483;12;25;2.0
23;36;483;486;3;25;2.0
23;37;486;499;13;25;2.0
23;38;499;501;2;25;2.0
23;39;501;502;1;25;2.0
23;40;502;511;9;25;2.0
23;41;511;514;3;25;2.0
23;42;514;529;15;25;2.0
23;43;529;532;3;25;2.0
23;44;532;541;9;25;2.0
23;45;541;547;6;25;2.0
23;46;547;551;4;25;2.0
23;47;551;584;33;25;2.0
23;48;584;591;7;25;2.0
23;49;591;592;1;25;2.0
23;50;592;596;4;25;2.0
23;51;596;619;23;25;2.0
23;52;619;629;10;25;2.0
23;53;629;631;2;25;2.0
23;54;631;634;3;25;2.0
23;55;634;657;23;25;2.0
23;56;657;662;5;25;2.0
23;57;662;681;19;25;2.0
23;58;681;704;23;25;2.0
23;59;704;716;12;25;2.0
23;60;716;727;11;25;2.0
23;61;727;739;12;25;2.0
23;62;739;747;8;25;2.0
23;63;747;749;2;25;2.0
23;64;749;764;15;25;2.0
23;65;764;776;12;25;2.0
23;66;776;797;21;25;2.0
23;67;797;799;2;25;2.0
23;68;799;821;22;25;2.0
23;69;821;822;1;25;2.0
23;70;822;824;2;25;2.0
23;71;824;831;7;25;2.0
23;72;831;832;1;25;2.0
23;73;832;834;2;25;2.0
23;74;834;839;5;25;2.0
23;75;839;849;10;25;2.0
23;76;849;852;3;25;2.0
23;77;852;867;15;25;2.0
23;78;867;869;2;25;2.0
23;79;869;872;3;25;2.0
23;80;872;881;9;25;2.0
23;81;881;882;1;25;2.0
23;82;882;884;2;25;2.0
23;83;884;886;2;25;2.0
23;84;886;889;3;25;2.0
23;85;889;899;10;25;2.0
23;86;899;901;2;25;2.0
23;87;901;904;3;25;2.0
23;88;904;912;8;25;2.0
23;89;912;914;2;25;2.0
23;90;914;919;5;25;2.0
23;91;919;924;5;25;2.0
23;92;924;929;5;25;2.0
23;93;929;932;3;25;2.0
23;94;932;936;4;25;2.0
23;95;936;944;8;25;2.0
23;96;944;946;2;25;2.0
23;97;946;947;1;25;2.0
23;98;947;956;9;25;2.0
23;99;956;959;3;25;2.0
23;100;959;972;13;25;2.0
23;101;972;974;2;25;2.0
23;102;974;976;2;25;2.0
23;103;976;979;3;25;2.0
23;104;979;980;1;25;2.0
23;105;980;991;11;25;2.0
23;106;991;999;8;25;2.0
23;107;999;1004;5;25;2.0
23;108;1004;1006;2;25;2.0
23;109;1006;1019;13;25;2.0
23;110;1019;1022;3;25;2.0
23;111;1022;1029;7;25;2.0
23;112;1029;1032;3;25;2.0
23;113;1032;1034;2;25;2.0
23;114;1034;1041;7;25;2.0
23;115;1041;1049;8;25;2.0
23;116;1049;1064;15;25;2.0
23;117;1064;1066;2;25;2.0
23;118;1066;1067;1;25;2.0
23;119;1067;1069;2;25;2.0
23;120;1069;1077;8;25;2.0
23;121;1077;1081;4;25;2.0
23;122;1081;1089;8;25;2.0
23;123;1089;1093;4;25;2.0
23;124;1093;1096;3;25;2.0
23;125;1096;1099;3;25;2.0
23;126;1099;1100;1;25;2.0
23;127;1100;1124;24;25;2.0
23;128;1124;1148;24;25;2.0
23;129;1148;1150;2;25;2.0
23;130;1150;1169;19;25;2.0
23;131;1169;1176;7;25;2.0
23;132;1176;1208;32;25;2.0
23;133;1208;1219;11;25;2.0
23;134;1219;1223;4;25;2.0
23;135;1223;1268;45;25;2.0
23;136;1268;1270;2;25;2.0
23;137;1270;1279;9;25;2.0
23;138;1279;1281;2;25;2.0
23;139;1281;1318;37;25;2.0
23;140;1318;1323;5;25;2.0
23;141;1323;1338;15;25;2.0
23;142;1338;1344;6;25;2.0
23;143;1344;1382;38;25;2.0
23;144;1382;1384;2;25;2.0
23;145;1384;1390;6;25;2.0
23;146;1390;1394;4;25;2.0
23;147;1394;1409;15;25;2.0
23;148;1409;1424;15;25;2.0
23;149;1424;1439;15;25;2.0
23;150;1439;1454;15;25;2.0
23;151;1454;1469;15;25;2.0
23;152;1469;1484;15;25;2.0
23;153;1484;1499;15;25;2.0
23;154;1499;1514;15;25;2.0
23;155;1514;1529;15;25;2.0
23;156;1529;1544;15;25;2.0
23;157;1544;1559;15;25;2.0
23;158;1559;1574;15;25;2.0
23;159;1574;1589;15;25;2.0
23;160;1589;1604;15;25;2.0
23;161;1604;1619;15;25;2.0
23;162;1619;1634;15;25;2.0
23;163;1634;1649;15;25;2.0
23;164;1649;1664;15;25;2.0
23;165;1664;1680;16;25;2.0
24;0;240;333;93;0;0.83
24;1;333;336;3;0;0.83
24;2;336;339;3;0;0.83
24;3;339;342;3;0;0.83
24;4;342;351;9;0;0.83
24;5;351;354;3;0;0.83
24;6;354;359;5;0;0.83
24;7;359;362;3;0;0.83
24;8;362;366;4;0;0.83
24;9;366;369;3;0;0.83
24;10;369;377;8;0;0.83
24;11;377;378;1;0;0.83
24;12;378;386;8;0;0.83
24;13;386;389;3;0;0.83
24;14;389;394;5;0;0.83
24;15;394;397;3;0;0.83
24;16;397;401;4;0;0.83
24;17;401;409;8;0;0.83
24;18;409;412;3;0;0.83
24;19;412;419;7;0;0.83
24;20;419;420;1;0;0.83
24;21;420;421;1;0;0.83
24;22;421;426;5;0;0.83
24;23;426;429;3;0;0.83
24;24;429;432;3;0;0.83
24;25;432;435;3;0;0.83
24;26;435;447;12;0;0.83
24;27;447;449;2;0;0.83
24;28;449;454;5;0;0.83
24;29;454;455;1;0;0.83
24;30;455;456;1;0;0.83
24;31;456;457;1;0;0.83
24;32;457;461;4;0;0.83
24;33;461;465;4;0;0.83
24;34;465;467;2;0;0.83
24;35;467;469;2;0;0.83
24;36;469;475;6;0;0.83
24;37;475;484;9;0;0.83
24;38;484;502;18;0;0.83
24;39;502;503;1;0;0.83
24;40;503;505;2;0;0.83
24;41;505;506;1;0;0.83
24;42;506;515;9;0;0.83
24;43;515;516;1;0;0.83
24;44;516;532;16;0;0.83
24;45;532;536;4;0;0.83
24;46;536;545;9;0;0.83
24;47;545;549;4;0;0.83
24;48;549;551;2;0;0.83
24;49;551;587;36;0;0.83
24;50;587;593;6;0;0.83
24;51;593;595;2;0;0.83
24;52;595;600;5;0;0.83
24;53;600;620;20;0;0.83
24;54;620;629;9;0;0.83
24;55;629;631;2;0;0.83
24;56;631;637;6;0;0.83
24;57;637;661;24;0;0.83
24;58;661;663;2;0;0.83
24;59;663;683;20;0;0.83
24;60;683;707;24;0;0.83
24;61;707;720;13;0;0.83
24;62;720;728;8;0;0.83
24;63;728;740;12;0;0.83
24;64;740;751;11;0;0.83
24;65;751;762;11;0;0.83
24;66;762;767;5;0;0.83
24;67;767;780;13;0;0.83
24;68;780;798;18;0;0.83
24;69;798;802;4;0;0.83
24;70;802;825;23;0;0.83
24;71;825;826;1;0;0.83
24;72;826;827;1;0;0.83
24;73;827;832;5;0;0.83
24;74;832;834;2;0;0.83
24;75;834;835;1;0;0.83
24;76;835;840;5;0;0.83
24;77;840;852;12;0;0.83
24;78;852;853;1;0;0.83
24;79;853;868;15;0;0.83
24;80;868;872;4;0;0.83
24;81;872;876;4;0;0.83
24;82;876;879;3;0;0.83
24;83;879;883;4;0;0.83
24;84;883;887;4;0;0.83
24;85;887;890;3;0;0.83
24;86;890;901;11;0;0.83
24;87;901;905;4;0;0.83
24;88;905;907;2;0;0.83
24;89;907;912;5;0;0.83
24;90;912;913;1;0;0.83
24;91;913;922;9;0;0.83
24;92;922;925;3;0;0.83
24;93;925;931;6;0;0.83
24;94;931;936;5;0;0.83
24;95;936;940;4;0;0.83
24;96;940;942;2;0;0.83
24;97;942;947;5;0;0.83
24;98;947;948;1;0;0.83
24;99;948;950;2;0;0.83
24;100;950;960;10;0;0.83
24;101;960;961;1;0;0.83
24;102;961;962;1;0;0.83
24;103;962;972;10;0;0.83
24;104;972;973;1;0;0.83
24;105;973;980;7;0;0.83
24;106;980;982;2;0;0.83
24;107;982;995;13;0;0.83
24;108;995;1002;7;0;0.83
24;109;1002;1010;8;0;0.83
24;110;1010;1021;11;0;0.83
24;111;1021;1026;5;0;0.83
24;112;1026;1032;6;0;0.83
24;113;1032;1033;1;0;0.83
24;114;1033;1045;12;0;0.83
24;115;1045;1052;7;0;0.83
24;116;1052;1062;10;0;0.83
24;117;1062;1068;6;0;0.83
24;118;1068;1070;2;0;0.83
24;119;1070;1072;2;0;0.83
24;120;1072;1081;9;0;0.83
24;121;1081;1085;4;0;0.83
24;122;1085;1090;5;0;0.83
24;123;1090;1092;2;0;0.83
24;124;1092;1095;3;0;0.83
24;125;1095;1100;5;0;0.83
24;126;1100;1102;2;0;0.83
24;127;1102;1103;1;0;0.83
24;128;1103;1122;19;0;0.83
24;129;1122;1151;29;0;0.83
24;130;1151;1154;3;0;0.83
24;131;1154;1173;19;0;0.83
24;132;1173;1178;5;0;0.83
24;133;1178;1211;33;0;0.83
24;134;1211;1220;9;0;0.83
24;135;1220;1223;3;0;0.83
24;136;1223;1225;2;0;0.83
24;137;1225;1271;46;0;0.83
24;138;1271;1274;3;0;0.83
24;139;1274;1283;9;0;0.83
24;140;1283;1321;38;0;0.83
24;141;1321;1324;3;0;0.83
24;142;1324;1342;18;0;0.83
24;143;1342;1346;4;0;0.83
24;144;1346;1385;39;0;0.83
24;145;1385;1388;3;0;0.83
24;146;1388;1394;6;0;0.83
24;147;1394;1396;2;0;0.83
24;148;1396;1411;15;0;0.83
24;149;1411;1426;15;0;0.83
24;150;1426;1441;15;0;0.83
24;151;1441;1456;15;0;0.83
24;152;1456;1471;15;0;0.83
24;153;1471;1486;15;0;0.83
24;154;1486;1501;15;0;0.83
24;155;1501;1516;15;0;0.83
24;156;1516;1531;15;0;0.83
24;157;1531;1546;15;0;0.83
24;158;1546;1561;15;0;0.83
24;159;1561;1576;15;0;0.83
24;160;1576;1591;15;0;0.83
24;161;1591;1606;15;0;0.83
24;162;1606;1621;15;0;0.83
24;163;1621;1636;15;0;0.83
24;164;1636;1651;15;0;0.83
24;165;1651;1666;15;0;0.83
24;166;1666;1680;14;0;0.83
25;0;240;333;93;0;0.83
25;1;333;336;3;0;0.83
25;2;336;339;3;0;0.83
25;3;339;342;3;0;0.83
25;4;342;351;9;0;0.83
25;5;351;354;3;0;0.83
25;6;354;359;5;0;0.83
25;7;359;362;3;0;0.83
25;8;362;366;4;0;0.83
25;9;366;369;3;0;0.83
25;10;369;377;8;0;0.83
25;11;377;378;1;0;0.83
25;12;378;386;8;0;0.83
25;13;386;389;3;0;0.83
25;14;389;394;5;0;0.83
25;15;394;397;3;0;0.83
25;16;397;401;4;0;0.83
25;17;401;409;8;0;0.83
25;18;409;412;3;0;0.83
25;19;412;419;7;0;0.83
25;20;419;420;1;0;0.83
25;21;420;421;1;0;0.83
25;22;421;426;5;0;0.83
25;23;426;429;3;0;0.83
25;24;429;432;3;0;0.83
25;25;432;435;3;0;0.83
25;26;435;447;12;0;0.83
25;27;447;449;2;0;0.83
25;28;449;454;5;0;0.83
25;29;454;455;1;0;0.83
25;30;455;456;1;0;0.83
25;31;456;457;1;0;0.83
25;32;457;461;4;0;0.83
25;33;461;465;4;0;0.83
25;34;465;467;2;0;0.83
25;35;467;469;2;0;0.83
25;36;469;475;6;0;0.83
25;37;475;484;9;0;0.83
25;38;484;502;18;0;0.83
25;39;502;503;1;0;0.83
25;40;503;505;2;0;0.83
25;41;505;506;1;0;0.83
25;42;506;515;9;0;0.83
25;43;515;516;1;0;0.83
25;44;516;532;16;0;0.83
25;45;532;536;4;0;0.83
25;46;536;545;9;0;0.83
25;47;545;549;4;0;0.83
25;48;549;551;2;0;0.83
25;49;551;587;36;0;0.83
25;50;587;593;6;0;0.83
25;51;593;595;2;0;0.83
25;52;595;600;5;0;0.83
25;53;600;620;20;0;0.83
25;54;620;629;9;0;0.83
25;55;629;631;2;0;0.83
25;56;631;637;6;0;0.83
25;57;637;661;24;0;0.83
25;58;661;663;2;0;0.83
25;59;663;683;20;0;0.83
25;60;683;707;24;0;0.83
25;61;707;720;13;0;0.83
25;62;720;728;8;0;0.83
25;63;728;740;12;0;0.83
25;64;740;751;11;0;0.83
25;65;751;762;11;0;0.83
25;66;762;767;5;0;0.83
25;67;767;780;13;0;0.83
25;68;780;798;18;0;0.83
25;69;798;802;4;0;0.83
25;70;802;825;23;0;0.83
25;71;825;826;1;0;0.83
25;72;826;827;1;0;0.83
25;73;827;832;5;0;0.83
25;74;832;834;2;0;0.83
25;75;834;835;1;0;0.83
25;76;835;840;5;0;0.83
25;77;840;852;12;0;0.83
25;78;852;853;1;0;0.83
25;79;853;868;15;0;0.83
25;80;868;872;4;0;0.83
25;81;872;876;4;0;0.83
25;82;876;879;3;0;0.83
25;83;879;883;4;0;0.83
25;84;883;887;4;0;0.83
25;85;887;890;3;0;0.83
25;86;890;901;11;0;0.83
25;87;901;905;4;0;0.83
25;88;905;907;2;0;0.83
25;89;907;912;5;0;0.83
25;90;912;913;1;0;0.83
25;91;913;922;9;0;0.83
25;92;922;925;3;0;0.83
25;93;925;931;6;0;0.83
25;94;931;936;5;0;0.83
25;95;936;940;4;0;0.83
25;96;940;942;2;0;0.83
25;97;942;947;5;0;0.83
25;98;947;948;1;0;0.83
25;99;948;950;2;0;0.83
25;100;950;960;10;0;0.83
25;101;960;961;1;0;0.83
25;102;961;962;1;0;0.83
25;103;962;972;10;0;0.83
25;104;972;973;1;0;0.83
25;105;973;980;7;0;0.83
25;106;980;982;2;0;0.83
25;107;982;995;13;0;0.83
25;108;995;1002;7;0;0.83
25;109;1002;1010;8;0;0.83
25;110;1010;1021;11;0;0.83
25;111;1021;1026;5;0;0.83
25;112;1026;1032;6;0;0.83
25;113;1032;1033;1;0;0.83
25;114;1033;1045;12;0;0.83
25;115;1045;1052;7;0;0.83
25;116;1052;1062;10;0;0.83
25;117;1062;1068;6;0;0.83
25;118;1068;1070;2;0;0.83
25;119;1070;1072;2;0;0.83
25;120;1072;1081;9;0;0.83
25;121;1081;1085;4;0;0.83
25;122;1085;1090;5;0;0.83
25;123;1090;1092;2;0;0.83
25;124;1092;1095;3;0;0.83
25;125;1095;1100;5;0;0.83
25;126;1100;1102;2;0;0.83
25;127;1102;1103;1;0;0.83
25;128;1103;1122;19;0;0.83
25;129;1122;1151;29;0;0.83
25;130;1151;1154;3;0;0.83
25;131;1154;1173;19;0;0.83
25;132;1173;1178;5;0;0.83
25;133;1178;1211;33;0;0.83
25;134;1211;1220;9;0;0.83
25;135;1220;1223;3;0;0.83
25;136;1223;1225;2;0;0.83
25;137;1225;1271;46;0;0.83
25;138;1271;1274;3;0;0.83
25;139;1274;1283;9;0;0.83
25;140;1283;1321;38;0;0.83
25;141;1321;1324;3;0;0.83
25;142;1324;1342;18;0;0.83
25;143;1342;1346;4;0;0.83
25;144;1346;1385;39;0;0.83
25;145;1385;1388;3;0;0.83
25;146;1388;1394;6;0;0.83
25;147;1394;1396;2;0;0.83
25;148;1396;1411;15;0;0.83
25;149;1411;1426;15;0;0.83
25;150;1426;1441;15;0;0.83
25;151;1441;1456;15;0;0.83
25;152;1456;1471;15;0;0.83
25;153;1471;1486;15;0;0.83
25;154;1486;1501;15;0;0.83
25;155;1501;1516;15;0;0.83
25;156;1516;1531;15;0;0.83
25;157;1531;1546;15;0;0.83
25;158;1546;1561;15;0;0.83
25;159;1561;1576;15;0;0.83
25;160;1576;1591;15;0;0.83
25;161;1591;1606;15;0;0.83
25;162;1606;1621;15;0;0.83
25;163;1621;1636;15;0;0.83
25;164;1636;1651;15;0;0.83
25;165;1651;1666;15;0;0.83
25;166;1666;1680;14;0;0.83
26;0;240;333;93;0;0.83
26;1;333;336;3;0;0.83
26;2;336;339;3;0;0.83
26;3;339;342;3;0;0.83
26;4;342;351;9;0;0.83
26;5;351;354;3;0;0.83
26;6;354;359;5;0;0.83
26;7;359;362;3;0;0.83
26;8;362;366;4;0;0.83
26;9;366;369;3;0;0.83
26;10;369;377;8;0;0.83
26;11;377;378;1;0;0.83
26;12;378;386;8;0;0.83
26;13;386;389;3;0;0.83
26;14;389;394;5;0;0.83
26;15;394;397;3;0;0.83
26;16;397;401;4;0;0.83
26;17;401;409;8;0;0.83
26;18;409;412;3;0;0.83
26;19;412;419;7;0;0.83
26;20;419;420;1;0;0.83
26;21;420;421;1;0;0.83
26;22;421;426;5;0;0.83
26;23;426;429;3;0;0.83
26;24;429;432;3;0;0.83
26;25;432;435;3;0;0.83
26;26;435;447;12;0;0.83
26;27;447;449;2;0;0.83
26;28;449;454;5;0;0.83
26;29;454;455;1;0;0.83
26;30;455;456;1;0;0.83
26;31;456;457;1;0;0.83
26;32;457;461;4;0;0.83
26;33;461;465;4;0;0.83
26;34;465;467;2;0;0.83
26;35;467;469;2;0;0.83
26;36;469;475;6;0;0.83
26;37;475;484;9;0;0.83
26;38;484;502;18;0;0.83
26;39;502;503;1;0;0.83
26;40;503;505;2;0;0.83
26;41;505;506;1;0;0.83
26;42;506;515;9;0;0.83
26;43;515;516;1;0;0.83
26;44;516;532;16;0;0.83
26;45;532;536;4;0;0.83
26;46;536;545;9;0;0.83
26;47;545;549;4;0;0.83
26;48;549;551;2;0;0.83
26;49;551;587;36;0;0.83
26;50;587;593;6;0;0.83
26;51;593;595;2;0;0.83
26;52;595;600;5;0;0.83
26;53;600;620;20;0;0.83
26;54;620;629;9;0;0.83
26;55;629;631;2;0;0.83
26;56;631;637;6;0;0.83
26;57;637;661;24;0;0.83
26;58;661;663;2;0;0.83
26;59;663;683;20;0;0.83
26;60;683;707;24;0;0.83
26;61;707;720;13;0;0.83
26;62;720;728;8;0;0.83
26;63;728;740;12;0;0.83
26;64;740;751;11;0;0.83
26;65;751;762;11;0;0.83
26;66;762;767;5;0;0.83
26;67;767;780;13;0;0.83
26;68;780;798;18;0;0.83
26;69;798;802;4;0;0.83
26;70;802;825;23;0;0.83
26;71;825;826;1;0;0.83
26;72;826;827;1;0;0.83
26;73;827;832;5;0;0.83
26;74;832;834;2;0;0.83
26;75;834;835;1;0;0.83
26;76;835;840;5;0;0.83
26;77;840;852;12;0;0.83
26;78;852;853;1;0;0.83
26;79;853;868;15;0;0.83
26;80;868;872;4;0;0.83
26;81;872;876;4;0;0.83
26;82;876;879;3;0;0.83
26;83;879;883;4;0;0.83
26;84;883;887;4;0;0.83
26;85;887;890;3;0;0.83
26;86;890;901;11;0;0.83
26;87;901;905;4;0;0.83
26;88;905;907;2;0;0.83
26;89;907;912;5;0;0.83
26;90;912;913;1;0;0.83
26;91;913;922;9;0;0.83
26;92;922;925;3;0;0.83
26;93;925;931;6;0;0.83
26;94;931;936;5;0;0.83
26;95;936;940;4;0;0.83
26;96;940;942;2;0;0.83
26;97;942;947;5;0;0.83
26;98;947;948;1;0;0.83
26;99;948;950;2;0;0.83
26;100;950;960;10;0;0.83
26;101;960;961;1;0;0.83
26;102;961;962;1;0;0.83
26;103;962;972;10;0;0.83
26;104;972;973;1;0;0.83
26;105;973;980;7;0;0.83
26;106;980;982;2;0;0.83
26;107;982;995;13;0;0.83
26;108;995;1002;7;0;0.83
26;109;1002;1010;8;0;0.83
26;110;1010;1021;11;0;0.83
26;111;1021;1026;5;0;0.83
26;112;1026;1032;6;0;0.83
26;113;1032;1033;1;0;0.83
26;114;1033;1045;12;0;0.83
26;115;1045;1052;7;0;0.83
26;116;1052;1062;10;0;0.83
26;117;1062;1068;6;0;0.83
26;118;1068;1070;2;0;0.83
26;119;1070;1072;2;0;0.83
26;120;1072;1081;9;0;0.83
26;121;1081;1085;4;0;0.83
26;122;1085;1090;5;0;0.83
26;123;1090;1092;2;0;0.83
26;124;1092;1095;3;0;0.83
26;125;1095;1100;5;0;0.83
26;126;1100;1102;2;0;0.83
26;127;1102;1103;1;0;0.83
26;128;1103;1122;19;0;0.83
26;129;1122;1151;29;0;0.83
26;130;1151;1154;3;0;0.83
26;131;1154;1173;19;0;0.83
26;132;1173;1178;5;0;0.83
26;133;1178;1211;33;0;0.83
26;134;1211;1220;9;0;0.83
26;135;1220;1223;3;0;0.83
26;136;1223;1225;2;0;0.83
26;137;1225;1271;46;0;0.83
26;138;1271;1274;3;0;0.83
26;139;1274;1283;9;0;0.83
26;140;1283;1321;38;0;0.83
26;141;1321;1324;3;0;0.83
26;142;1324;1342;18;0;0.83
26;143;1342;1346;4;0;0.83
26;144;1346;1385;39;0;0.83
26;145;1385;1388;3;0;0.83
26;146;1388;1394;6;0;0.83
26;147;1394;1396;2;0;0.83
26;148;1396;1411;15;0;0.83
26;149;1411;1426;15;0;0.83
26;150;1426;1441;15;0;0.83
26;151;1441;1456;15;0;0.83
26;152;1456;1471;15;0;0.83
26;153;1471;1486;15;0;0.83
26;154;1486;1501;15;0;0.83
26;155;1501;1516;15;0;0.83
26;156;1516;1531;15;0;0.83
26;157;1531;1546;15;0;0.83
26;158;1546;1561;15;0;0.83
26;159;1561;1576;15;0;0.83
26;160;1576;1591;15;0;0.83
26;161;1591;1606;15;0;0.83
26;162;1606;1621;15;0;0.83
26;163;1621;1636;15;0;0.83
26;164;1636;1651;15;0;0.83
26;165;1651;1666;15;0;0.83
26;166;1666;1680;14;0;0.83
27;0;240;333;93;0;0.83
27;1;333;336;3;0;0.83
27;2;336;339;3;0;0.83
27;3;339;342;3;0;0.83
27;4;342;351;9;0;0.83
27;5;351;354;3;0;0.83
27;6;354;359;5;0;0.83
27;7;359;362;3;0;0.83
27;8;362;366;4;0;0.83
27;9;366;369;3;0;0.83
27;10;369;377;8;0;0.83
27;11;377;378;1;0;0.83
27;12;378;386;8;0;0.83
27;13;386;389;3;0;0.83
27;14;389;394;5;0;0.83
27;15;394;397;3;0;0.83
27;16;397;401;4;0;0.83
27;17;401;409;8;0;0.83
27;18;409;412;3;0;0.83
27;19;412;419;7;0;0.83
27;20;419;420;1;0;0.83
27;21;420;421;1;0;0.83
27;22;421;426;5;0;0.83
27;23;426;429;3;0;0.83
27;24;429;432;3;0;0.83
27;25;432;435;3;0;0.83
27;26;435;447;12;0;0.83
27;27;447;449;2;0;0.83
27;28;449;454;5;0;0.83
27;29;454;455;1;0;0.83
27;30;455;456;1;0;0.83
27;31;456;457;1;0;0.83
27;32;457;461;4;0;0.83
27;33;461;465;4;0;0.83
27;34;465;467;2;0;0.83
27;35;467;469;2;0;0.83
27;36;469;475;6;0;0.83
27;37;475;484;9;0;0.83
27;38;484;502;18;0;0.83
27;39;502;503;1;0;0.83
27;40;503;505;2;0;0.83
27;41;505;506;1;0;0.83
27;42;506;515;9;0;0.83
27;43;515;516;1;0;0.83
27;44;516;532;16;0;0.83
27;45;532;536;4;0;0.83
27;46;536;545;9;0;0.83
27;47;545;549;4;0;0.83
27;48;549;551;2;0;0.83
27;49;551;587;36;0;0.83
27;50;587;593;6;0;0.83
27;51;593;595;2;0;0.83
27;52;595;600;5;0;0.83
27;53;600;620;20;0;0.83
27;54;620;629;9;0;0.83
27;55;629;631;2;0;0.83
27;56;631;637;6;0;0.83
27;57;637;661;24;0;0.83
27;58;661;663;2;0;0.83
27;59;663;683;20;0;0.83
27;60;683;707;24;0;0.83
27;61;707;720;13;0;0.83
27;62;720;728;8;0;0.83
27;63;728;740;12;0;0.83
27;64;740;751;11;0;0.83
27;65;751;762;11;0;0.83
27;66;762;767;5;0;0.83
27;67;767;780;13;0;0.83
27;68;780;798;18;0;0.83
27;69;798;802;4;0;0.83
27;70;802;825;23;0;0.83
27;71;825;826;1;0;0.83
27;72;826;827;1;0;0.83
27;73;827;832;5;0;0.83
27;74;832;834;2;0;0.83
27;75;834;835;1;0;0.83
27;76;835;840;5;0;0.83
27;77;840;852;12;0;0.83
27;78;852;853;1;0;0.83
27;79;853;868;15;0;0.83
27;80;868;872;4;0;0.83
27;81;872;876;4;0;0.83
27;82;876;879;3;0;0.83
27;83;879;883;4;0;0.83
27;84;883;887;4;0;0.83
27;85;887;890;3;0;0.83
27;86;890;901;11;0;0.83
27;87;901;905;4;0;0.83
27;88;905;907;2;0;0.83
27;89;907;912;5;0;0.83
27;90;912;913;1;0;0.83
27;91;913;922;9;0;0.83
27;92;922;925;3;0;0.83
27;93;925;931;6;0;0.83
27;94;931;936;5;0;0.83
27;95;936;940;4;0;0.83
27;96;940;942;2;0;0.83
27;97;942;947;5;0;0.83
27;98;947;948;1;0;0.83
27;99;948;950;2;0;0.83
27;100;950;960;10;0;0.83
27;101;960;961;1;0;0.83
27;102;961;962;1;0;0.83
27;103;962;972;10;0;0.83
27;104;972;973;1;0;0.83
27;105;973;980;7;0;0.83
27;106;980;982;2;0;0.83
27;107;982;995;13;0;0.83
27;108;995;1002;7;0;0.83
27;109;1002;1010;8;0;0.83
27;110;1010;1021;11;0;0.83
27;111;1021;1026;5;0;0.83
27;112;1026;1032;6;0;0.83
27;113;1032;1033;1;0;0.83
27;114;1033;1045;12;0;0.83
27;115;1045;1052;7;0;0.83
27;116;1052;1062;10;0;0.83
27;117;1062;1068;6;0;0.83
27;118;1068;1070;2;0;0.83
27;119;1070;1072;2;0;0.83
27;120;1072;1081;9;0;0.83
27;121;1081;1085;4;0;0.83
27;122;1085;1090;5;0;0.83
27;123;1090;1092;2;0;0.83
27;124;1092;1095;3;0;0.83
27;125;1095;1100;5;0;0.83
27;126;1100;1102;2;0;0.83
27;127;1102;1103;1;0;0.83
27;128;1103;1122;19;0;0.83
27;129;1122;1151;29;0;0.83
27;130;1151;1154;3;0;0.83
27;131;1154;1173;19;0;0.83
27;132;1173;1178;5;0;0.83
27;133;1178;1211;33;0;0.83
27;134;1211;1220;9;0;0.83
27;135;1220;1223;3;0;0.83
27;136;1223;1225;2;0;0.83
27;137;1225;1271;46;0;0.83
27;138;1271;1274;3;0;0.83
27;139;1274;1283;9;0;0.83
27;140;1283;1321;38;0;0.83
27;141;1321;1324;3;0;0.83
27;142;1324;1342;18;0;0.83
27;143;1342;1346;4;0;0.83
27;144;1346;1385;39;0;0.83
27;145;1385;1388;3;0;0.83
27;146;1388;1394;6;0;0.83
27;147;1394;1396;2;0;0.83
27;148;1396;1411;15;0;0.83
27;149;1411;1426;15;0;0.83
27;150;1426;1441;15;0;0.83
27;151;1441;1456;15;0;0.83
27;152;1456;1471;15;0;0.83
27;153;1471;1486;15;0;0.83
27;154;1486;1501;15;0;0.83
27;155;1501;1516;15;0;0.83
27;156;1516;1531;15;0;0.83
27;157;1531;1546;15;0;0.83
27;158;1546;1561;15;0;0.83
27;159;1561;1576;15;0;0.83
27;160;1576;1591;15;0;0.83
27;161;1591;1606;15;0;0.83
27;162;1606;1621;15;0;0.83
27;163;1621;1636;15;0;0.83
27;164;1636;1651;15;0;0.83
27;165;1651;1666;15;0;0.83
27;166;1666;1680;14;0;0.83
28;0;240;333;93;0;0.83
28;1;333;336;3;0;0.83
28;2;336;339;3;0;0.83
28;3;339;342;3;0;0.83
28;4;342;351;9;0;0.83
28;5;351;354;3;0;0.83
28;6;354;359;5;0;0.83
28;7;359;362;3;0;0.83
28;8;362;366;4;0;0.83
28;9;366;369;3;0;0.83
28;10;369;377;8;0;0.83
28;11;377;378;1;0;0.83
28;12;378;386;8;0;0.83
28;13;386;389;3;0;0.83
28;14;389;394;5;0;0.83
28;15;394;397;3;0;0.83
28;16;397;401;4;0;0.83
28;17;401;409;8;0;0.83
28;18;409;412;3;0;0.83
28;19;412;419;7;0;0.83
28;20;419;420;1;0;0.83
28;21;420;421;1;0;0.83
28;22;421;426;5;0;0.83
28;23;426;429;3;0;0.83
28;24;429;432;3;0;0.83
28;25;432;435;3;0;0.83
28;26;435;447;12;0;0.83
28;27;447;449;2;0;0.83
28;28;449;454;5;0;0.83
28;29;454;455;1;0;0.83
28;30;455;456;1;0;0.83
28;31;456;457;1;0;0.83
28;32;457;461;4;0;0.83
28;33;461;465;4;0;0.83
28;34;465;467;2;0;0.83
28;35;467;469;2;0;0.83
28;36;469;475;6;0;0.83
28;37;475;484;9;0;0.83
28;38;484;502;18;0;0.83
28;39;502;503;1;0;0.83
28;40;503;505;2;0;0.83
28;41;505;506;1;0;0.83
28;42;506;515;9;0;0.83
28;43;515;516;1;0;0.83
28;44;516;532;16;0;0.83
28;45;532;536;4;0;0.83
28;46;536;545;9;0;0.83
28;47;545;549;4;0;0.83
28;48;549;551;2;0;0.83
28;49;551;587;36;0;0.83
28;50;587;593;6;0;0.83
28;51;593;595;2;0;0.83
28;52;595;600;5;0;0.83
28;53;600;620;20;0;0.83
28;54;620;629;9;0;0.83
28;55;629;631;2;0;0.83
28;56;631;637;6;0;0.83
28;57;637;661;24;0;0.83
28;58;661;663;2;0;0.83
28;59;663;683;20;0;0.83
28;60;683;707;24;0;0.83
28;61;707;720;13;0;0.83
28;62;720;728;8;0;0.83
28;63;728;740;12;0;0.83
28;64;740;751;11;0;0.83
28;65;751;762;11;0;0.83
28;66;762;767;5;0;0.83
28;67;767;780;13;0;0.83
28;68;780;798;18;0;0.83
28;69;798;802;4;0;0.83
28;70;802;825;23;0;0.83
28;71;825;826;1;0;0.83
28;72;826;827;1;0;0.83
28;73;827;832;5;0;0.83
28;74;832;834;2;0;0.83
28;75;834;835;1;0;0.83
28;76;835;840;5;0;0.83
28;77;840;852;12;0;0.83
28;78;852;853;1;0;0.83
28;79;853;868;15;0;0.83
28;80;868;872;4;0;0.83
28;81;872;876;4;0;0.83
28;82;876;879;3;0;0.83
28;83;879;883;4;0;0.83
28;84;883;887;4;0;0.83
28;85;887;890;3;0;0.83
28;86;890;901;11;0;0.83
28;87;901;905;4;0;0.83
28;88;905;907;2;0;0.83
28;89;907;912;5;0;0.83
28;90;912;913;1;0;0.83
28;91;913;922;9;0;0.83
28;92;922;925;3;0;0.83
28;93;925;931;6;0;0.83
28;94;931;936;5;0;0.83
28;95;936;940;4;0;0.83
28;96;940;942;2;0;0.83
28;97;942;947;5;0;0.83
28;98;947;948;1;0;0.83
28;99;948;950;2;0;0.83
28;100;950;960;10;0;0.83
28;101;960;961;1;0;0.83
28;102;961;962;1;0;0.83
28;103;962;972;10;0;0.83
28;104;972;973;1;0;0.83
28;105;973;980;7;0;0.83
28;106;980;982;2;0;0.83
28;107;982;995;13;0;0.83
28;108;995;1002;7;0;0.83
28;109;1002;1010;8;0;0.83
28;110;1010;1021;11;0;0.83
28;111;1021;1026;5;0;0.83
28;112;1026;1032;6;0;0.83
28;113;1032;1033;1;0;0.83
28;114;1033;1045;12;0;0.83
28;115;1045;1052;7;0;0.83
28;116;1052;1062;10;0;0.83
28;117;1062;1068;6;0;0.83
28;118;1068;1070;2;0;0.83
28;119;1070;1072;2;0;0.83
28;120;1072;1081;9;0;0.83
28;121;1081;1085;4;0;0.83
28;122;1085;1090;5;0;0.83
28;123;1090;1092;2;0;0.83
28;124;1092;1095;3;0;0.83
28;125;1095;1100;5;0;0.83
28;126;1100;1102;2;0;0.83
28;127;1102;1103;1;0;0.83
28;128;1103;1122;19;0;0.83
28;129;1122;1151;29;0;0.83
28;130;1151;1154;3;0;0.83
28;131;1154;1173;19;0;0.83
28;132;1173;1178;5;0;0.83
28;133;1178;1211;33;0;0.83
28;134;1211;1220;9;0;0.83
28;135;1220;1223;3;0;0.83
28;136;1223;1225;2;0;0.83
28;137;1225;1271;46;0;0.83
28;138;1271;1274;3;0;0.83
28;139;1274;1283;9;0;0.83
28;140;1283;1321;38;0;0.83
28;141;1321;1324;3;0;0.83
28;142;1324;1342;18;0;0.83
28;143;1342;1346;4;0;0.83
28;144;1346;1385;39;0;0.83
28;145;1385;1388;3;0;0.83
28;146;1388;1394;6;0;0.83
28;147;1394;1396;2;0;0.83
28;148;1396;1411;15;0;0.83
28;149;1411;1426;15;0;0.83
28;150;1426;1441;15;0;0.83
28;151;1441;1456;15;0;0.83
28;152;1456;1471;15;0;0.83
28;153;1471;1486;15;0;0.83
28;154;1486;1501;15;0;0.83
28;155;1501;1516;15;0;0.83
28;156;1516;1531;15;0;0.83
28;157;1531;1546;15;0;0.83
28;158;1546;1561;15;0;0.83
28;159;1561;1576;15;0;0.83
28;160;1576;1591;15;0;0.83
28;161;1591;1606;15;0;0.83
28;162;1606;1621;15;0;0.83
28;163;1621;1636;15;0;0.83
28;164;1636;1651;15;0;0.83
28;165;1651;1666;15;0;0.83
28;166;1666;1680;14;0;0.83
29;0;240;333;93;0;2.0
29;1;333;336;3;0;2.0
29;2;336;339;3;0;2.0
29;3;339;342;3;0;2.0
29;4;342;351;9;0;2.0
29;5;351;354;3;0;2.0
29;6;354;359;5;0;2.0
29;7;359;362;3;0;2.0
29;8;362;366;4;0;2.0
29;9;366;369;3;0;2.0
29;10;369;377;8;0;2.0
29;11;377;378;1;0;2.0
29;12;378;386;8;0;2.0
29;13;386;389;3;0;2.0
29;14;389;394;5;0;2.0
29;15;394;397;3;0;2.0
29;16;397;401;4;0;2.0
29;17;401;409;8;0;2.0
29;18;409;412;3;0;2.0
29;19;412;419;7;0;2.0
29;20;419;420;1;0;2.0
29;21;420;421;1;0;2.0
29;22;421;426;5;0;2.0
29;23;426;429;3;0;2.0
29;24;429;432;3;0;2.0
29;25;432;435;3;0;2.0
29;26;435;447;12;0;2.0
29;27;447;449;2;0;2.0
29;28;449;454;5;0;2.0
29;29;454;455;1;0;2.0
29;30;455;456;1;0;2.0
29;31;456;457;1;0;2.0
29;32;457;461;4;0;2.0
29;33;461;465;4;0;2.0
29;34;465;467;2;0;2.0
29;35;467;469;2;0;2.0
29;36;469;475;6;0;2.0
29;37;475;484;9;0;2.0
29;38;484;502;18;0;2.0
29;39;502;503;1;0;2.0
29;40;503;505;2;0;2.0
29;41;505;506;1;0;2.0
29;42;506;515;9;0;2.0
29;43;515;516;1;0;2.0
29;44;516;532;16;0;2.0
29;45;532;536;4;0;2.0
29;46;536;545;9;0;2.0
29;47;545;549;4;0;2.0
29;48;549;551;2;0;2.0
29;49;551;587;36;0;2.0
29;50;587;593;6;0;2.0
29;51;593;595;2;0;2.0
29;52;595;600;5;0;2.0
29;53;600;620;20;0;2.0
29;54;620;629;9;0;2.0
29;55;629;631;2;0;2.0
29;56;631;637;6;0;2.0
29;57;637;661;24;0;2.0
29;58;661;663;2;0;2.0
29;59;663;683;20;0;2.0
29;60;683;707;24;0;2.0
29;61;707;720;13;0;2.0
29;62;720;728;8;0;2.0
29;63;728;740;12;0;2.0
29;64;740;751;11;0;2.0
29;65;751;762;11;0;2.0
29;66;762;767;5;0;2.0
29;67;767;780;13;0;2.0
29;68;780;798;18;0;2.0
29;69;798;802;4;0;2.0
29;70;802;825;23;0;2.0
29;71;825;826;1;0;2.0
29;72;826;827;1;0;2.0
29;73;827;832;5;0;2.0
29;74;832;834;2;0;2.0
29;75;834;835;1;0;2.0
29;76;835;840;5;0;2.0
29;77;840;852;12;0;2.0
29;78;852;853;1;0;2.0
29;79;853;868;15;0;2.0
29;80;868;872;4;0;2.0
29;81;872;876;4;0;2.0
29;82;876;879;3;0;2.0
29;83;879;883;4;0;2.0
29;84;883;887;4;0;2.0
29;85;887;890;3;0;2.0
29;86;890;901;11;0;2.0
29;87;901;905;4;0;2.0
29;88;905;907;2;0;2.0
29;89;907;912;5;0;2.0
29;90;912;913;1;0;2.0
29;91;913;922;9;0;2.0
29;92;922;925;3;0;2.0
29;93;925;931;6;0;2.0
29;94;931;936;5;0;2.0
29;95;936;940;4;0;2.0
29;96;940;942;2;0;2.0
29;97;942;947;5;0;2.0
29;98;947;948;1;0;2.0
29;99;948;950;2;0;2.0
29;100;950;960;10;0;2.0
29;101;960;961;1;0;2.0
29;102;961;962;1;0;2.0
29;103;962;972;10;0;2.0
29;104;972;973;1;0;2.0
29;105;973;980;7;0;2.0
29;106;980;982;2;0;2.0
29;107;982;995;13;0;2.0
29;108;995;1002;7;0;2.0
29;109;1002;1010;8;0;2.0
29;110;1010;1021;11;0;2.0
29;111;1021;1026;5;0;2.0
29;112;1026;1032;6;0;2.0
29;113;1032;1033;1;0;2.0
29;114;1033;1045;12;0;2.0
29;115;1045;1052;7;0;2.0
29;116;1052;1062;10;0;2.0
29;117;1062;1068;6;0;2.0
29;118;1068;1070;2;0;2.0
29;119;1070;1072;2;0;2.0
29;120;1072;1081;9;0;2.0
29;121;1081;1085;4;0;2.0
29;122;1085;1090;5;0;2.0
29;123;1090;1092;2;0;2.0
29;124;1092;1095;3;0;2.0
29;125;1095;1100;5;0;2.0
29;126;1100;1102;2;0;2.0
29;127;1102;1103;1;0;2.0
29;128;1103;1122;19;0;2.0
29;129;1122;1151;29;0;2.0
29;130;1151;1154;3;0;2.0
29;131;1154;1173;19;0;2.0
29;132;1173;1178;5;0;2.0
29;133;1178;1211;33;0;2.0
29;134;1211;1220;9;0;2.0
29;135;1220;1223;3;0;2.0
29;136;1223;1225;2;0;2.0
29;137;1225;1271;46;0;2.0
29;138;1271;1274;3;0;2.0
29;139;1274;1283;9;0;2.0
29;140;1283;1321;38;0;2.0
29;141;1321;1324;3;0;2.0
29;142;1324;1342;18;0;2.0
29;143;1342;1346;4;0;2.0
29;144;1346;1385;39;0;2.0
29;145;1385;1388;3;0;2.0
29;146;1388;1394;6;0;2.0
29;147;1394;1396;2;0;2.0
29;148;1396;1411;15;0;2.0
29;149;1411;1426;15;0;2.0
29;150;1426;1441;15;0;2.0
29;151;1441;1456;15;0;2.0
29;152;1456;1471;15;0;2.0
29;153;1471;1486;15;0;2.0
29;154;1486;1501;15;0;2.0
29;155;1501;1516;15;0;2.0
29;156;1516;1531;15;0;2.0
29;157;1531;1546;15;0;2.0
29;158;1546;1561;15;0;2.0
29;159;1561;1576;15;0;2.0
29;160;1576;1591;15;0;2.0
29;161;1591;1606;15;0;2.0
29;162;1606;1621;15;0;2.0
29;163;1621;1636;15;0;2.0
29;164;1636;1651;15;0;2.0
29;165;1651;1666;15;0;2.0
29;166;1666;1680;14;0;2.0
30;0;240;333;93;0;2.0
30;1;333;336;3;0;2.0
30;2;336;339;3;0;2.0
30;3;339;342;3;0;2.0
30;4;342;351;9;0;2.0
30;5;351;354;3;0;2.0
30;6;354;359;5;0;2.0
30;7;359;362;3;0;2.0
30;8;362;366;4;0;2.0
30;9;366;369;3;0;2.0
30;10;369;377;8;0;2.0
30;11;377;378;1;0;2.0
30;12;378;386;8;0;2.0
30;13;386;389;3;0;2.0
30;14;389;394;5;0;2.0
30;15;394;397;3;0;2.0
30;16;397;401;4;0;2.0
30;17;401;409;8;0;2.0
30;18;409;412;3;0;2.0
30;19;412;419;7;0;2.0
30;20;419;420;1;0;2.0
30;21;420;421;1;0;2.0
30;22;421;426;5;0;2.0
30;23;426;429;3;0;2.0
30;24;429;432;3;0;2.0
30;25;432;435;3;0;2.0
30;26;435;447;12;0;2.0
30;27;447;449;2;0;2.0
30;28;449;454;5;0;2.0
30;29;454;455;1;0;2.0
30;30;455;456;1;0;2.0
30;31;456;457;1;0;2.0
30;32;457;461;4;0;2.0
30;33;461;465;4;0;2.0
30;34;465;467;2;0;2.0
30;35;467;469;2;0;2.0
30;36;469;475;6;0;2.0
30;37;475;484;9;0;2.0
30;38;484;502;18;0;2.0
30;39;502;503;1;0;2.0
30;40;503;505;2;0;2.0
30;41;505;506;1;0;2.0
30;42;506;515;9;0;2.0
30;43;515;516;1;0;2.0
30;44;516;532;16;0;2.0
30;45;532;536;4;0;2.0
30;46;536;545;9;0;2.0
30;47;545;549;4;0;2.0
30;48;549;551;2;0;2.0
30;49;551;587;36;0;2.0
30;50;587;593;6;0;2.0
30;51;593;595;2;0;2.0
30;52;595;600;5;0;2.0
30;53;600;620;20;0;2.0
30;54;620;629;9;0;2.0
30;55;629;631;2;0;2.0
30;56;631;637;6;0;2.0
30;57;637;661;24;0;2.0
30;58;661;663;2;0;2.0
30;59;663;683;20;0;2.0
30;60;683;707;24;0;2.0
30;61;707;720;13;0;2.0
30;62;720;728;8;0;2.0
30;63;728;740;12;0;2.0
30;64;740;751;11;0;2.0
30;65;751;762;11;0;2.0
30;66;762;767;5;0;2.0
30;67;767;780;13;0;2.0
30;68;780;798;18;0;2.0
30;69;798;802;4;0;2.0
30;70;802;825;23;0;2.0
30;71;825;826;1;0;2.0
30;72;826;827;1;0;2.0
30;73;827;832;5;0;2.0
30;74;832;834;2;0;2.0
30;75;834;835;1;0;2.0
30;76;835;840;5;0;2.0
30;77;840;852;12;0;2.0
30;78;852;853;1;0;2.0
30;79;853;868;15;0;2.0
30;80;868;872;4;0;2.0
30;81;872;876;4;0;2.0
30;82;876;879;3;0;2.0
30;83;879;883;4;0;2.0
30;84;883;887;4;0;2.0
30;85;887;890;3;0;2.0
30;86;890;901;11;0;2.0
30;87;901;905;4;0;2.0
30;88;905;907;2;0;2.0
30;89;907;912;5;0;2.0
30;90;912;913;1;0;2.0
30;91;913;922;9;0;2.0
30;92;922;925;3;0;2.0
30;93;925;931;6;0;2.0
30;94;931;936;5;0;2.0
30;95;936;940;4;0;2.0
30;96;940;942;2;0;2.0
30;97;942;947;5;0;2.0
30;98;947;948;1;0;2.0
30;99;948;950;2;0;2.0
30;100;950;960;10;0;2.0
30;101;960;961;1;0;2.0
30;102;961;962;1;0;2.0
30;103;962;972;10;0;2.0
30;104;972;973;1;0;2.0
30;105;973;980;7;0;2.0
30;106;980;982;2;0;2.0
30;107;982;995;13;0;2.0
30;108;995;1002;7;0;2.0
30;109;1002;1010;8;0;2.0
30;110;1010;1021;11;0;2.0
30;111;1021;1026;5;0;2.0
30;112;1026;1032;6;0;2.0
30;113;1032;1033;1;0;2.0
30;114;1033;1045;12;0;2.0
30;115;1045;1052;7;0;2.0
30;116;1052;1062;10;0;2.0
30;117;1062;1068;6;0;2.0
30;118;1068;1070;2;0;2.0
30;119;1070;1072;2;0;2.0
30;120;1072;1081;9;0;2.0
30;121;1081;1085;4;0;2.0
30;122;1085;1090;5;0;2.0
30;123;1090;1092;2;0;2.0
30;124;1092;1095;3;0;2.0
30;125;1095;1100;5;0;2.0
30;126;1100;1102;2;0;2.0
30;127;1102;1103;1;0;2.0
30;128;1103;1122;19;0;2.0
30;129;1122;1151;29;0;2.0
30;130;1151;1154;3;0;2.0
30;131;1154;1173;19;0;2.0
30;132;1173;1178;5;0;2.0
30;133;1178;1211;33;0;2.0
30;134;1211;1220;9;0;2.0
30;135;1220;1223;3;0;2.0
30;136;1223;1225;2;0;2.0
30;137;1225;1271;46;0;2.0
30;138;1271;1274;3;0;2.0
30;139;1274;1283;9;0;2.0
30;140;1283;1321;38;0;2.0
30;141;1321;1324;3;0;2.0
30;142;1324;1342;18;0;2.0
30;143;1342;1346;4;0;2.0
30;144;1346;1385;39;0;2.0
30;145;1385;1388;3;0;2.0
30;146;1388;1394;6;0;2.0
30;147;1394;1396;2;0;2.0
30;148;1396;1411;15;0;2.0
30;149;1411;1426;15;0;2.0
30;150;1426;1441;15;0;2.0
30;151;1441;1456;15;0;2.0
30;152;1456;1471;15;0;2.0
30;153;1471;1486;15;0;2.0
30;154;1486;1501;15;0;2.0
30;155;1501;1516;15;0;2.0
30;156;1516;1531;15;0;2.0
30;157;1531;1546;15;0;2.0
30;158;1546;1561;15;0;2.0
30;159;1561;1576;15;0;2.0
30;160;1576;1591;15;0;2.0
30;161;1591;1606;15;0;2.0
30;162;1606;1621;15;0;2.0
30;163;1621;1636;15;0;2.0
30;164;1636;1651;15;0;2.0
30;165;1651;1666;15;0;2.0
30;166;1666;1680;14;0;2.0
